,Unnamed: 0,Date,TeamName,ScoreOff,RushAttOff,RushYdsOff,PassAttOff,PassCompOff,PassYdsOff,PassIntOff,FumblesOff,Opponent,ScoreDef,RushAttDef,RushYdsDef,PassAttDef,PassCompDef,PassYdsDef,PassIntDef,FumblesDef,Site,Line,ScoreDiff,RushAttDiff,RushYdsDiff,PassAttDiff,PassCompDiff,PassYdsDiff,PassIntDiff,FumblesDiff,season
0,0,08/28/2004,Miami-Ohio,49,39,162,37,24,292,1,2,Indiana State,0,31,44,33,18,160,1,2,H, ,49,8,118,4,6,132,0,0,2004
1,1,08/28/2004,Southern Cal,24,29,101,29,19,272,0,0,Virginia Tech,13,34,141,29,14,153,1,1,N,16,11,-5,-40,0,5,119,-1,-1,2004
2,2,08/28/2004,Virginia Tech,13,34,141,29,14,153,1,1,Southern Cal,24,29,101,29,19,272,0,0,N,-16,-11,5,40,0,-5,-119,1,1,2004
3,3,09/02/2004,Arizona State,41,42,131,44,23,356,1,0,Texas-El Paso,9,31,87,44,21,196,4,1,H,24.5,32,11,44,0,2,160,-3,-1,2004
4,4,09/02/2004,Ball State,11,33,64,33,19,147,0,0,Boston College,19,43,205,23,12,135,1,1,H,-17,-8,-10,-141,10,7,12,-1,-1,2004
5,5,09/02/2004,Boston College,19,43,205,23,12,135,1,1,Ball State,11,33,64,33,19,147,0,0,V,17,8,10,141,-10,-7,-12,1,1,2004
6,6,09/02/2004,Buffalo,34,48,225,44,19,174,2,1,Eastern Michigan,37,52,248,20,11,91,0,4,V,-6,-3,-4,-23,24,8,83,2,-3,2004
7,7,09/02/2004,Eastern Michigan,37,52,248,20,11,91,0,4,Buffalo,34,48,225,44,19,174,2,1,H,6,3,4,23,-24,-8,-83,-2,3,2004
8,8,09/02/2004,Northwestern,45,38,124,62,39,513,1,0,Texas Christian,48,36,157,38,20,368,1,1,V,-5.5,-3,2,-33,24,19,145,0,-1,2004
9,9,09/02/2004,Texas A+M,21,31,167,43,20,270,0,0,Utah,41,45,212,31,22,370,0,0,V,-9.5,-20,-14,-45,12,-2,-100,0,0,2004
10,10,09/02/2004,Texas Christian,48,36,157,38,20,368,1,1,Northwestern,45,38,124,62,39,513,1,0,H,5.5,3,-2,33,-24,-19,-145,0,1,2004
11,11,09/02/2004,Texas-El Paso,9,31,87,44,21,196,4,1,Arizona State,41,42,131,44,23,356,1,0,V,-24.5,-32,-11,-44,0,-2,-160,3,1,2004
12,12,09/02/2004,Utah,41,45,212,31,22,370,0,0,Texas A+M,21,31,167,43,20,270,0,0,H,9.5,20,14,45,-12,2,100,0,0,2004
13,13,09/02/2004,Western Michigan,42,38,108,23,16,215,1,1,Tennessee-Martin,0,37,86,25,9,136,1,1,H, ,42,1,22,-2,7,79,0,0,2004
14,14,09/03/2004,New Mexico,17,43,186,31,16,229,3,1,Washington State,21,31,31,38,24,240,2,1,H,-3,-4,12,155,-7,-8,-11,1,0,2004
15,15,09/03/2004,Washington State,21,31,31,38,24,240,2,1,New Mexico,17,43,186,31,16,229,3,1,V,3,4,-12,-155,7,8,11,-1,0,2004
16,16,09/04/2004,Air Force,14,53,182,18,9,89,1,1,California,56,44,342,18,12,231,0,0,H,-14,-42,9,-160,0,-3,-142,1,1,2004
17,17,09/04/2004,Akron,10,31,72,36,29,223,2,1,Penn State,48,41,352,23,16,193,0,0,V,-15.5,-38,-10,-280,13,13,30,2,1,2004
18,18,09/04/2004,Alabama,48,44,255,22,16,205,0,0,Utah State,17,25,61,34,17,205,2,0,H,26,31,19,194,-12,-1,0,-2,0,2004
19,19,09/04/2004,Alabama-Birmingham,56,53,343,17,9,173,1,1,Baylor,14,26,58,44,28,228,3,2,H,14,42,27,285,-27,-19,-55,-2,-1,2004
20,20,09/04/2004,Arizona,21,42,136,23,18,171,0,1,Northern Arizona,3,30,104,37,20,176,3,1,H, ,18,12,32,-14,-2,-5,-3,0,2004
21,21,09/04/2004,Arkansas,63,54,221,24,18,327,0,0,New Mexico State,13,29,55,26,17,161,0,3,H,21,50,25,166,-2,1,166,0,-3,2004
22,22,09/04/2004,Arkansas State,20,36,88,37,26,350,1,1,Missouri,52,34,263,24,16,243,1,1,V,-35.5,-32,2,-175,13,10,107,0,0,2004
23,23,09/04/2004,Auburn,31,41,194,24,14,186,1,1,UL-Monroe,0,35,140,23,17,99,1,2,H,34.5,31,6,54,1,-3,87,0,-1,2004
24,24,09/04/2004,Baylor,14,26,58,44,28,228,3,2,Alabama-Birmingham,56,53,343,17,9,173,1,1,V,-14,-42,-27,-285,27,19,55,2,1,2004
25,25,09/04/2004,Boise State,65,47,254,22,16,318,1,2,Idaho,7,33,121,29,13,91,1,1,H,29.5,58,14,133,-7,3,227,0,1,2004
26,26,09/04/2004,Bowling Green,24,19,51,41,24,218,0,1,Oklahoma,40,52,258,31,21,238,1,1,V,-33,-16,-33,-207,10,3,-20,-1,0,2004
27,27,09/04/2004,Brigham Young,20,35,22,33,22,263,1,1,Notre Dame,17,21,11,47,26,265,0,1,H,-6,3,14,11,-14,-4,-2,1,0,2004
28,28,09/04/2004,California,56,44,342,18,12,231,0,0,Air Force,14,53,182,18,9,89,1,1,V,14,42,-9,160,0,3,142,-1,-1,2004
29,29,09/04/2004,Central Michigan,10,34,114,43,23,275,2,0,Indiana,41,51,203,17,11,131,0,2,V,-10,-31,-17,-89,26,12,144,2,-2,2004
30,30,09/04/2004,Cincinnati,6,26,76,37,17,162,0,0,Ohio State,27,43,220,29,16,242,2,1,V,-13,-21,-17,-144,8,1,-80,-2,-1,2004
31,31,09/04/2004,Clemson,37,35,83,41,20,288,2,1,Wake Forest,30,54,254,25,10,156,0,1,H,11.5,7,-19,-171,16,10,132,2,0,2004
32,32,09/04/2004,Colorado,27,45,255,25,13,117,1,0,Colorado State,24,28,44,42,29,403,1,0,H,4.5,3,17,211,-17,-16,-286,0,0,2004
33,33,09/04/2004,Colorado State,24,28,44,42,29,403,1,0,Colorado,27,45,255,25,13,117,1,0,V,-4.5,-3,-17,-211,17,16,286,0,0,2004
34,34,09/04/2004,Connecticut,52,40,144,32,20,386,2,0,Murray State,14,39,76,19,7,91,1,0,H, ,38,1,68,13,13,295,1,0,2004
35,35,09/04/2004,Duke,12,39,175,22,13,90,0,0,Navy,27,57,301,9,8,129,0,3,V,-7,-15,-18,-126,13,5,-39,0,-3,2004
36,36,09/04/2004,East Carolina,23,28,59,51,26,322,2,1,West Virginia,56,56,478,15,6,143,2,0,V,-28,-33,-28,-419,36,20,179,0,1,2004
37,37,09/04/2004,Florida Atlantic,35,39,147,46,29,298,3,0,Hawaii,28,10,27,66,38,302,0,0,V,-25,7,29,120,-20,-9,-4,3,0,2004
38,38,09/04/2004,Georgia,48,31,191,22,11,231,0,0,Georgia Southern,28,63,294,15,6,54,1,1,H, ,20,-32,-103,7,5,177,-1,-1,2004
39,39,09/04/2004,Georgia Tech,28,45,268,22,14,201,1,1,Samford,7,16,42,44,29,169,0,1,H, ,21,29,226,-22,-15,32,1,0,2004
40,40,09/04/2004,Hawaii,28,10,27,66,38,302,0,0,Florida Atlantic,35,39,147,46,29,298,3,0,H,25,-7,-29,-120,20,9,4,-3,0,2004
41,41,09/04/2004,Idaho,7,33,121,29,13,91,1,1,Boise State,65,47,254,22,16,318,1,2,V,-29.5,-58,-14,-133,7,-3,-227,0,-1,2004
42,42,09/04/2004,Illinois,52,48,296,23,18,258,0,0,Florida A+M,13,25,71,55,37,287,2,1,H, ,39,23,225,-32,-19,-29,-2,-1,2004
43,43,09/04/2004,Indiana,41,51,203,17,11,131,0,2,Central Michigan,10,34,114,43,23,275,2,0,H,10,31,17,89,-26,-12,-144,-2,2,2004
44,44,09/04/2004,Iowa,39,57,197,30,18,223,1,0,Kent State,7,19,-13,36,19,123,2,2,H,31,32,38,210,-6,-1,100,-1,-2,2004
45,45,09/04/2004,Iowa State,23,56,202,28,17,176,0,0,Northern Iowa,0,32,36,19,8,63,0,0,H, ,23,24,166,9,9,113,0,0,2004
46,46,09/04/2004,Kansas,21,36,102,31,14,99,1,0,Tulsa,3,35,50,24,11,91,2,1,H,3,18,1,52,7,3,8,-1,-1,2004
47,47,09/04/2004,Kansas State,27,60,306,21,14,196,0,1,Western Kentucky,13,25,77,21,10,182,0,0,H, ,14,35,229,0,4,14,0,1,2004
48,48,09/04/2004,Kent State,7,19,-13,36,19,123,2,2,Iowa,39,57,197,30,18,223,1,0,V,-31,-32,-38,-210,6,1,-100,1,2,2004
49,49,09/04/2004,Louisiana State,22,30,91,44,16,211,1,1,Oregon State,21,31,84,47,26,231,1,2,H,18,1,-1,7,-3,-10,-20,0,-1,2004
50,50,09/04/2004,Marshall,15,34,25,28,14,152,1,1,Troy State,17,42,65,27,13,196,2,0,H,14,-2,-8,-40,1,1,-44,-1,1,2004
51,51,09/04/2004,Maryland,23,46,198,22,12,169,1,2,Northern Illinois,20,38,118,37,19,219,2,1,H,18.5,3,8,80,-15,-7,-50,-1,1,2004
52,52,09/04/2004,Memphis,20,44,126,43,21,266,1,0,Mississippi,13,33,58,31,11,182,0,0,V,-6,7,11,68,12,10,84,1,0,2004
53,53,09/04/2004,Miami-Ohio,10,25,33,40,19,217,5,2,Michigan,43,40,115,28,16,159,1,0,V,-13,-33,-15,-82,12,3,58,4,2,2004
54,54,09/04/2004,Michigan,43,40,115,28,16,159,1,0,Miami-Ohio,10,25,33,40,19,217,5,2,H,13,33,15,82,-12,-3,-58,-4,-2,2004
55,55,09/04/2004,Michigan State,14,22,90,39,22,270,1,2,Rutgers,19,50,174,34,20,241,1,0,V,3,-5,-28,-84,5,2,29,0,2,2004
56,56,09/04/2004,Minnesota,63,68,415,13,11,289,0,0,Toledo,21,21,94,38,24,312,0,1,H,11,42,47,321,-25,-13,-23,0,-1,2004
57,57,09/04/2004,Mississippi,13,33,58,31,11,182,0,0,Memphis,20,44,126,43,21,266,1,0,H,6,-7,-11,-68,-12,-10,-84,-1,0,2004
58,58,09/04/2004,Mississippi State,28,47,199,20,10,111,0,0,Tulane,7,29,70,31,16,135,2,0,H,6.5,21,18,129,-11,-6,-24,-2,0,2004
59,59,09/04/2004,Missouri,52,34,263,24,16,243,1,1,Arkansas State,20,36,88,37,26,350,1,1,H,35.5,32,-2,175,-13,-10,-107,0,0,2004
60,60,09/04/2004,Navy,27,57,301,9,8,129,0,3,Duke,12,39,175,22,13,90,0,0,H,7,15,18,126,-13,-5,39,0,3,2004
61,61,09/04/2004,Nebraska,56,39,363,31,16,218,4,2,Western Illinois,17,35,-3,42,20,223,4,1,H, ,39,4,366,-11,-4,-5,0,1,2004
62,62,09/04/2004,New Mexico State,13,29,55,26,17,161,0,3,Arkansas,63,54,221,24,18,327,0,0,V,-21,-50,-25,-166,2,-1,-166,0,3,2004
63,63,09/04/2004,No Carolina State,42,37,174,32,24,229,0,1,Richmond,0,36,104,27,10,63,2,1,H, ,42,1,70,5,14,166,-2,0,2004
64,64,09/04/2004,North Carolina,49,45,341,24,14,234,1,3,William + Mary,38,31,120,41,23,322,0,0,H, ,11,14,221,-17,-9,-88,1,3,2004
65,65,09/04/2004,North Texas,0,26,38,23,10,92,0,3,Texas,65,60,513,22,15,160,0,0,V,-26,-65,-34,-475,1,-5,-68,0,3,2004
66,66,09/04/2004,Northern Illinois,20,38,118,37,19,219,2,1,Maryland,23,46,198,22,12,169,1,2,V,-18.5,-3,-8,-80,15,7,50,1,-1,2004
67,67,09/04/2004,Notre Dame,17,21,11,47,26,265,0,1,Brigham Young,20,35,22,33,22,263,1,1,V,6,-3,-14,-11,14,4,2,-1,0,2004
68,68,09/04/2004,Ohio,42,52,230,25,14,229,0,1,Virginia Military,14,29,67,39,23,222,1,2,H, ,28,23,163,-14,-9,7,-1,-1,2004
69,69,09/04/2004,Ohio State,27,43,220,29,16,242,2,1,Cincinnati,6,26,76,37,17,162,0,0,H,13,21,17,144,-8,-1,80,2,1,2004
70,70,09/04/2004,Oklahoma,40,52,258,31,21,238,1,1,Bowling Green,24,19,51,41,24,218,0,1,H,33,16,33,207,-10,-3,20,1,0,2004
71,71,09/04/2004,Oklahoma State,31,67,426,8,2,23,0,0,U.C.L.A.,20,33,191,36,16,252,2,2,V,-1.5,11,34,235,-28,-14,-229,-2,-2,2004
72,72,09/04/2004,Oregon State,21,31,84,47,26,231,1,2,Louisiana State,22,30,91,44,16,211,1,1,V,-18,-1,1,-7,3,10,20,0,1,2004
73,73,09/04/2004,Penn State,48,41,352,23,16,193,0,0,Akron,10,31,72,36,29,223,2,1,H,15.5,38,10,280,-13,-13,-30,-2,-1,2004
74,74,09/04/2004,Rutgers,19,50,174,34,20,241,1,0,Michigan State,14,22,90,39,22,270,1,2,H,-3,5,28,84,-5,-2,-29,0,-2,2004
75,75,09/04/2004,San Diego State,38,51,290,41,21,291,2,1,Idaho State,21,17,46,69,37,352,3,1,H, ,17,34,244,-28,-16,-61,-1,0,2004
76,76,09/04/2004,San Jose State,3,37,111,24,15,157,0,0,Stanford,43,39,132,33,20,333,0,0,V,-19,-40,-2,-21,-9,-5,-176,0,0,2004
77,77,09/04/2004,South Carolina,31,57,269,20,13,184,0,1,Vanderbilt,6,22,36,38,24,270,2,2,V,3,25,35,233,-18,-11,-86,-2,-1,2004
78,78,09/04/2004,Southern Methodist,13,39,160,37,18,162,1,2,Texas Tech,27,22,67,66,40,470,0,0,H,-26.5,-14,17,93,-29,-22,-308,1,2,2004
79,79,09/04/2004,Stanford,43,39,132,33,20,333,0,0,San Jose State,3,37,111,24,15,157,0,0,H,19,40,2,21,9,5,176,0,0,2004
80,80,09/04/2004,Temple,14,35,128,24,11,132,0,2,Virginia,44,57,286,24,18,218,0,0,H,-16,-30,-22,-158,0,-7,-86,0,2,2004
81,81,09/04/2004,Texas,65,60,513,22,15,160,0,0,North Texas,0,26,38,23,10,92,0,3,H,26,65,34,475,-1,5,68,0,-3,2004
82,82,09/04/2004,Texas Tech,27,22,67,66,40,470,0,0,Southern Methodist,13,39,160,37,18,162,1,2,V,26.5,14,-17,-93,29,22,308,-1,-2,2004
83,83,09/04/2004,Toledo,21,21,94,38,24,312,0,1,Minnesota,63,68,415,13,11,289,0,0,V,-11,-42,-47,-321,25,13,23,0,1,2004
84,84,09/04/2004,Troy State,17,42,65,27,13,196,2,0,Marshall,15,34,25,28,14,152,1,1,V,-14,2,8,40,-1,-1,44,1,-1,2004
85,85,09/04/2004,Tulane,7,29,70,31,16,135,2,0,Mississippi State,28,47,199,20,10,111,0,0,V,-6.5,-21,-18,-129,11,6,24,2,0,2004
86,86,09/04/2004,Tulsa,3,35,50,24,11,91,2,1,Kansas,21,36,102,31,14,99,1,0,V,-3,-18,-1,-52,-7,-3,-8,1,1,2004
87,87,09/04/2004,U-C-F,6,35,53,24,13,177,1,1,Wisconsin,34,49,230,20,9,170,0,1,V,-23,-28,-14,-177,4,4,7,1,0,2004
88,88,09/04/2004,U.C.L.A.,20,33,191,36,16,252,2,2,Oklahoma State,31,67,426,8,2,23,0,0,H,1.5,-11,-34,-235,28,14,229,2,2,2004
89,89,09/04/2004,UL-Lafayette,14,42,112,26,17,176,1,1,Northwestern St(LA),7,40,177,31,16,166,1,3,H, ,7,2,-65,-5,1,10,0,-2,2004
90,90,09/04/2004,UL-Monroe,0,35,140,23,17,99,1,2,Auburn,31,41,194,24,14,186,1,1,V,-34.5,-31,-6,-54,-1,3,-87,0,1,2004
91,91,09/04/2004,Utah State,17,25,61,34,17,205,2,0,Alabama,48,44,255,22,16,205,0,0,V,-26,-31,-19,-194,12,1,0,2,0,2004
92,92,09/04/2004,Vanderbilt,6,22,36,38,24,270,2,2,South Carolina,31,57,269,20,13,184,0,1,H,-3,-25,-35,-233,18,11,86,2,1,2004
93,93,09/04/2004,Virginia,44,57,286,24,18,218,0,0,Temple,14,35,128,24,11,132,0,2,V,16,30,22,158,0,7,86,0,-2,2004
94,94,09/04/2004,Wake Forest,30,54,254,25,10,156,0,1,Clemson,37,35,83,41,20,288,2,1,V,-11.5,-7,19,171,-16,-10,-132,-2,0,2004
95,95,09/04/2004,West Virginia,56,56,478,15,6,143,2,0,East Carolina,23,28,59,51,26,322,2,1,H,28,33,28,419,-36,-20,-179,0,-1,2004
96,96,09/04/2004,Wisconsin,34,49,230,20,9,170,0,1,U-C-F,6,35,53,24,13,177,1,1,H,23,28,14,177,-4,-4,-7,-1,0,2004
97,97,09/04/2004,Wyoming,53,51,266,32,18,271,0,1,Appalachian State,7,32,30,31,16,200,3,2,H, ,46,19,236,1,2,71,-3,-1,2004
98,98,09/05/2004,Fresno State,35,35,137,21,13,125,1,1,Washington,16,41,170,48,21,190,4,1,V,2,19,-6,-33,-27,-8,-65,-3,0,2004
99,99,09/05/2004,Houston,7,32,8,33,15,204,1,1,Rice,10,55,158,7,3,28,1,1,V,5,-3,-23,-150,26,12,176,0,0,2004
100,100,09/05/2004,Kentucky,0,26,66,34,14,172,2,1,Louisville,28,49,261,21,14,178,1,0,V,-10,-28,-23,-195,13,0,-6,1,1,2004
101,101,09/05/2004,Louisville,28,49,261,21,14,178,1,0,Kentucky,0,26,66,34,14,172,2,1,H,10,28,23,195,-13,0,6,-1,-1,2004
102,102,09/05/2004,Nevada-Las Vegas,17,37,164,25,13,175,1,1,Tennessee,42,45,272,27,17,241,0,1,V,-16.5,-25,-8,-108,-2,-4,-66,1,0,2004
103,103,09/05/2004,Purdue,51,41,237,32,17,334,0,0,Syracuse,0,32,40,26,15,157,2,1,H,12.5,51,9,197,6,2,177,-2,-1,2004
104,104,09/05/2004,Rice,10,55,158,7,3,28,1,1,Houston,7,32,8,33,15,204,1,1,H,-5,3,23,150,-26,-12,-176,0,0,2004
105,105,09/05/2004,Syracuse,0,32,40,26,15,157,2,1,Purdue,51,41,237,32,17,334,0,0,V,-12.5,-51,-9,-197,-6,-2,-177,2,1,2004
106,106,09/05/2004,Tennessee,42,45,272,27,17,241,0,1,Nevada-Las Vegas,17,37,164,25,13,175,1,1,H,16.5,25,8,108,2,4,66,-1,0,2004
107,107,09/05/2004,Washington,16,41,170,48,21,190,4,1,Fresno State,35,35,137,21,13,125,1,1,H,-2,-19,6,33,27,8,65,3,0,2004
108,108,09/06/2004,Louisiana Tech,38,47,331,16,8,149,1,3,Nevada-Reno,21,34,7,38,23,244,0,2,H,6.5,17,13,324,-22,-15,-95,1,1,2004
109,109,09/06/2004,Nevada-Reno,21,34,7,38,23,244,0,2,Louisiana Tech,38,47,331,16,8,149,1,3,V,-6.5,-17,-13,-324,22,15,95,-1,-1,2004
110,110,09/09/2004,Missouri,14,36,112,46,25,224,2,1,Troy State,24,41,172,21,8,121,3,0,V,10,-10,-5,-60,25,17,103,-1,1,2004
111,111,09/09/2004,Troy State,24,41,172,21,8,121,3,0,Missouri,14,36,112,46,25,224,2,1,H,-10,10,5,60,-25,-17,-103,1,-1,2004
112,112,09/10/2004,Boise State,53,52,246,35,21,246,1,0,Oregon State,34,15,58,42,22,411,4,0,H,7.5,19,37,188,-7,-1,-165,-3,0,2004
113,113,09/10/2004,Florida State,10,35,57,28,12,108,2,2,Miami-Florida,16,32,109,36,20,255,1,2,V,-1.5,-6,3,-52,-8,-8,-147,1,0,2004
114,114,09/10/2004,Miami-Florida,16,32,109,36,20,255,1,2,Florida State,10,35,57,28,12,108,2,2,H,1.5,6,-3,52,8,8,147,-1,0,2004
115,115,09/10/2004,Oregon State,34,15,58,42,22,411,4,0,Boise State,53,52,246,35,21,246,1,0,V,-7.5,-19,-37,-188,7,1,165,3,0,2004
116,116,09/11/2004,Air Force,42,52,353,16,11,145,1,0,Eastern Washington,20,40,120,38,21,293,1,1,H, ,22,12,233,-22,-10,-148,0,-1,2004
117,117,09/11/2004,Akron,24,34,103,44,31,399,1,2,Mid Tennessee St,31,29,64,41,33,339,2,2,H,7,-7,5,39,3,-2,60,-1,0,2004
118,118,09/11/2004,Alabama,28,47,221,22,14,169,0,2,Mississippi,7,29,75,27,10,117,0,1,H,11,21,18,146,-5,4,52,0,1,2004
119,119,09/11/2004,Arizona,6,33,114,25,19,198,1,3,Utah,23,38,156,22,12,170,0,0,H,-12.5,-17,-5,-42,3,7,28,1,3,2004
120,120,09/11/2004,Arizona State,30,41,139,36,19,292,0,0,Northwestern,21,42,235,38,21,228,0,1,V,-1.5,9,-1,-96,-2,-2,64,0,-1,2004
121,121,09/11/2004,Arkansas,20,45,175,29,14,283,2,2,Texas,22,46,259,22,11,150,0,0,H,-11,-2,-1,-84,7,3,133,2,2,2004
122,122,09/11/2004,Arkansas State,3,33,54,22,9,147,1,2,Louisiana State,53,40,251,20,12,210,0,1,V,-40.5,-50,-7,-197,2,-3,-63,1,1,2004
123,123,09/11/2004,Army,21,27,133,32,17,217,0,1,Louisville,52,54,230,34,26,342,0,1,H,-23,-31,-27,-97,-2,-9,-125,0,0,2004
124,124,09/11/2004,Auburn,43,41,283,22,13,182,0,1,Mississippi State,14,29,81,36,24,190,1,0,V,13,29,12,202,-14,-11,-8,-1,1,2004
125,125,09/11/2004,Ball State,7,37,71,16,11,126,0,0,Purdue,59,42,231,30,26,368,0,0,V,-29,-52,-5,-160,-14,-15,-242,0,0,2004
126,126,09/11/2004,Baylor,24,46,89,29,16,224,2,0,Texas State,17,40,131,27,12,164,0,2,H, ,7,6,-42,2,4,60,2,-2,2004
127,127,09/11/2004,Boston College,21,40,129,31,23,199,0,1,Penn State,7,21,73,41,23,254,4,1,H,-1.5,14,19,56,-10,0,-55,-4,0,2004
128,128,09/11/2004,Bowling Green,49,50,216,38,24,285,1,1,S E Missouri St,10,24,81,41,27,278,1,3,H, ,39,26,135,-3,-3,7,0,-2,2004
129,129,09/11/2004,Brigham Young,10,27,41,56,28,288,4,3,Stanford,37,35,72,42,20,297,0,2,V,-3.5,-27,-8,-31,14,8,-9,4,1,2004
130,130,09/11/2004,Buffalo,17,39,109,32,16,122,2,1,Syracuse,37,48,191,24,9,84,1,2,H,-16.5,-20,-9,-82,8,7,38,1,-1,2004
131,131,09/11/2004,California,41,41,336,28,21,275,0,2,New Mexico State,14,36,37,23,14,175,0,0,H,32,27,5,299,5,7,100,0,2,2004
132,132,09/11/2004,Central Michigan,7,44,236,30,10,93,0,0,Michigan State,24,44,213,22,10,192,0,0,V,-25.5,-17,0,23,8,0,-99,0,0,2004
133,133,09/11/2004,Cincinnati,45,43,341,23,12,258,1,1,Miami-Ohio,26,24,37,43,26,416,0,1,H,-2.5,19,19,304,-20,-14,-158,1,0,2004
134,134,09/11/2004,Clemson,24,30,199,44,20,275,2,0,Georgia Tech,28,48,112,36,20,251,1,0,H,7,-4,-18,87,8,0,24,1,0,2004
135,135,09/11/2004,Colorado,20,37,47,24,12,78,1,2,Washington State,12,40,15,52,19,387,1,2,N,-3,8,-3,32,-28,-7,-309,0,0,2004
136,136,09/11/2004,Colorado State,0,27,48,35,19,233,4,2,Southern Cal,49,45,322,31,20,231,0,2,V,-24.5,-49,-18,-274,4,-1,2,4,0,2004
137,137,09/11/2004,Connecticut,22,35,112,34,23,290,1,1,Duke,20,32,61,29,16,184,1,1,H,13.5,2,3,51,5,7,106,0,0,2004
138,138,09/11/2004,Duke,20,32,61,29,16,184,1,1,Connecticut,22,35,112,34,23,290,1,1,V,-13.5,-2,-3,-51,-5,-7,-106,0,0,2004
139,139,09/11/2004,East Carolina,17,23,236,40,20,233,2,0,Wake Forest,31,57,240,21,16,344,1,1,H,-17.5,-14,-34,-4,19,4,-111,1,-1,2004
140,140,09/11/2004,Eastern Michigan,10,36,95,40,19,201,0,1,Florida,49,38,159,28,17,250,0,1,V,-38,-39,-2,-64,12,2,-49,0,0,2004
141,141,09/11/2004,Florida,49,38,159,28,17,250,0,1,Eastern Michigan,10,36,95,40,19,201,0,1,H,38,39,2,64,-12,-2,49,0,0,2004
142,142,09/11/2004,Florida Atlantic,20,44,177,28,20,280,0,1,North Texas,13,36,116,22,8,165,0,0,V,-7.5,7,8,61,6,12,115,0,1,2004
143,143,09/11/2004,Fresno State,45,48,156,30,17,244,3,0,Kansas State,21,33,59,23,8,121,2,0,V,-13.5,24,15,97,7,9,123,1,0,2004
144,144,09/11/2004,Georgia,20,37,154,38,19,213,1,2,South Carolina,16,31,73,21,13,200,1,1,V,8.5,4,6,81,17,6,13,0,1,2004
145,145,09/11/2004,Georgia Tech,28,48,112,36,20,251,1,0,Clemson,24,30,199,44,20,275,2,0,V,-7,4,18,-87,-8,0,-24,-1,0,2004
146,146,09/11/2004,Houston,13,37,61,22,15,221,0,1,Oklahoma,63,49,281,27,22,307,0,1,V,-35.5,-50,-12,-220,-5,-7,-86,0,0,2004
147,147,09/11/2004,Idaho,7,46,134,23,17,101,1,1,Utah State,14,25,58,31,20,214,2,3,V,-10.5,-7,21,76,-8,-3,-113,-1,-2,2004
148,148,09/11/2004,Illinois,17,41,208,38,23,248,1,2,U.C.L.A.,35,47,273,21,14,208,1,0,H,-3,-18,-6,-65,17,9,40,0,2,2004
149,149,09/11/2004,Indiana,30,53,127,18,6,71,1,1,Oregon,24,33,178,45,24,317,3,4,V,-20.5,6,20,-51,-27,-18,-246,-2,-3,2004
150,150,09/11/2004,Iowa,17,47,102,22,16,220,1,0,Iowa State,10,34,66,30,15,170,0,0,H,25,7,13,36,-8,1,50,1,0,2004
151,151,09/11/2004,Iowa State,10,34,66,30,15,170,0,0,Iowa,17,44,85,22,16,220,1,0,V,-25,-7,-10,-19,8,-1,-50,-1,0,2004
152,152,09/11/2004,Kansas,63,41,174,36,25,327,1,1,Toledo,14,37,64,35,17,234,2,3,H,3,49,4,110,1,8,93,-1,-2,2004
153,153,09/11/2004,Kansas State,21,33,59,23,8,121,2,0,Fresno State,45,48,156,30,17,244,3,0,H,13.5,-24,-15,-97,-7,-9,-123,-1,0,2004
154,154,09/11/2004,Kent State,38,37,201,30,20,144,1,1,Liberty,10,52,197,26,9,112,2,0,H, ,28,-15,4,4,11,32,-1,1,2004
155,155,09/11/2004,Louisiana State,53,40,251,20,12,210,0,1,Arkansas State,3,33,54,22,9,147,1,2,H,40.5,50,7,197,-2,3,63,-1,-1,2004
156,156,09/11/2004,Louisiana Tech,24,43,258,28,17,193,1,2,UL-Lafayette,20,27,83,55,32,327,2,0,H,14,4,16,175,-27,-15,-134,-1,2,2004
157,157,09/11/2004,Louisville,52,54,230,34,26,342,0,1,Army,21,27,133,32,17,217,0,1,V,23,31,27,97,2,9,125,0,0,2004
158,158,09/11/2004,Marshall,21,44,150,35,22,140,0,0,Ohio State,24,26,79,33,18,318,2,2,V,-16,-3,18,71,2,4,-178,-2,-2,2004
159,159,09/11/2004,Maryland,45,49,203,28,18,268,0,1,Temple,22,37,158,27,16,188,0,2,H,26,23,12,45,1,2,80,0,-1,2004
160,160,09/11/2004,Memphis,52,35,160,28,12,336,1,0,Chattanooga,21,44,73,38,21,265,0,2,H, ,31,-9,87,-10,-9,71,1,-2,2004
161,161,09/11/2004,Miami-Ohio,26,24,37,43,26,416,0,1,Cincinnati,45,43,341,23,12,258,1,1,V,2.5,-19,-19,-304,20,14,158,-1,0,2004
162,162,09/11/2004,Michigan,20,30,56,40,25,240,1,2,Notre Dame,28,40,135,21,10,178,3,1,V,13,-8,-10,-79,19,15,62,-2,1,2004
163,163,09/11/2004,Michigan State,24,44,213,22,10,192,0,0,Central Michigan,7,44,236,30,10,93,0,0,H,25.5,17,0,-23,-8,0,99,0,0,2004
164,164,09/11/2004,Mid Tennessee St,31,29,64,41,33,339,2,2,Akron,24,34,103,44,31,399,1,2,V,-7,7,-5,-39,-3,2,-60,1,0,2004
165,165,09/11/2004,Minnesota,37,42,303,23,11,206,0,1,Illinois State,21,30,108,59,33,372,2,0,H, ,16,12,195,-36,-22,-166,-2,1,2004
166,166,09/11/2004,Mississippi,7,29,75,27,10,117,0,1,Alabama,28,47,221,22,14,169,0,2,V,-11,-21,-18,-146,5,-4,-52,0,-1,2004
167,167,09/11/2004,Mississippi State,14,29,81,36,24,190,1,0,Auburn,43,41,283,22,13,182,0,1,H,-13,-29,-12,-202,14,11,8,1,-1,2004
168,168,09/11/2004,Navy,28,58,300,6,2,36,2,1,Northeastern,24,32,108,29,20,176,3,1,H, ,4,26,192,-23,-18,-140,-1,0,2004
169,169,09/11/2004,Nebraska,17,46,274,42,22,202,3,2,Southern Miss,21,33,97,28,12,142,1,0,H,14,-4,13,177,14,10,60,2,2,2004
170,170,09/11/2004,Nevada-Las Vegas,3,27,72,29,13,102,0,0,Wisconsin,18,44,145,24,14,131,1,0,V,-16,-15,-17,-73,5,-1,-29,-1,0,2004
171,171,09/11/2004,Nevada-Reno,59,51,312,33,24,286,0,0,Sacramento State,7,29,12,19,11,119,0,0,H, ,52,22,300,14,13,167,0,0,2004
172,172,09/11/2004,New Mexico,27,39,142,26,12,173,0,2,Texas Tech,24,22,46,70,44,449,2,1,H,-4,3,17,96,-44,-32,-276,-2,1,2004
173,173,09/11/2004,New Mexico State,14,36,37,23,14,175,0,0,California,41,41,336,28,21,275,0,2,V,-32,-27,-5,-299,-5,-7,-100,0,-2,2004
174,174,09/11/2004,North Carolina,24,35,135,24,19,299,1,1,Virginia,56,48,299,16,13,250,0,0,V,-20.5,-32,-13,-164,8,6,49,1,1,2004
175,175,09/11/2004,North Texas,13,36,116,22,8,165,0,0,Florida Atlantic,20,44,177,28,20,280,0,1,H,7.5,-7,-8,-61,-6,-12,-115,0,-1,2004
176,176,09/11/2004,Northern Illinois,23,41,191,23,12,209,0,0,Southern Illinois,22,39,172,27,16,208,0,1,H, ,1,2,19,-4,-4,1,0,-1,2004
177,177,09/11/2004,Northwestern,21,42,235,38,21,228,0,1,Arizona State,30,41,139,36,19,292,0,1,H,1.5,-9,1,96,2,2,-64,0,0,2004
178,178,09/11/2004,Notre Dame,28,40,135,21,10,178,3,1,Michigan,20,30,56,40,25,240,1,2,H,-13,8,10,79,-19,-15,-62,2,-1,2004
179,179,09/11/2004,Ohio,3,26,88,51,22,202,2,1,Pittsburgh,24,47,168,19,6,49,1,0,V,-18,-21,-21,-80,32,16,153,1,1,2004
180,180,09/11/2004,Ohio State,24,26,79,33,18,318,2,2,Marshall,21,44,150,35,22,140,0,0,H,16,3,-18,-71,-2,-4,178,2,2,2004
181,181,09/11/2004,Oklahoma,63,49,276,27,22,307,0,1,Houston,13,37,61,22,15,221,0,1,H,35.5,50,12,215,5,7,86,0,0,2004
182,182,09/11/2004,Oklahoma State,38,60,276,8,3,70,0,0,Tulsa,21,35,100,28,15,168,0,1,H,20,17,25,176,-20,-12,-98,0,-1,2004
183,183,09/11/2004,Oregon,24,33,178,45,24,317,3,4,Indiana,30,53,127,18,6,71,1,1,H,20.5,-6,-20,51,27,18,246,2,3,2004
184,184,09/11/2004,Penn State,7,21,73,41,23,254,4,1,Boston College,21,40,129,31,23,199,0,1,V,1.5,-14,-19,-56,10,0,55,4,0,2004
185,185,09/11/2004,Pittsburgh,24,47,168,19,6,49,1,0,Ohio,3,26,88,51,22,202,2,1,H,18,21,21,80,-32,-16,-153,-1,-1,2004
186,186,09/11/2004,Purdue,59,42,231,30,26,368,0,0,Ball State,7,37,71,16,11,126,0,0,H,29,52,5,160,14,15,242,0,0,2004
187,187,09/11/2004,Rutgers,24,36,50,50,30,307,1,1,New Hampshire,35,31,66,40,30,385,1,1,H, ,-11,5,-16,10,0,-78,0,0,2004
188,188,09/11/2004,South Carolina,16,31,73,21,13,200,1,1,Georgia,20,37,154,38,19,213,1,2,H,-8.5,-4,-6,-81,-17,-6,-13,0,-1,2004
189,189,09/11/2004,South Florida,21,43,185,23,13,93,1,1,Tennessee Tech,7,33,16,38,14,129,1,0,H, ,14,10,169,-15,-1,-36,0,1,2004
190,190,09/11/2004,Southern Cal,49,45,322,31,20,231,0,2,Colorado State,0,27,48,35,19,233,4,2,H,24.5,49,18,274,-4,1,-2,-4,0,2004
191,191,09/11/2004,Southern Methodist,0,30,6,29,14,164,2,1,Texas Christian,44,51,165,35,26,397,0,0,V,-23,-44,-21,-159,-6,-12,-233,2,1,2004
192,192,09/11/2004,Southern Miss,21,33,97,28,12,142,1,0,Nebraska,17,46,274,42,22,202,3,2,V,-14,4,-13,-177,-14,-10,-60,-2,-2,2004
193,193,09/11/2004,Stanford,37,35,72,42,20,297,0,2,Brigham Young,10,27,41,56,28,288,4,3,H,3.5,27,8,31,-14,-8,9,-4,-1,2004
194,194,09/11/2004,Syracuse,37,48,191,24,9,84,1,2,Buffalo,17,39,109,32,16,122,2,1,V,16.5,20,9,82,-8,-7,-38,-1,1,2004
195,195,09/11/2004,Temple,22,36,158,27,16,188,0,2,Maryland,45,49,203,28,18,268,0,1,V,-26,-23,-13,-45,-1,-2,-80,0,1,2004
196,196,09/11/2004,Texas,22,46,259,22,11,150,0,0,Arkansas,20,45,175,29,14,283,2,2,V,11,2,1,84,-7,-3,-133,-2,-2,2004
197,197,09/11/2004,Texas A+M,31,42,156,29,20,325,0,0,Wyoming,0,26,-3,36,19,184,3,0,H,11.5,31,16,159,-7,1,141,-3,0,2004
198,198,09/11/2004,Texas Christian,44,51,165,35,26,397,0,1,Southern Methodist,0,30,6,29,14,164,2,1,H,23,44,21,159,6,12,233,-2,0,2004
199,199,09/11/2004,Texas Tech,24,22,46,70,44,449,2,1,New Mexico,27,39,142,26,12,173,0,2,V,4,-3,-17,-96,44,32,276,2,-1,2004
200,200,09/11/2004,Texas-El Paso,32,54,276,29,18,223,0,0,Weber State,0,25,34,26,9,78,1,1,H, ,32,29,242,3,9,145,-1,-1,2004
201,201,09/11/2004,Toledo,14,37,64,35,17,234,2,3,Kansas,63,41,174,36,25,327,1,1,V,-3,-49,-4,-110,-1,-8,-93,1,2,2004
202,202,09/11/2004,Tulane,39,44,233,24,16,224,1,2,Florida A+M,19,40,74,42,31,314,0,1,H, ,20,4,159,-18,-15,-90,1,1,2004
203,203,09/11/2004,Tulsa,21,35,100,28,15,168,0,1,Oklahoma State,38,60,276,8,3,70,0,0,V,-20,-17,-25,-176,20,12,98,0,1,2004
204,204,09/11/2004,U-C-F,20,46,169,25,13,130,0,0,West Virginia,45,45,235,18,14,225,0,2,H,-20,-25,1,-66,7,-1,-95,0,-2,2004
205,205,09/11/2004,U.C.L.A.,35,47,273,21,14,208,1,0,Illinois,17,41,208,38,23,248,1,2,V,3,18,6,65,-17,-9,-40,0,-2,2004
206,206,09/11/2004,UL-Lafayette,20,27,83,55,32,327,2,0,Louisiana Tech,24,43,304,28,17,193,1,2,V,-14,-4,-16,-221,27,15,134,1,-2,2004
207,207,09/11/2004,Utah,23,38,156,22,12,170,0,0,Arizona,6,33,114,25,19,198,1,3,V,12.5,17,5,42,-3,-7,-28,-1,-3,2004
208,208,09/11/2004,Utah State,14,25,58,31,20,214,2,3,Idaho,7,46,134,23,17,101,1,1,H,10.5,7,-21,-76,8,3,113,1,2,2004
209,209,09/11/2004,Virginia,56,48,299,16,13,250,0,0,North Carolina,24,34,135,24,19,299,1,1,H,20.5,32,14,164,-8,-6,-49,-1,-1,2004
210,210,09/11/2004,Virginia Tech,63,35,155,25,19,332,1,0,Western Michigan,0,31,109,39,26,163,2,2,H,24.5,63,4,46,-14,-7,169,-1,-2,2004
211,211,09/11/2004,Wake Forest,31,57,240,21,16,344,1,1,East Carolina,17,23,236,40,20,233,2,0,V,17.5,14,34,4,-19,-4,111,-1,1,2004
212,212,09/11/2004,Washington State,12,40,15,52,19,387,1,2,Colorado,20,37,47,24,12,78,1,2,N,3,-8,3,-32,28,7,309,0,0,2004
213,213,09/11/2004,West Virginia,45,45,235,18,14,225,0,2,U-C-F,20,46,169,25,13,130,0,0,V,20,25,-1,66,-7,1,95,0,2,2004
214,214,09/11/2004,Western Michigan,0,31,109,39,26,163,2,2,Virginia Tech,63,35,155,25,19,332,1,0,V,-24.5,-63,-4,-46,14,7,-169,1,2,2004
215,215,09/11/2004,Wisconsin,18,44,145,24,14,131,1,0,Nevada-Las Vegas,3,27,72,29,13,102,0,0,H,16,15,17,73,-5,1,29,1,0,2004
216,216,09/11/2004,Wyoming,0,26,-3,36,19,184,3,0,Texas A+M,31,42,156,29,20,325,0,0,V,-11.5,-31,-16,-159,7,-1,-141,3,0,2004
217,217,09/17/2004,Boston College,27,43,141,23,14,193,1,1,Connecticut,7,29,98,32,22,193,1,1,H,8,20,14,43,-9,-8,0,0,0,2004
218,218,09/17/2004,Connecticut,7,29,98,32,22,193,1,1,Boston College,27,43,141,23,14,193,1,1,V,-8,-20,-14,-43,9,8,0,0,0,2004
219,219,09/18/2004,Air Force,27,71,278,14,12,139,0,0,Nevada-Las Vegas,10,24,98,27,12,160,2,1,V,-6.5,17,47,180,-13,0,-21,-2,-1,2004
220,220,09/18/2004,Akron,0,31,6,27,12,78,2,0,Virginia,51,42,326,33,21,196,1,0,V,-31,-51,-11,-320,-6,-9,-118,1,0,2004
221,221,09/18/2004,Alabama,52,42,247,31,20,231,0,1,Western Carolina,0,30,83,24,8,108,2,3,H, ,52,12,164,7,12,123,-2,-2,2004
222,222,09/18/2004,Alabama-Birmingham,7,28,-24,22,10,168,1,0,Florida State,34,47,251,38,24,238,1,0,V,-24.5,-27,-19,-275,-16,-14,-70,0,0,2004
223,223,09/18/2004,Arizona,7,33,96,15,9,103,0,0,Wisconsin,9,46,146,24,12,116,0,2,H,-10.5,-2,-13,-50,-9,-3,-13,0,-2,2004
224,224,09/18/2004,Arizona State,44,34,76,46,33,435,1,0,Iowa,7,27,56,19,8,44,1,0,H,1,37,7,20,27,25,391,0,0,2004
225,225,09/18/2004,Arkansas,49,44,289,29,19,282,1,1,UL-Monroe,20,34,93,34,15,303,3,1,H,29,29,10,196,-5,4,-21,-2,0,2004
226,226,09/18/2004,Arkansas State,35,32,89,41,29,418,3,1,Memphis,47,45,175,43,22,356,1,1,H,-23,-12,-13,-86,-2,7,62,2,0,2004
227,227,09/18/2004,Army,21,31,234,21,7,103,1,0,Houston,35,57,369,34,20,278,1,1,V,-15,-14,-26,-135,-13,-13,-175,0,-1,2004
228,228,09/18/2004,Auburn,10,34,131,27,16,170,0,1,Louisiana State,9,39,140,28,12,168,1,1,H,2,1,-5,-9,-1,4,2,-1,0,2004
229,229,09/18/2004,Ball State,0,36,65,19,12,77,1,1,Missouri,48,38,203,36,21,268,0,0,V,-26,-48,-2,-138,-17,-9,-191,1,1,2004
230,230,09/18/2004,Boise State,47,49,175,37,26,392,2,2,Texas-El Paso,31,28,56,33,16,235,2,0,V,28.5,16,21,119,4,10,157,0,2,2004
231,231,09/18/2004,Brigham Young,10,24,27,34,18,194,3,1,Southern Cal,42,50,291,35,22,236,1,0,H,-26,-32,-26,-264,-1,-4,-42,2,1,2004
232,232,09/18/2004,Buffalo,13,43,183,28,11,105,2,0,Nevada-Reno,38,46,207,32,16,234,1,0,V,-14.5,-25,-3,-24,-4,-5,-129,1,0,2004
233,233,09/18/2004,Central Michigan,44,42,195,33,17,303,0,0,S E Missouri St,27,30,87,52,32,304,1,0,H, ,17,12,108,-19,-15,-1,-1,0,2004
234,234,09/18/2004,Cincinnati,7,36,138,26,14,155,4,2,Syracuse,19,44,192,18,11,161,2,1,V,1,-12,-8,-54,8,3,-6,2,1,2004
235,235,09/18/2004,Clemson,6,27,45,35,20,192,3,1,Texas A+M,27,53,324,26,14,178,0,0,V,2,-21,-26,-279,9,6,14,3,1,2004
236,236,09/18/2004,Colorado,52,37,203,35,28,383,0,0,North Texas,21,40,258,36,21,249,0,1,H,18,31,-3,-55,-1,7,134,0,-1,2004
237,237,09/18/2004,Colorado State,16,35,126,41,25,298,3,1,Minnesota,34,52,360,21,12,144,0,0,H,-4,-18,-17,-234,20,13,154,3,1,2004
238,238,09/18/2004,Duke,17,42,108,20,6,89,2,0,Virginia Tech,41,45,250,25,13,172,2,0,V,-25,-24,-3,-142,-5,-7,-83,0,0,2004
239,239,09/18/2004,Eastern Michigan,32,46,224,50,25,314,2,0,Toledo,42,47,204,27,22,338,0,1,H,-7,-10,-1,20,23,3,-24,2,-1,2004
240,240,09/18/2004,Florida,28,35,135,31,22,286,1,0,Tennessee,30,44,171,30,19,232,1,2,V,-3,-2,-9,-36,1,3,54,0,-2,2004
241,241,09/18/2004,Florida Atlantic,27,35,87,33,23,335,0,0,Mid Tennessee St,20,29,67,40,28,364,3,0,V,-1.5,7,6,20,-7,-5,-29,-3,0,2004
242,242,09/18/2004,Florida State,34,47,251,38,24,238,1,0,Alabama-Birmingham,7,28,-24,22,10,168,1,0,H,24.5,27,19,275,16,14,70,0,0,2004
243,243,09/18/2004,Fresno State,27,46,263,25,13,142,2,1,Portland State,17,39,116,38,15,160,2,1,H, ,10,7,147,-13,-2,-18,0,0,2004
244,244,09/18/2004,Georgia,13,41,146,31,18,225,0,1,Marshall,3,23,37,23,11,123,0,0,H,18.5,10,18,109,8,7,102,0,1,2004
245,245,09/18/2004,Georgia Tech,13,43,229,29,12,164,3,2,North Carolina,34,47,271,22,10,142,2,0,V,9.5,-21,-4,-42,7,2,22,1,2,2004
246,246,09/18/2004,Hawaii,29,13,7,51,34,363,0,0,Rice,41,64,405,12,5,118,0,2,V,-1,-12,-51,-398,39,29,245,0,-2,2004
247,247,09/18/2004,Houston,35,57,369,34,20,278,1,1,Army,21,31,234,21,7,103,1,0,H,15,14,26,135,13,13,175,0,1,2004
248,248,09/18/2004,Idaho,8,40,130,24,18,145,1,3,Washington State,49,46,286,21,13,223,0,1,H,-24,-41,-6,-156,3,5,-78,1,2,2004
249,249,09/18/2004,Illinois,30,45,176,19,10,177,2,1,Western Michigan,27,35,133,41,27,273,1,1,H,9.5,3,10,43,-22,-17,-96,1,0,2004
250,250,09/18/2004,Indiana,32,39,176,26,12,236,1,1,Kentucky,51,43,355,30,21,205,0,1,V,-2,-19,-4,-179,-4,-9,31,1,0,2004
251,251,09/18/2004,Iowa,7,27,56,19,8,44,1,0,Arizona State,44,34,76,46,33,435,1,0,V,-1,-37,-7,-20,-27,-25,-391,0,0,2004
252,252,09/18/2004,Iowa State,48,39,117,28,14,225,2,0,Northern Illinois,41,46,117,33,20,285,4,0,H,2,7,-7,0,-5,-6,-60,-2,0,2004
253,253,09/18/2004,Kansas,17,26,47,51,32,303,0,1,Northwestern,20,32,145,33,20,192,0,0,V,-2,-3,-6,-98,18,12,111,0,1,2004
254,254,09/18/2004,Kansas State,40,62,393,10,7,52,0,2,UL-Lafayette,20,34,214,23,9,128,2,1,H,31,20,28,179,-13,-2,-76,-2,1,2004
255,255,09/18/2004,Kent State,21,38,30,47,29,311,1,3,Rutgers,29,36,88,30,19,238,2,1,V,-12.5,-8,2,-58,17,10,73,-1,2,2004
256,256,09/18/2004,Kentucky,51,43,355,30,21,205,0,1,Indiana,32,39,176,26,12,236,1,1,H,2,19,4,179,4,9,-31,-1,0,2004
257,257,09/18/2004,Louisiana State,9,39,140,28,12,168,1,1,Auburn,10,34,131,27,16,170,0,1,V,-2,-1,5,9,1,-4,-2,1,0,2004
258,258,09/18/2004,Louisiana Tech,0,41,56,20,8,121,0,3,Miami-Florida,48,35,184,21,11,167,1,0,V,-31,-48,6,-128,-1,-3,-46,-1,3,2004
259,259,09/18/2004,Marshall,3,23,37,23,11,123,0,0,Georgia,13,41,146,31,18,231,0,1,V,-18.5,-10,-18,-109,-8,-7,-108,0,-1,2004
260,260,09/18/2004,Maryland,16,41,187,20,9,108,3,2,West Virginia,19,61,220,22,10,132,0,1,V,-6.5,-3,-20,-33,-2,-1,-24,3,1,2004
261,261,09/18/2004,Memphis,47,45,175,43,22,356,1,1,Arkansas State,35,32,89,41,29,418,3,1,V,23,12,13,86,2,-7,-62,-2,0,2004
262,262,09/18/2004,Miami-Florida,48,35,184,22,12,167,1,0,Louisiana Tech,0,41,52,20,8,131,0,3,H,31,48,-6,132,2,4,36,1,-3,2004
263,263,09/18/2004,Miami-Ohio,40,36,146,32,21,268,1,2,Ohio,20,34,9,39,23,253,0,1,H,18,20,2,137,-7,-2,15,1,1,2004
264,264,09/18/2004,Michigan,24,48,148,28,14,179,3,1,San Diego State,21,23,22,43,27,289,1,2,H,21,3,25,126,-15,-13,-110,2,-1,2004
265,265,09/18/2004,Michigan State,24,35,165,34,15,176,3,3,Notre Dame,31,48,173,24,11,215,1,2,H,-3,-7,-13,-8,10,4,-39,2,1,2004
266,266,09/18/2004,Mid Tennessee St,20,29,67,40,28,364,3,0,Florida Atlantic,27,35,87,33,23,335,0,0,H,1.5,-7,-6,-20,7,5,29,3,0,2004
267,267,09/18/2004,Minnesota,34,52,360,21,12,144,0,0,Colorado State,16,35,126,41,25,298,3,1,V,4,18,17,234,-20,-13,-154,-3,-1,2004
268,268,09/18/2004,Mississippi,26,39,170,36,23,195,0,1,Vanderbilt,23,47,183,17,9,131,1,1,H,7,3,-8,-13,19,14,64,-1,0,2004
269,269,09/18/2004,Mississippi State,7,37,124,35,21,250,1,2,Maine,9,37,102,19,10,124,2,0,H, ,-2,0,22,16,11,126,-1,2,2004
270,270,09/18/2004,Missouri,48,38,203,36,21,268,0,0,Ball State,0,36,65,19,12,77,1,1,H,26,48,2,138,17,9,191,-1,-1,2004
271,271,09/18/2004,Navy,29,68,330,8,6,117,0,1,Tulsa,0,34,100,40,20,220,2,0,V,0,29,34,230,-32,-14,-103,-2,1,2004
272,272,09/18/2004,Nebraska,24,43,123,23,11,142,1,0,Pittsburgh,17,25,30,45,22,228,3,1,V,4,7,18,93,-22,-11,-86,-2,-1,2004
273,273,09/18/2004,Nevada-Las Vegas,10,24,98,27,12,160,2,1,Air Force,27,71,278,14,12,139,0,0,H,6.5,-17,-47,-180,13,0,21,2,1,2004
274,274,09/18/2004,Nevada-Reno,38,46,207,32,16,234,1,0,Buffalo,13,43,183,28,11,105,2,0,H,14.5,25,3,24,4,5,129,-1,0,2004
275,275,09/18/2004,New Mexico,7,27,75,31,7,39,2,1,Oregon State,17,41,124,50,24,274,0,2,V,-12.5,-10,-14,-49,-19,-17,-235,2,-1,2004
276,276,09/18/2004,New Mexico State,22,37,106,35,23,253,1,0,Troy State,18,35,164,23,13,183,0,1,H,-10,4,2,-58,12,10,70,1,-1,2004
277,277,09/18/2004,No Carolina State,14,35,157,24,12,99,3,2,Ohio State,22,40,64,21,10,73,0,1,H,-2.5,-8,-5,93,3,2,26,3,1,2004
278,278,09/18/2004,North Carolina,34,47,284,23,10,142,2,0,Georgia Tech,13,43,229,29,12,164,3,2,H,-9.5,21,4,55,-6,-2,-22,-1,-2,2004
279,279,09/18/2004,North Texas,21,40,258,36,21,249,0,1,Colorado,52,37,203,35,28,383,0,0,V,-18,-31,3,55,1,-7,-134,0,1,2004
280,280,09/18/2004,Northern Illinois,41,46,117,33,20,285,4,0,Iowa State,48,39,117,28,14,225,2,0,V,-2,-7,7,0,5,6,60,2,0,2004
281,281,09/18/2004,Northwestern,20,32,145,33,20,192,0,0,Kansas,17,26,47,51,32,303,0,1,H,2,3,6,98,-18,-12,-111,0,-1,2004
282,282,09/18/2004,Notre Dame,31,48,173,24,11,215,1,2,Michigan State,24,35,165,34,15,176,3,3,V,3,7,13,8,-10,-4,39,-2,-1,2004
283,283,09/18/2004,Ohio,20,34,9,39,23,253,0,1,Miami-Ohio,40,36,146,32,21,268,1,2,V,-18,-20,-2,-137,7,2,-15,-1,-1,2004
284,284,09/18/2004,Ohio State,22,40,64,21,10,79,0,1,No Carolina State,14,35,157,24,12,99,3,2,V,2.5,8,5,-93,-3,-2,-20,-3,-1,2004
285,285,09/18/2004,Oklahoma,31,46,214,23,17,213,0,1,Oregon,7,34,140,37,25,181,0,1,H,27,24,12,74,-14,-8,32,0,0,2004
286,286,09/18/2004,Oklahoma State,59,54,299,15,10,166,0,0,Southern Methodist,7,37,163,33,19,147,2,3,H,34.5,52,17,136,-18,-9,19,-2,-3,2004
287,287,09/18/2004,Oregon,7,34,140,37,25,181,0,1,Oklahoma,31,46,214,23,17,213,0,1,V,-27,-24,-12,-74,14,8,-32,0,0,2004
288,288,09/18/2004,Oregon State,17,41,124,50,24,274,0,2,New Mexico,7,27,75,31,7,39,2,1,H,12.5,10,14,49,19,17,235,-2,1,2004
289,289,09/18/2004,Penn State,37,41,247,34,22,277,2,4,U-C-F,13,31,60,33,13,121,1,1,H,21.5,24,10,187,1,9,156,1,3,2004
290,290,09/18/2004,Pittsburgh,17,25,30,45,22,228,3,1,Nebraska,24,43,123,23,11,142,1,0,H,-4,-7,-18,-93,22,11,86,2,1,2004
291,291,09/18/2004,Rice,41,64,405,12,5,118,0,2,Hawaii,29,13,7,51,34,363,0,0,H,1,12,51,398,-39,-29,-245,0,2,2004
292,292,09/18/2004,Rutgers,29,36,88,30,19,238,2,1,Kent State,21,38,30,47,29,311,1,3,H,12.5,8,-2,58,-17,-10,-73,1,-2,2004
293,293,09/18/2004,San Diego State,21,23,22,43,27,289,1,2,Michigan,24,48,148,28,14,179,3,1,V,-21,-3,-25,-126,15,13,110,-2,1,2004
294,294,09/18/2004,San Jose State,47,34,213,17,11,204,0,3,Morgan State,28,54,261,20,5,30,2,0,H, ,19,-20,-48,-3,6,174,-2,3,2004
295,295,09/18/2004,South Carolina,34,45,174,26,16,356,0,1,South Florida,3,22,80,33,14,111,1,1,H,14,31,23,94,-7,2,245,-1,0,2004
296,296,09/18/2004,South Florida,3,22,80,33,14,111,1,1,South Carolina,34,45,174,26,16,356,0,1,V,-14,-31,-23,-94,7,-2,-245,1,0,2004
297,297,09/18/2004,Southern Cal,42,50,291,35,22,236,1,0,Brigham Young,10,24,27,34,18,194,3,1,V,26,32,26,264,1,4,42,-2,-1,2004
298,298,09/18/2004,Southern Methodist,7,37,163,33,19,147,2,3,Oklahoma State,59,54,299,15,10,166,0,0,V,-34.5,-52,-17,-136,18,9,-19,2,3,2004
299,299,09/18/2004,Syracuse,19,44,192,18,11,161,2,1,Cincinnati,7,36,138,26,14,155,4,2,H,-1,12,8,54,-8,-3,6,-2,-1,2004
300,300,09/18/2004,Temple,38,53,255,26,16,222,0,1,Florida A+M,7,23,118,51,26,229,0,1,H, ,31,30,137,-25,-10,-7,0,0,2004
301,301,09/18/2004,Tennessee,30,44,171,30,19,232,1,2,Florida,28,35,135,31,22,286,1,0,H,3,2,9,36,-1,-3,-54,0,2,2004
302,302,09/18/2004,Texas A+M,27,53,324,26,14,178,0,0,Clemson,6,27,58,36,20,192,3,1,H,-2,21,26,266,-10,-6,-14,-3,-1,2004
303,303,09/18/2004,Texas Christian,35,39,151,39,16,165,0,2,Texas Tech,70,32,115,52,31,471,2,1,V,-6,-35,7,36,-13,-15,-306,-2,1,2004
304,304,09/18/2004,Texas Tech,70,32,115,52,31,471,2,1,Texas Christian,35,39,151,39,16,165,0,2,H,6,35,-7,-36,13,15,306,2,-1,2004
305,305,09/18/2004,Texas-El Paso,31,28,56,33,16,235,2,0,Boise State,47,49,175,37,26,392,2,2,H,-28.5,-16,-21,-119,-4,-10,-157,0,-2,2004
306,306,09/18/2004,Toledo,42,47,204,27,22,338,0,1,Eastern Michigan,32,46,224,50,25,314,2,0,V,7,10,1,-20,-23,-3,24,-2,1,2004
307,307,09/18/2004,Troy State,18,35,164,23,13,183,0,1,New Mexico State,22,37,106,35,23,253,1,0,V,10,-4,-2,58,-12,-10,-70,-1,1,2004
308,308,09/18/2004,Tulsa,0,34,100,40,20,220,2,0,Navy,29,68,330,8,6,117,0,1,H,0,-29,-34,-230,32,14,103,2,-1,2004
309,309,09/18/2004,U-C-F,13,31,60,33,13,121,1,1,Penn State,37,41,247,34,22,277,2,4,V,-21.5,-24,-10,-187,-1,-9,-156,-1,-3,2004
310,310,09/18/2004,U.C.L.A.,37,54,424,17,12,122,1,2,Washington,31,45,219,29,13,200,0,0,V,0,6,9,205,-12,-1,-78,1,2,2004
311,311,09/18/2004,UL-Lafayette,20,34,214,22,8,128,2,1,Kansas State,40,62,397,10,7,42,0,2,V,-31,-20,-28,-183,12,1,86,2,-1,2004
312,312,09/18/2004,UL-Monroe,20,34,93,34,15,303,3,1,Arkansas,49,44,289,29,19,282,1,1,V,-29,-29,-10,-196,5,-4,21,2,0,2004
313,313,09/18/2004,Utah,48,43,237,20,14,204,1,0,Utah State,6,35,48,38,25,247,2,1,V,20,42,8,189,-18,-11,-43,-1,-1,2004
314,314,09/18/2004,Utah State,6,35,48,38,25,247,2,1,Utah,48,44,236,20,14,204,1,0,H,-20,-42,-9,-188,18,11,43,1,1,2004
315,315,09/18/2004,Vanderbilt,23,47,183,17,9,131,1,1,Mississippi,26,39,170,36,23,195,0,1,V,-7,-3,8,13,-19,-14,-64,1,0,2004
316,316,09/18/2004,Virginia,51,42,326,33,21,196,1,0,Akron,0,31,6,27,12,78,2,0,H,31,51,11,320,6,9,118,-1,0,2004
317,317,09/18/2004,Virginia Tech,41,45,250,25,13,172,2,0,Duke,17,42,108,20,6,89,2,0,H,25,24,3,142,5,7,83,0,0,2004
318,318,09/18/2004,Wake Forest,42,51,336,14,8,69,0,1,No Carolina A+T,3,36,117,26,12,104,2,1,H, ,39,15,219,-12,-4,-35,-2,0,2004
319,319,09/18/2004,Washington,31,45,219,29,13,200,0,0,U.C.L.A.,37,54,424,17,12,122,1,2,H,0,-6,-9,-205,12,1,78,-1,-2,2004
320,320,09/18/2004,Washington State,49,46,286,21,13,223,0,1,Idaho,8,39,131,24,18,145,1,3,V,24,41,7,155,-3,-5,78,-1,-2,2004
321,321,09/18/2004,West Virginia,19,61,220,22,10,132,0,1,Maryland,16,41,187,20,9,108,3,2,H,6.5,3,20,33,2,1,24,-3,-1,2004
322,322,09/18/2004,Western Michigan,27,35,133,41,27,273,1,1,Illinois,30,45,176,19,10,177,2,1,V,-9.5,-3,-10,-43,22,17,96,-1,0,2004
323,323,09/18/2004,Wisconsin,9,46,146,24,12,116,0,2,Arizona,7,33,96,15,9,103,0,0,V,10.5,2,13,50,9,3,13,0,2,2004
324,324,09/23/2004,Akron,24,31,100,29,17,178,1,0,Kent State,19,43,198,41,24,192,0,1,V,-7,5,-12,-98,-12,-7,-14,1,-1,2004
325,325,09/23/2004,Houston,13,44,132,28,11,153,0,1,Miami-Florida,38,40,172,23,13,99,0,1,H,-28,-25,4,-40,5,-2,54,0,0,2004
326,326,09/23/2004,Kent State,19,43,198,41,24,192,0,1,Akron,24,31,100,29,17,178,1,0,H,7,-5,12,98,12,7,14,-1,1,2004
327,327,09/23/2004,Miami-Florida,38,40,172,23,13,99,0,1,Houston,13,44,132,28,11,153,0,1,V,28,25,-4,40,-5,2,-54,0,0,2004
328,328,09/24/2004,Boise State,28,45,89,29,21,310,1,1,Brigham Young,27,35,25,35,20,390,0,0,H,20.5,1,10,64,-6,1,-80,1,1,2004
329,329,09/24/2004,Bowling Green,17,29,142,42,29,275,0,0,Northern Illinois,34,54,292,23,16,191,0,0,V,2.5,-17,-25,-150,19,13,84,0,0,2004
330,330,09/24/2004,Brigham Young,27,36,11,34,20,390,0,0,Boise State,28,46,76,28,21,310,1,1,V,-20.5,-1,-10,-65,6,-1,80,-1,-1,2004
331,331,09/24/2004,Northern Illinois,34,54,292,23,16,191,0,0,Bowling Green,17,29,142,42,29,275,0,0,H,-2.5,17,25,150,-19,-13,-84,0,0,2004
332,332,09/25/2004,Air Force,35,66,302,16,11,169,1,2,Utah,49,45,245,24,14,260,0,2,V,-22,-14,21,57,-8,-3,-91,1,0,2004
333,333,09/25/2004,Alabama,10,46,271,18,6,57,1,1,Arkansas,27,49,211,12,7,122,1,0,V,-5.5,-17,-3,60,6,-1,-65,0,1,2004
334,334,09/25/2004,Alabama-Birmingham,35,32,141,31,21,398,1,1,Memphis,28,35,116,43,26,347,4,0,H,-2.5,7,-3,25,-12,-5,51,-3,1,2004
335,335,09/25/2004,Arizona,19,41,80,31,15,183,0,2,Washington State,20,35,28,37,18,282,0,4,H,-3.5,-1,6,52,-6,-3,-99,0,-2,2004
336,336,09/25/2004,Arizona State,27,35,125,40,16,124,0,0,Oregon State,14,22,-19,53,29,384,2,3,H,7.5,13,13,144,-13,-13,-260,-2,-3,2004
337,337,09/25/2004,Arkansas,27,49,211,12,7,122,1,0,Alabama,10,46,271,18,6,57,1,1,H,5.5,17,3,-60,-6,1,65,0,-1,2004
338,338,09/25/2004,Arkansas State,28,37,213,23,11,128,1,1,UL-Monroe,21,55,260,23,11,174,1,3,V,-5.5,7,-18,-47,0,0,-46,0,-2,2004
339,339,09/25/2004,Army,3,36,136,27,11,114,1,1,Connecticut,40,39,199,37,27,304,1,0,V,-23,-37,-3,-63,-10,-16,-190,0,1,2004
340,340,09/25/2004,Auburn,33,50,234,32,22,359,0,2,The Citadel,3,32,98,15,6,71,1,0,H, ,30,18,136,17,16,288,-1,2,2004
341,341,09/25/2004,Ball State,41,37,158,36,19,318,0,0,Western Michigan,14,34,89,35,24,209,0,1,H,-4,27,3,69,1,-5,109,0,-1,2004
342,342,09/25/2004,Baylor,37,39,158,33,20,213,1,0,North Texas,14,35,98,19,6,126,1,0,H,-3.5,23,4,60,14,14,87,0,0,2004
343,343,09/25/2004,Boston College,14,37,182,38,21,269,1,0,Wake Forest,17,49,159,23,14,210,1,0,V,-1,-3,-12,23,15,7,59,0,0,2004
344,344,09/25/2004,Buffalo,0,43,138,25,15,94,4,1,Ohio,34,36,173,20,11,192,0,2,V,-13,-34,7,-35,5,4,-98,4,-1,2004
345,345,09/25/2004,Cincinnati,24,57,217,25,14,155,1,1,East Carolina,19,31,11,25,10,192,0,2,V,12.5,5,26,206,0,4,-37,1,-1,2004
346,346,09/25/2004,Clemson,22,26,85,26,10,88,3,2,Florida State,41,51,186,34,20,184,0,0,V,-18,-19,-25,-101,-8,-10,-96,3,2,2004
347,347,09/25/2004,Colorado State,39,43,113,37,23,318,1,0,Montana State,14,22,112,36,20,196,1,0,H, ,25,21,1,1,3,122,0,0,2004
348,348,09/25/2004,Connecticut,40,39,199,37,27,304,1,0,Army,3,36,136,27,11,114,1,1,H,23,37,3,63,10,16,190,0,-1,2004
349,349,09/25/2004,Duke,21,27,83,19,8,102,1,3,Maryland,55,60,277,40,25,408,3,0,H,-17,-34,-33,-194,-21,-17,-306,-2,3,2004
350,350,09/25/2004,East Carolina,19,31,11,25,10,192,0,2,Cincinnati,24,57,217,25,14,155,1,1,H,-12.5,-5,-26,-206,0,-4,37,-1,1,2004
351,351,09/25/2004,Eastern Michigan,28,49,182,28,17,279,1,0,Eastern Illinois,31,42,196,23,14,235,1,0,H, ,-3,7,-14,5,3,44,0,0,2004
352,352,09/25/2004,Florida,20,40,262,43,25,261,3,0,Kentucky,3,27,73,35,17,134,1,1,H,17.5,17,13,189,8,8,127,2,-1,2004
353,353,09/25/2004,Florida State,41,51,186,34,20,184,0,0,Clemson,22,26,85,26,10,88,3,2,H,18,19,25,101,8,10,96,-3,-2,2004
354,354,09/25/2004,Idaho,10,27,60,39,23,212,2,0,Oregon,48,48,227,27,16,228,0,2,V,-35,-38,-21,-167,12,7,-16,2,-2,2004
355,355,09/25/2004,Illinois,30,34,175,37,22,215,0,2,Purdue,38,37,149,50,35,366,0,0,H,-21,-8,-3,26,-13,-13,-151,0,2,2004
356,356,09/25/2004,Indiana,20,37,105,22,12,153,2,0,Michigan State,30,48,241,23,15,172,2,0,H,-2.5,-10,-11,-136,-1,-3,-19,0,0,2004
357,357,09/25/2004,Iowa,17,28,-15,32,24,270,2,3,Michigan,30,39,93,26,16,236,0,2,V,-13.5,-13,-11,-108,6,8,34,2,1,2004
358,358,09/25/2004,Kansas,30,35,86,47,23,250,3,0,Texas Tech,31,22,182,52,28,356,4,1,H,-5.5,-1,13,-96,-5,-5,-106,-1,-1,2004
359,359,09/25/2004,Kentucky,3,27,73,35,17,134,1,1,Florida,20,40,262,43,25,261,3,0,V,-17.5,-17,-13,-189,-8,-8,-127,-2,1,2004
360,360,09/25/2004,Louisiana State,51,58,272,23,18,327,0,4,Mississippi State,0,22,40,26,8,90,4,1,H,31,51,36,232,-3,10,237,-4,3,2004
361,361,09/25/2004,Louisiana Tech,17,29,66,33,18,264,2,0,Tennessee,42,51,347,22,13,248,0,0,V,-23.5,-25,-22,-281,11,5,16,2,0,2004
362,362,09/25/2004,Louisville,34,52,278,24,18,177,0,0,North Carolina,0,22,77,26,14,145,2,1,V,7.5,34,30,201,-2,4,32,-2,-1,2004
363,363,09/25/2004,Maryland,55,60,277,40,25,408,3,0,Duke,21,27,83,19,8,102,1,3,V,17,34,33,194,21,17,306,2,-3,2004
364,364,09/25/2004,Memphis,28,35,116,43,26,347,4,0,Alabama-Birmingham,35,32,141,31,21,398,1,1,V,2.5,-7,3,-25,12,5,-51,3,-1,2004
365,365,09/25/2004,Michigan,30,39,93,26,16,236,0,2,Iowa,17,28,-15,32,24,270,2,3,H,13.5,13,11,108,-6,-8,-34,-2,-1,2004
366,366,09/25/2004,Michigan State,30,48,241,23,15,172,2,0,Indiana,20,37,105,22,12,153,2,0,V,2.5,10,11,136,1,3,19,0,0,2004
367,367,09/25/2004,Mid Tennessee St,17,25,94,46,35,242,1,2,UL-Lafayette,24,49,192,27,16,183,0,1,V,1.5,-7,-24,-98,19,19,59,1,1,2004
368,368,09/25/2004,Minnesota,43,52,251,33,14,203,0,0,Northwestern,17,27,140,28,14,127,1,0,H,14.5,26,25,111,5,0,76,-1,0,2004
369,369,09/25/2004,Mississippi,32,44,221,56,26,346,4,1,Wyoming,37,38,158,32,16,239,1,1,V,4.5,-5,6,63,24,10,107,3,0,2004
370,370,09/25/2004,Mississippi State,0,22,40,26,8,90,4,1,Louisiana State,51,58,272,23,18,327,0,4,V,-31,-51,-36,-232,3,-10,-237,4,-3,2004
371,371,09/25/2004,Navy,29,52,190,14,9,176,0,0,Vanderbilt,26,46,153,23,15,176,0,2,H,7.5,3,6,37,-9,-6,0,0,-2,2004
372,372,09/25/2004,Nevada-Las Vegas,21,45,267,35,20,283,4,1,Utah State,31,33,114,26,12,177,0,0,H,13,-10,12,153,9,8,106,4,1,2004
373,373,09/25/2004,Nevada-Reno,10,28,84,53,26,271,2,0,San Diego State,27,39,146,40,23,262,2,1,V,-15,-17,-11,-62,13,3,9,0,-1,2004
374,374,09/25/2004,New Mexico,38,62,321,13,7,88,1,0,New Mexico State,3,30,64,18,8,60,1,1,V,7.5,35,32,257,-5,-1,28,0,-1,2004
375,375,09/25/2004,New Mexico State,3,30,64,18,8,60,1,1,New Mexico,38,62,321,13,7,88,1,0,H,-7.5,-35,-32,-257,5,1,-28,0,1,2004
376,376,09/25/2004,No Carolina State,17,39,145,17,6,78,1,1,Virginia Tech,16,43,36,26,11,156,0,1,V,-8.5,1,-4,109,-9,-5,-78,1,0,2004
377,377,09/25/2004,North Carolina,0,22,77,26,14,145,2,1,Louisville,34,52,278,24,18,177,0,0,H,-7.5,-34,-30,-201,2,-4,-32,2,1,2004
378,378,09/25/2004,North Texas,14,35,98,19,6,126,1,0,Baylor,37,39,158,33,20,213,1,0,V,3.5,-23,-4,-60,-14,-14,-87,0,0,2004
379,379,09/25/2004,Northwestern,17,27,140,28,14,127,1,0,Minnesota,43,52,251,23,14,203,0,-1,V,-14.5,-26,-25,-111,5,0,-76,1,1,2004
380,380,09/25/2004,Notre Dame,38,46,146,32,17,266,1,0,Washington,3,34,112,44,17,223,1,4,H,11,35,12,34,-12,0,43,0,-4,2004
381,381,09/25/2004,Ohio,34,36,173,20,11,192,0,2,Buffalo,0,43,138,25,15,94,4,1,H,13,34,-7,35,-5,-4,98,-4,1,2004
382,382,09/25/2004,Oregon,48,48,227,27,16,228,0,2,Idaho,10,27,60,39,23,212,2,0,H,35,38,21,167,-12,-7,16,-2,2,2004
383,383,09/25/2004,Oregon State,14,22,-19,53,29,384,2,3,Arizona State,27,35,125,40,16,124,0,0,V,-7.5,-13,-13,-144,13,13,260,2,3,2004
384,384,09/25/2004,Penn State,3,26,70,28,8,87,2,1,Wisconsin,16,46,130,29,12,150,2,1,V,-3,-13,-20,-60,-1,-4,-63,0,0,2004
385,385,09/25/2004,Pittsburgh,41,45,99,36,30,380,0,0,Furman,38,38,141,26,14,282,2,0,H, ,3,7,-42,10,16,98,-2,0,2004
386,386,09/25/2004,Purdue,38,37,149,50,35,366,0,0,Illinois,30,34,175,37,22,215,0,2,V,21,8,3,-26,13,13,151,0,-2,2004
387,387,09/25/2004,Rice,13,51,172,12,5,56,0,1,Texas,35,44,339,24,14,186,2,1,V,-31,-22,7,-167,-12,-9,-130,-2,0,2004
388,388,09/25/2004,San Diego State,27,39,146,40,23,262,2,1,Nevada-Reno,10,28,84,53,26,271,2,0,H,15,17,11,62,-13,-3,-9,0,1,2004
389,389,09/25/2004,San Jose State,13,36,171,26,13,102,0,0,Southern Methodist,36,49,212,24,14,177,0,0,V,-1.5,-23,-13,-41,2,-1,-75,0,0,2004
390,390,09/25/2004,South Carolina,17,47,132,24,16,199,2,1,Troy State,7,28,99,23,9,108,2,0,H,13.5,10,19,33,1,7,91,0,1,2004
391,391,09/25/2004,South Florida,45,55,83,34,22,324,0,2,Texas Christian,44,44,157,22,11,167,0,0,V,-9.5,1,11,-74,12,11,157,0,2,2004
392,392,09/25/2004,Southern Cal,31,35,86,29,24,308,0,1,Stanford,28,31,130,34,23,183,1,0,V,22,3,4,-44,-5,1,125,-1,1,2004
393,393,09/25/2004,Southern Methodist,36,49,212,24,14,177,0,0,San Jose State,13,36,171,26,13,102,0,0,H,1.5,23,13,41,-2,1,75,0,0,2004
394,394,09/25/2004,Southern Miss,32,51,305,24,16,156,0,0,Tulane,14,31,178,21,9,93,2,1,V,13,18,20,127,3,7,63,-2,-1,2004
395,395,09/25/2004,Stanford,28,30,144,35,23,183,1,0,Southern Cal,31,34,99,30,24,308,0,1,H,-22,-3,-4,45,5,-1,-125,1,-1,2004
396,396,09/25/2004,Syracuse,10,38,113,23,15,141,0,0,Virginia,31,39,225,12,11,202,0,0,V,-27,-21,-1,-112,11,4,-61,0,0,2004
397,397,09/25/2004,Temple,17,40,139,36,15,205,1,2,Toledo,45,38,129,27,22,276,0,2,V,-8,-28,2,10,9,-7,-71,1,0,2004
398,398,09/25/2004,Tennessee,42,51,347,22,13,248,0,0,Louisiana Tech,17,29,66,33,18,264,2,0,H,23.5,25,22,281,-11,-5,-16,-2,0,2004
399,399,09/25/2004,Texas,35,44,339,24,14,186,2,1,Rice,13,51,172,12,5,56,0,1,H,31,22,-7,167,12,9,130,2,0,2004
400,400,09/25/2004,Texas Christian,44,44,157,22,11,167,0,-1,South Florida,45,55,83,34,22,324,0,2,H,9.5,-1,-11,74,-12,-11,-157,0,-3,2004
401,401,09/25/2004,Texas Tech,31,22,182,52,28,356,4,1,Kansas,30,35,86,47,23,250,3,0,V,5.5,1,-13,96,5,5,106,1,1,2004
402,402,09/25/2004,Toledo,45,38,129,27,22,276,0,2,Temple,17,40,139,36,15,205,1,2,H,8,28,-2,-10,-9,7,71,-1,0,2004
403,403,09/25/2004,Troy State,7,28,99,23,9,108,2,0,South Carolina,17,47,132,24,16,199,2,1,V,-13.5,-10,-19,-33,-1,-7,-91,0,-1,2004
404,404,09/25/2004,Tulane,14,31,178,21,9,93,2,1,Southern Miss,32,51,305,24,16,156,0,0,H,-13,-18,-20,-127,-3,-7,-63,2,1,2004
405,405,09/25/2004,Tulsa,49,45,280,34,23,232,1,1,S W Missouri St,7,33,131,28,13,126,2,0,H, ,42,12,149,6,10,106,-1,1,2004
406,406,09/25/2004,UL-Lafayette,24,49,192,27,16,183,0,1,Mid Tennessee St,17,25,94,46,35,242,1,2,H,-1.5,7,24,98,-19,-19,-59,-1,-1,2004
407,407,09/25/2004,UL-Monroe,21,55,260,23,11,174,1,3,Arkansas State,28,37,213,23,11,128,1,1,H,5.5,-7,18,47,0,0,46,0,2,2004
408,408,09/25/2004,Utah,49,44,229,25,15,276,0,2,Air Force,35,66,302,16,11,169,1,2,H,22,14,-22,-73,9,4,107,-1,0,2004
409,409,09/25/2004,Utah State,31,33,114,26,12,177,0,0,Nevada-Las Vegas,21,44,251,36,21,299,4,1,V,-13,10,-11,-137,-10,-9,-122,-4,-1,2004
410,410,09/25/2004,Vanderbilt,26,46,153,23,15,176,0,2,Navy,29,52,190,14,9,176,0,0,V,-7.5,-3,-6,-37,9,6,0,0,2,2004
411,411,09/25/2004,Virginia,31,39,225,12,11,202,0,0,Syracuse,10,38,113,23,15,141,0,0,H,27,21,1,112,-11,-4,61,0,0,2004
412,412,09/25/2004,Virginia Tech,16,43,36,26,11,156,0,1,No Carolina State,17,39,145,17,6,78,1,1,H,8.5,-1,4,-109,9,5,78,-1,0,2004
413,413,09/25/2004,Wake Forest,17,49,159,23,14,210,1,0,Boston College,14,37,182,38,21,269,1,0,H,1,3,12,-23,-15,-7,-59,0,0,2004
414,414,09/25/2004,Washington,3,34,112,44,17,223,1,4,Notre Dame,38,46,146,32,17,266,1,0,V,-11,-35,-12,-34,12,0,-43,0,4,2004
415,415,09/25/2004,Washington State,20,35,28,37,18,282,0,4,Arizona,19,41,80,31,15,183,0,2,V,3.5,1,-6,-52,6,3,99,0,2,2004
416,416,09/25/2004,West Virginia,45,46,171,24,19,199,0,1,James Madison,10,42,74,23,13,146,0,2,H, ,35,4,97,1,6,53,0,-1,2004
417,417,09/25/2004,Western Michigan,14,34,89,35,24,209,0,1,Ball State,41,37,158,36,19,318,0,0,V,4,-27,-3,-69,-1,5,-109,0,1,2004
418,418,09/25/2004,Wisconsin,16,46,130,29,12,150,2,1,Penn State,3,26,70,28,8,87,2,1,H,3,13,20,60,1,4,63,0,0,2004
419,419,09/25/2004,Wyoming,37,38,158,32,16,239,1,1,Mississippi,32,44,221,56,26,346,4,1,H,-4.5,5,-6,-63,-24,-10,-107,-3,0,2004
420,420,09/29/2004,Marshall,33,35,154,37,23,184,1,0,Miami-Ohio,25,42,119,24,14,144,2,3,H,6.5,8,-7,35,13,9,40,-1,-3,2004
421,421,09/29/2004,Miami-Ohio,25,42,119,24,14,144,2,3,Marshall,33,35,154,37,23,184,1,0,V,-6.5,-8,7,-35,-13,-9,-40,1,3,2004
422,422,09/30/2004,Air Force,21,57,182,24,18,233,2,0,Navy,24,46,216,10,5,105,1,1,H,1,-3,11,-34,14,13,128,1,-1,2004
423,423,09/30/2004,Connecticut,29,35,158,43,23,237,1,1,Pittsburgh,17,34,82,31,11,267,1,1,H,5.5,12,1,76,12,12,-30,0,0,2004
424,424,09/30/2004,Navy,24,46,216,10,5,105,1,1,Air Force,21,57,182,24,18,233,2,0,V,-1,3,-11,34,-14,-13,-128,-1,1,2004
425,425,09/30/2004,Pittsburgh,17,34,82,31,11,267,1,1,Connecticut,29,35,158,43,23,237,1,1,V,-5.5,-12,-1,-76,-12,-12,30,0,0,2004
426,426,10/01/2004,New Mexico,7,35,74,24,7,83,1,0,Utah,28,53,278,29,15,188,1,2,H,-10,-21,-18,-204,-5,-8,-105,0,-2,2004
427,427,10/01/2004,Utah,28,53,278,29,15,188,1,2,New Mexico,7,35,74,24,7,83,1,0,V,10,21,18,204,5,8,105,0,2,2004
428,428,10/02/2004,Akron,19,34,65,26,17,192,0,1,Northern Illinois,49,38,260,28,17,225,1,0,V,-17.5,-30,-4,-195,-2,0,-33,-1,1,2004
429,429,10/02/2004,Alabama,3,28,143,24,10,67,4,0,South Carolina,20,54,203,11,4,46,1,2,H,1.5,-17,-26,-60,13,6,21,3,-2,2004
430,430,10/02/2004,Alabama-Birmingham,30,34,116,30,12,107,0,0,Cincinnati,27,30,103,52,29,300,1,2,V,-1,3,4,13,-22,-17,-193,-1,-2,2004
431,431,10/02/2004,Arizona State,28,33,119,23,14,164,0,0,Oregon,13,43,134,31,17,177,0,0,V,-2.5,15,-10,-15,-8,-3,-13,0,0,2004
432,432,10/02/2004,Arkansas,30,36,134,39,23,252,3,0,Florida,45,33,118,38,23,322,0,0,V,-7.5,-15,3,16,1,0,-70,3,0,2004
433,433,10/02/2004,Arkansas State,21,29,151,39,17,230,1,1,Mississippi,28,46,200,24,18,179,1,0,V,-20,-7,-17,-49,15,-1,51,0,1,2004
434,434,10/02/2004,Army,17,39,129,26,12,214,0,0,Texas Christian,21,46,164,33,20,240,2,0,H,-17,-4,-7,-35,-7,-8,-26,-2,0,2004
435,435,10/02/2004,Auburn,34,42,148,23,16,252,1,1,Tennessee,10,31,107,40,18,186,5,1,V,-1.5,24,11,41,-17,-2,66,-4,0,2004
436,436,10/02/2004,Ball State,14,33,83,29,17,213,0,1,Toledo,52,35,177,36,28,468,0,1,V,-17.5,-38,-2,-94,-7,-11,-255,0,0,2004
437,437,10/02/2004,Baylor,14,25,70,42,22,196,1,2,Texas,44,51,303,26,17,204,0,0,V,-39.5,-30,-26,-233,16,5,-8,1,2,2004
438,438,10/02/2004,Boise State,38,44,208,40,22,218,2,0,Southern Methodist,20,24,56,35,17,249,1,0,H,38,18,20,152,5,5,-31,1,0,2004
439,439,10/02/2004,Boston College,29,46,261,33,18,255,3,0,Massachusetts,7,29,26,31,13,121,1,0,H, ,22,17,235,2,5,134,2,0,2004
440,440,10/02/2004,Bowling Green,70,45,272,26,21,367,1,0,Temple,16,35,97,24,13,197,0,1,V,8,54,10,175,2,8,170,1,-1,2004
441,441,10/02/2004,Brigham Young,31,46,207,42,24,238,1,0,Colorado State,21,30,103,36,22,359,1,1,V,-2.5,10,16,104,6,2,-121,0,-1,2004
442,442,10/02/2004,Buffalo,48,45,245,7,5,195,0,0,U-C-F,20,46,203,35,23,270,3,0,H,-7.5,28,-1,42,-28,-18,-75,-3,0,2004
443,443,10/02/2004,California,49,39,156,18,14,277,2,1,Oregon State,7,28,91,49,21,211,2,0,V,6.5,42,11,65,-31,-7,66,0,1,2004
444,444,10/02/2004,Central Michigan,24,40,170,28,15,143,1,0,Kent State,21,39,145,30,17,152,0,2,H,2,3,1,25,-2,-2,-9,1,-2,2004
445,445,10/02/2004,Cincinnati,27,30,103,52,29,300,1,1,Alabama-Birmingham,30,34,116,30,12,107,0,0,H,1,-3,-4,-13,22,17,193,1,1,2004
446,446,10/02/2004,Colorado,9,28,80,28,18,171,3,0,Missouri,17,55,228,25,16,189,0,1,V,-8,-8,-27,-148,3,2,-18,3,-1,2004
447,447,10/02/2004,Colorado State,21,30,103,36,22,359,1,1,Brigham Young,31,46,207,42,24,238,1,0,H,2.5,-10,-16,-104,-6,-2,121,0,1,2004
448,448,10/02/2004,Duke,28,43,191,25,18,206,1,2,The Citadel,10,36,142,23,10,139,2,1,H, ,18,7,49,2,8,67,-1,1,2004
449,449,10/02/2004,East Carolina,7,38,53,36,21,182,3,2,Louisville,59,38,215,31,24,334,0,1,V,-31.5,-52,0,-162,5,-3,-152,3,1,2004
450,450,10/02/2004,Eastern Michigan,41,42,216,43,22,228,1,1,Idaho,45,42,146,36,28,318,0,2,H,7,-4,0,70,7,-6,-90,1,-1,2004
451,451,10/02/2004,Florida,45,33,118,38,23,322,0,0,Arkansas,30,36,134,39,23,252,3,0,H,7.5,15,-3,-16,-1,0,70,-3,0,2004
452,452,10/02/2004,Florida State,38,37,249,31,20,193,1,0,North Carolina,16,35,100,33,20,263,1,0,H,27.5,22,2,149,-2,0,-70,0,0,2004
453,453,10/02/2004,Fresno State,21,48,269,28,13,104,2,0,Louisiana Tech,28,42,244,26,15,158,0,1,V,14,-7,6,25,2,-2,-54,2,-1,2004
454,454,10/02/2004,Georgia,45,49,221,26,13,209,0,0,Louisiana State,16,29,67,30,19,247,0,3,H,3,29,20,154,-4,-6,-38,0,-3,2004
455,455,10/02/2004,Georgia Tech,3,37,162,26,8,68,3,1,Miami-Florida,27,38,140,26,14,224,0,0,H,-14,-24,-1,22,0,-6,-156,3,1,2004
456,456,10/02/2004,Hawaii,44,23,128,45,23,397,0,0,Tulsa,16,33,59,44,21,189,1,0,H,9,28,-10,69,1,2,208,-1,0,2004
457,457,10/02/2004,Houston,14,38,65,27,18,220,0,2,Memphis,41,49,333,28,16,168,2,0,V,-12,-27,-11,-268,-1,2,52,-2,2,2004
458,458,10/02/2004,Idaho,45,42,146,36,28,318,0,2,Eastern Michigan,41,42,216,43,22,228,1,1,V,-7,4,0,-70,-7,6,90,-1,1,2004
459,459,10/02/2004,Illinois,7,27,42,41,20,164,0,1,Wisconsin,24,50,258,20,9,99,0,1,V,-14.5,-17,-23,-216,21,11,65,0,0,2004
460,460,10/02/2004,Indiana,14,38,61,22,14,153,0,0,Michigan,35,39,93,26,19,331,0,2,H,-19,-21,-1,-32,-4,-5,-178,0,-2,2004
461,461,10/02/2004,Iowa,38,27,124,37,25,340,1,0,Michigan State,16,36,204,54,29,245,0,1,H,7.5,22,-9,-80,-17,-4,95,1,-1,2004
462,462,10/02/2004,Iowa State,7,37,59,24,13,160,0,4,Oklahoma State,36,55,189,16,9,160,1,0,V,-17.5,-29,-18,-130,8,4,0,-1,4,2004
463,463,10/02/2004,Kansas,8,33,105,49,24,200,1,0,Nebraska,14,32,139,24,16,183,3,1,V,-11.5,-6,1,-34,25,8,17,-2,-1,2004
464,464,10/02/2004,Kansas State,30,45,123,45,29,246,2,2,Texas A+M,42,31,180,12,7,129,0,1,V,-5.5,-12,14,-57,33,22,117,2,1,2004
465,465,10/02/2004,Kent State,21,39,145,30,17,152,0,2,Central Michigan,24,40,170,28,15,143,1,0,V,-2,-3,-1,-25,2,2,9,-1,2,2004
466,466,10/02/2004,Kentucky,16,38,90,36,18,190,3,2,Ohio,28,40,90,18,10,218,0,1,H,14,-12,-2,0,18,8,-28,3,1,2004
467,467,10/02/2004,Louisiana State,16,29,67,30,19,247,0,3,Georgia,45,49,221,26,13,209,0,0,V,-3,-29,-20,-154,4,6,38,0,3,2004
468,468,10/02/2004,Louisiana Tech,28,42,244,26,15,158,0,1,Fresno State,21,48,269,28,13,104,2,0,H,-14,7,-6,-25,-2,2,54,-2,1,2004
469,469,10/02/2004,Louisville,59,38,215,31,24,334,0,1,East Carolina,7,38,53,36,21,182,3,2,H,31.5,52,0,162,-5,3,152,-3,-1,2004
470,470,10/02/2004,Memphis,41,49,333,28,16,168,2,0,Houston,14,38,65,27,18,220,0,2,H,12,27,11,268,1,-2,-52,2,-2,2004
471,471,10/02/2004,Miami-Florida,27,38,140,26,14,224,0,0,Georgia Tech,3,37,162,26,8,68,3,1,V,14,24,1,-22,0,6,156,-3,-1,2004
472,472,10/02/2004,Michigan,35,39,93,26,19,331,0,2,Indiana,14,38,61,22,14,153,0,0,V,19,21,1,32,4,5,178,0,2,2004
473,473,10/02/2004,Michigan State,16,36,204,54,29,245,0,1,Iowa,38,27,124,37,25,340,1,0,V,-7.5,-22,9,80,17,4,-95,-1,1,2004
474,474,10/02/2004,Mid Tennessee St,21,43,144,30,22,243,1,2,North Texas,30,40,176,23,17,285,0,1,V,-3,-9,3,-32,7,5,-42,1,1,2004
475,475,10/02/2004,Minnesota,16,56,288,18,8,113,1,0,Penn State,7,22,21,48,24,250,1,1,H,16.5,9,34,267,-30,-16,-137,0,-1,2004
476,476,10/02/2004,Mississippi,28,46,200,24,18,179,1,0,Arkansas State,21,29,151,39,17,230,1,1,H,20,7,17,49,-15,1,-51,0,-1,2004
477,477,10/02/2004,Mississippi State,13,29,138,36,17,136,4,1,Vanderbilt,31,49,228,22,12,102,0,1,V,-12,-18,-20,-90,14,5,34,4,0,2004
478,478,10/02/2004,Missouri,17,55,228,25,16,189,0,1,Colorado,9,28,80,28,18,171,3,0,H,8,8,27,148,-3,-2,18,-3,1,2004
479,479,10/02/2004,Nebraska,14,32,139,24,16,183,3,1,Kansas,8,33,105,49,24,200,1,0,H,11.5,6,-1,34,-25,-8,-17,2,1,2004
480,480,10/02/2004,Nevada-Las Vegas,48,47,238,19,11,128,0,1,Nevada-Reno,13,33,98,52,32,320,3,2,H,6.5,35,14,140,-33,-21,-192,-3,-1,2004
481,481,10/02/2004,Nevada-Reno,13,33,98,52,32,320,3,2,Nevada-Las Vegas,48,47,238,19,11,128,0,1,V,-6.5,-35,-14,-140,33,21,192,3,1,2004
482,482,10/02/2004,New Mexico State,0,32,116,28,9,110,2,1,Texas-El Paso,45,58,266,20,15,179,0,1,V,-8,-45,-26,-150,8,-6,-69,2,0,2004
483,483,10/02/2004,No Carolina State,27,50,196,28,19,243,1,0,Wake Forest,21,42,202,21,13,61,0,0,H,11,6,8,-6,7,6,182,1,0,2004
484,484,10/02/2004,North Carolina,16,35,100,33,20,263,1,0,Florida State,38,37,249,31,20,193,1,0,V,-27.5,-22,-2,-149,2,0,70,0,0,2004
485,485,10/02/2004,North Texas,30,40,176,23,17,285,0,1,Mid Tennessee St,21,43,144,30,22,243,1,2,H,3,9,-3,32,-7,-5,42,-1,-1,2004
486,486,10/02/2004,Northern Illinois,49,38,260,28,17,225,1,0,Akron,19,34,65,26,17,192,0,1,H,17.5,30,4,195,2,0,33,1,-1,2004
487,487,10/02/2004,Northwestern,33,39,166,44,24,278,2,0,Ohio State,27,37,97,38,18,211,1,1,H,-11,6,2,69,6,6,67,1,-1,2004
488,488,10/02/2004,Notre Dame,16,36,76,49,29,460,0,1,Purdue,41,28,99,32,22,413,0,0,H,-2,-25,8,-23,17,7,47,0,1,2004
489,489,10/02/2004,Ohio,28,40,90,18,10,218,0,1,Kentucky,16,38,90,36,18,190,3,2,V,-14,12,2,0,-18,-8,28,-3,-1,2004
490,490,10/02/2004,Ohio State,27,37,97,38,18,211,1,1,Northwestern,33,39,166,44,24,278,2,0,V,11,-6,-2,-69,-6,-6,-67,-1,1,2004
491,491,10/02/2004,Oklahoma,28,40,221,24,15,151,0,0,Texas Tech,13,24,56,55,36,369,3,1,H,24,15,16,165,-31,-21,-218,-3,-1,2004
492,492,10/02/2004,Oklahoma State,36,55,189,16,9,160,1,0,Iowa State,7,37,59,24,13,160,0,4,H,17.5,29,18,130,-8,-4,0,1,-4,2004
493,493,10/02/2004,Oregon,13,43,134,31,17,177,0,0,Arizona State,28,33,119,23,14,164,0,0,H,2.5,-15,10,15,8,3,13,0,0,2004
494,494,10/02/2004,Oregon State,7,28,91,49,21,211,2,0,California,49,39,156,18,14,277,2,1,H,-6.5,-42,-11,-65,31,7,-66,0,-1,2004
495,495,10/02/2004,Penn State,7,22,21,48,24,250,1,1,Minnesota,16,56,288,18,8,113,1,0,V,-16.5,-9,-34,-267,30,16,137,0,1,2004
496,496,10/02/2004,Purdue,41,28,99,32,22,413,0,0,Notre Dame,16,36,76,49,29,460,0,1,V,2,25,-8,23,-17,-7,-47,0,-1,2004
497,497,10/02/2004,Rice,63,85,570,15,4,64,3,2,San Jose State,70,25,83,24,11,372,4,1,V,14.5,-7,60,487,-9,-7,-308,-1,1,2004
498,498,10/02/2004,Rutgers,31,42,130,50,30,360,0,3,Syracuse,41,40,370,25,11,131,2,2,V,-6,-10,2,-240,25,19,229,-2,1,2004
499,499,10/02/2004,San Diego State,10,28,139,53,31,263,2,0,U.C.L.A.,33,42,205,31,15,205,1,0,V,-5.5,-23,-14,-66,22,16,58,1,0,2004
500,500,10/02/2004,San Jose State,70,25,83,24,11,372,4,1,Rice,63,85,570,15,4,64,3,2,H,-14.5,7,-60,-487,9,7,308,1,-1,2004
501,501,10/02/2004,South Carolina,20,54,203,11,4,46,1,2,Alabama,3,28,143,24,10,67,4,0,V,-1.5,17,26,60,-13,-6,-21,-3,2,2004
502,502,10/02/2004,South Florida,20,25,55,35,14,150,4,0,Southern Miss,27,50,112,27,14,200,0,1,H,-6.5,-7,-25,-57,8,0,-50,4,-1,2004
503,503,10/02/2004,Southern Methodist,20,24,56,35,17,249,1,0,Boise State,38,44,208,40,22,218,2,0,V,-38,-18,-20,-152,-5,-5,31,-1,0,2004
504,504,10/02/2004,Southern Miss,27,50,112,27,14,200,0,1,South Florida,20,25,55,35,14,150,4,0,V,6.5,7,25,57,-8,0,50,-4,1,2004
505,505,10/02/2004,Stanford,27,34,202,35,23,254,3,1,Washington,13,40,91,39,17,211,1,0,H,14,14,-6,111,-4,6,43,2,1,2004
506,506,10/02/2004,Syracuse,41,40,370,25,11,131,2,2,Rutgers,31,42,130,50,30,360,0,3,H,6,10,-2,240,-25,-19,-229,2,-1,2004
507,507,10/02/2004,Temple,16,35,97,24,13,197,0,1,Bowling Green,70,45,272,26,21,367,1,0,H,-8,-54,-10,-175,-2,-8,-170,-1,1,2004
508,508,10/02/2004,Tennessee,10,31,107,40,18,186,5,1,Auburn,34,42,148,23,16,252,1,1,H,1.5,-24,-11,-41,17,2,-66,4,0,2004
509,509,10/02/2004,Texas,44,51,303,26,17,204,0,0,Baylor,14,25,70,42,22,196,1,1,H,39.5,30,26,233,-16,-5,8,-1,-1,2004
510,510,10/02/2004,Texas A+M,42,31,180,12,7,129,0,1,Kansas State,30,45,123,45,29,246,2,2,H,5.5,12,-14,57,-33,-22,-117,-2,-1,2004
511,511,10/02/2004,Texas Christian,21,46,164,33,20,240,2,0,Army,17,39,129,26,12,214,0,0,V,17,4,7,35,7,8,26,2,0,2004
512,512,10/02/2004,Texas Tech,13,24,56,55,36,369,3,1,Oklahoma,28,40,221,24,15,151,0,0,V,-24,-15,-16,-165,31,21,218,3,1,2004
513,513,10/02/2004,Texas-El Paso,45,58,266,20,15,179,0,1,New Mexico State,0,32,116,28,9,110,2,1,H,8,45,26,150,-8,6,69,-2,0,2004
514,514,10/02/2004,Toledo,52,35,177,36,28,468,0,1,Ball State,14,33,83,29,17,213,0,1,H,17.5,38,2,94,7,11,255,0,0,2004
515,515,10/02/2004,Troy State,49,50,238,16,9,120,1,2,Utah State,21,42,99,37,18,243,3,0,H,15,28,8,139,-21,-9,-123,-2,2,2004
516,516,10/02/2004,Tulsa,16,33,59,44,21,189,1,0,Hawaii,44,23,128,45,23,397,0,0,V,-9,-28,10,-69,-1,-2,-208,1,0,2004
517,517,10/02/2004,U-C-F,20,46,203,35,23,270,3,0,Buffalo,48,45,245,7,5,195,0,0,V,7.5,-28,1,-42,28,18,75,3,0,2004
518,518,10/02/2004,U.C.L.A.,33,42,205,31,15,205,1,0,San Diego State,10,28,139,53,31,263,2,0,H,5.5,23,14,66,-22,-16,-58,-1,0,2004
519,519,10/02/2004,UL-Lafayette,43,37,143,42,30,302,1,0,Florida Intl,34,30,82,35,22,265,2,0,V,8,9,7,61,7,8,37,-1,0,2004
520,520,10/02/2004,UL-Monroe,10,30,91,33,15,145,0,0,Wyoming,31,53,261,28,16,175,1,0,V,-15.5,-21,-23,-170,5,-1,-30,-1,0,2004
521,521,10/02/2004,Utah State,21,42,99,37,18,243,3,0,Troy State,49,50,238,16,9,120,1,2,V,-15,-28,-8,-139,21,9,123,2,-2,2004
522,522,10/02/2004,Vanderbilt,31,49,228,22,12,102,0,1,Mississippi State,13,29,138,36,17,136,4,1,H,12,18,20,90,-14,-5,-34,-4,0,2004
523,523,10/02/2004,Virginia Tech,19,47,192,34,16,142,2,0,West Virginia,13,36,134,21,10,113,1,1,H,3,6,11,58,13,6,29,1,-1,2004
524,524,10/02/2004,Wake Forest,21,42,202,21,13,61,0,0,No Carolina State,27,50,196,28,19,243,1,0,V,-11,-6,-8,6,-7,-6,-182,-1,0,2004
525,525,10/02/2004,Washington,13,40,91,39,17,211,1,0,Stanford,27,34,202,35,23,254,3,1,V,-14,-14,6,-111,4,-6,-43,-2,-1,2004
526,526,10/02/2004,West Virginia,13,36,134,21,10,113,1,1,Virginia Tech,19,47,192,34,16,142,2,0,V,-3,-6,-11,-58,-13,-6,-29,-1,1,2004
527,527,10/02/2004,Wisconsin,24,50,258,20,9,99,0,1,Illinois,7,27,42,41,20,164,0,1,H,14.5,17,23,216,-21,-11,-65,0,0,2004
528,528,10/02/2004,Wyoming,31,53,261,28,16,175,1,0,UL-Monroe,10,30,91,33,15,145,0,0,H,15.5,21,23,170,-5,1,30,1,0,2004
529,529,10/07/2004,Clemson,10,21,45,28,16,166,1,0,Virginia,30,54,239,26,14,225,0,1,V,-14,-20,-33,-194,2,2,-59,1,-1,2004
530,530,10/07/2004,Houston,29,47,173,36,19,345,0,0,Southern Miss,35,38,165,29,17,173,1,1,V,-16.5,-6,9,8,7,2,172,-1,-1,2004
531,531,10/07/2004,Southern Miss,35,38,165,29,17,173,1,1,Houston,29,47,173,36,19,345,0,0,H,16.5,6,-9,-8,-7,-2,-172,1,1,2004
532,532,10/07/2004,Virginia,30,54,239,26,14,225,0,1,Clemson,10,21,45,28,16,166,1,0,H,14,20,33,194,-2,-2,59,-1,1,2004
533,533,10/08/2004,Brigham Young,20,28,91,68,34,358,1,4,Nevada-Las Vegas,24,46,129,27,9,130,1,1,H,10,-4,-18,-38,41,25,228,0,3,2004
534,534,10/08/2004,Nevada-Las Vegas,24,46,129,27,9,130,1,1,Brigham Young,20,28,91,68,34,358,1,4,V,-10,4,18,38,-41,-25,-228,0,-3,2004
535,535,10/09/2004,Air Force,28,53,239,9,4,95,0,0,New Mexico,23,41,140,22,9,119,1,0,H,3,5,12,99,-13,-5,-24,-1,0,2004
536,536,10/09/2004,Akron,44,28,172,23,13,202,0,0,Buffalo,21,47,172,20,11,136,0,0,H,8,23,-19,0,3,2,66,0,0,2004
537,537,10/09/2004,Alabama,45,63,304,11,7,83,0,0,Kentucky,17,28,77,18,7,100,0,3,V,4.5,28,35,227,-7,0,-17,0,-3,2004
538,538,10/09/2004,Alabama-Birmingham,27,40,164,19,13,150,0,0,Mississippi State,13,43,225,20,10,99,0,1,V,11,14,-3,-61,-1,3,51,0,-1,2004
539,539,10/09/2004,Arizona,17,39,258,25,13,93,1,0,U.C.L.A.,37,39,114,25,17,234,0,0,V,-9.5,-20,0,144,0,-4,-141,1,0,2004
540,540,10/09/2004,Arkansas State,17,37,144,29,19,251,3,2,Mid Tennessee St,45,36,104,34,30,447,0,0,V,-6.5,-28,1,40,-5,-11,-196,3,2,2004
541,541,10/09/2004,Army,48,46,284,21,13,270,1,0,Cincinnati,29,40,186,39,25,350,1,4,H,-16,19,6,98,-18,-12,-80,0,-4,2004
542,542,10/09/2004,Auburn,52,40,198,21,16,274,0,0,Louisiana Tech,7,34,37,25,14,185,2,1,H,25.5,45,6,161,-4,2,89,-2,-1,2004
543,543,10/09/2004,Ball State,24,35,142,39,21,267,0,0,Eastern Michigan,31,34,147,46,30,390,0,1,H,7,-7,1,-5,-7,-9,-123,0,-1,2004
544,544,10/09/2004,Baylor,10,29,85,31,15,88,2,2,Missouri,30,52,176,28,13,151,0,0,H,-20.5,-20,-23,-91,3,2,-63,2,2,2004
545,545,10/09/2004,Bowling Green,38,33,123,42,31,387,0,0,Central Michigan,14,41,210,35,19,191,2,0,V,17,24,-8,-87,7,12,196,-2,0,2004
546,546,10/09/2004,Buffalo,21,47,172,20,11,136,0,0,Akron,44,28,172,23,13,202,0,0,V,-8,-23,19,0,-3,-2,-66,0,0,2004
547,547,10/09/2004,California,17,44,157,35,29,267,0,3,Southern Cal,23,25,41,25,15,164,1,0,V,-7.5,-6,19,116,10,14,103,-1,3,2004
548,548,10/09/2004,Central Michigan,14,41,210,35,19,191,2,0,Bowling Green,38,33,123,42,31,387,0,0,H,-17,-24,8,87,-7,-12,-196,2,0,2004
549,549,10/09/2004,Cincinnati,29,40,186,39,25,350,1,4,Army,48,46,284,21,13,270,1,0,V,16,-19,-6,-98,18,12,80,0,4,2004
550,550,10/09/2004,Colorado,14,30,127,46,28,318,2,1,Oklahoma State,42,43,236,11,8,193,1,0,H,-4,-28,-13,-109,35,20,125,1,1,2004
551,551,10/09/2004,East Carolina,27,47,158,23,13,107,0,2,Tulane,25,27,43,28,15,223,2,0,H,2.5,2,20,115,-5,-2,-116,-2,2,2004
552,552,10/09/2004,Eastern Michigan,31,34,147,46,30,390,0,1,Ball State,24,35,142,39,21,267,0,0,V,-7,7,-1,5,7,9,123,0,1,2004
553,553,10/09/2004,Florida,21,26,94,33,15,142,0,0,Louisiana State,24,45,210,38,24,254,3,0,H,2.5,-3,-19,-116,-5,-9,-112,-3,0,2004
554,554,10/09/2004,Florida Atlantic,20,42,86,23,12,245,1,3,Texas State,13,49,253,25,14,167,2,0,V, ,7,-7,-167,-2,-2,78,-1,3,2004
555,555,10/09/2004,Florida State,17,43,258,26,15,169,1,2,Syracuse,13,31,58,28,19,207,1,1,V,18,4,12,200,-2,-4,-38,0,1,2004
556,556,10/09/2004,Fresno State,21,39,195,36,20,126,2,0,Texas-El Paso,24,37,92,23,12,185,0,2,H,17,-3,2,103,13,8,-59,2,-2,2004
557,557,10/09/2004,Georgia,14,29,56,41,19,209,0,1,Tennessee,19,47,127,22,12,150,0,2,H,12.5,-5,-18,-71,19,7,59,0,-1,2004
558,558,10/09/2004,Georgia Tech,20,43,131,22,11,197,0,0,Maryland,7,38,7,23,11,74,0,0,V,-13,13,5,124,-1,0,123,0,0,2004
559,559,10/09/2004,Hawaii,48,24,251,35,21,322,1,1,Nevada-Reno,26,55,233,39,21,258,2,1,H,16.5,22,-31,18,-4,0,64,-1,0,2004
560,560,10/09/2004,Idaho,14,31,83,35,25,210,1,0,UL-Monroe,16,33,117,24,13,139,0,1,H,2,-2,-2,-34,11,12,71,1,-1,2004
561,561,10/09/2004,Illinois,25,39,234,25,15,144,0,1,Michigan State,38,46,253,30,23,234,0,0,V,-8.5,-13,-7,-19,-5,-8,-90,0,1,2004
562,562,10/09/2004,Indiana,24,40,100,50,27,329,1,1,Northwestern,31,40,229,48,28,254,1,0,V,-11,-7,0,-129,2,-1,75,0,1,2004
563,563,10/09/2004,Iowa State,3,42,142,43,18,161,2,0,Texas A+M,27,37,162,31,19,257,0,0,H,-7,-24,5,-20,12,-1,-96,2,0,2004
564,564,10/09/2004,Kansas,31,32,101,27,14,137,0,2,Kansas State,28,33,59,33,19,306,1,1,H,-3,3,-1,42,-6,-5,-169,-1,1,2004
565,565,10/09/2004,Kansas State,28,33,59,33,19,306,1,1,Kansas,31,32,101,27,14,137,0,2,V,3,-3,1,-42,6,5,169,1,-1,2004
566,566,10/09/2004,Kent State,27,36,58,44,28,361,1,3,Miami-Ohio,47,38,116,29,19,308,0,0,V,-19.5,-20,-2,-58,15,9,53,1,3,2004
567,567,10/09/2004,Kentucky,17,28,77,18,7,100,0,3,Alabama,45,63,304,11,7,83,0,0,H,-4.5,-28,-35,-227,7,0,17,0,3,2004
568,568,10/09/2004,Louisiana State,24,45,210,38,24,254,3,0,Florida,21,26,94,33,15,142,0,0,V,-2.5,3,19,116,5,9,112,3,0,2004
569,569,10/09/2004,Louisiana Tech,7,34,37,25,14,185,2,1,Auburn,52,40,198,21,16,274,0,0,V,-25.5,-45,-6,-161,4,-2,-89,2,1,2004
570,570,10/09/2004,Marshall,16,28,109,35,20,170,1,2,Ohio,13,37,76,38,21,236,1,0,V,9.5,3,-9,33,-3,-1,-66,0,2,2004
571,571,10/09/2004,Maryland,7,38,7,23,11,74,0,0,Georgia Tech,20,43,131,22,11,197,0,0,H,13,-13,-5,-124,1,0,-123,0,0,2004
572,572,10/09/2004,Miami-Ohio,47,38,116,29,19,308,0,0,Kent State,27,36,58,44,28,361,1,3,H,19.5,20,2,58,-15,-9,-53,-1,-3,2004
573,573,10/09/2004,Michigan,27,45,190,49,33,328,2,1,Minnesota,24,39,189,22,8,156,0,0,H,3.5,3,6,1,27,25,172,2,1,2004
574,574,10/09/2004,Michigan State,38,46,253,30,23,234,0,0,Illinois,25,39,234,25,15,144,0,1,H,8.5,13,7,19,5,8,90,0,-1,2004
575,575,10/09/2004,Mid Tennessee St,45,36,104,34,30,447,0,0,Arkansas State,17,37,144,29,19,251,3,2,H,6.5,28,-1,-40,5,11,196,-3,-2,2004
576,576,10/09/2004,Minnesota,24,39,189,22,8,156,0,0,Michigan,27,45,190,49,33,328,2,1,V,-3.5,-3,-6,-1,-27,-25,-172,-2,-1,2004
577,577,10/09/2004,Mississippi,31,45,178,34,20,236,0,1,South Carolina,28,39,142,33,15,349,0,1,V,-17,3,6,36,1,5,-113,0,0,2004
578,578,10/09/2004,Mississippi State,13,43,225,20,10,99,0,1,Alabama-Birmingham,27,40,164,19,13,150,0,0,H,-11,-14,3,61,1,-3,-51,0,1,2004
579,579,10/09/2004,Missouri,30,52,176,28,13,151,0,0,Baylor,10,29,85,31,15,88,2,2,V,20.5,20,23,91,-3,-2,63,-2,-2,2004
580,580,10/09/2004,Nebraska,10,37,93,42,15,199,5,2,Texas Tech,70,15,72,61,47,451,1,0,V,-7.5,-60,22,21,-19,-32,-252,4,2,2004
581,581,10/09/2004,Nevada-Reno,26,55,233,39,21,258,2,1,Hawaii,48,24,251,35,21,322,1,1,V,-16.5,-22,31,-18,4,0,-64,1,0,2004
582,582,10/09/2004,New Mexico,23,41,140,22,9,119,1,0,Air Force,28,54,224,8,4,95,0,0,V,-3,-5,-13,-84,14,5,24,1,0,2004
583,583,10/09/2004,New Mexico State,35,42,210,25,16,274,1,2,UL-Lafayette,32,42,166,45,29,334,0,3,H,-3,3,0,44,-20,-13,-60,1,-1,2004
584,584,10/09/2004,No Carolina State,24,50,304,31,24,289,1,2,North Carolina,30,30,164,20,13,208,0,0,V,10.5,-6,20,140,11,11,81,1,2,2004
585,585,10/09/2004,North Carolina,30,30,164,23,15,192,0,0,No Carolina State,24,50,304,28,22,273,1,2,H,-10.5,6,-20,-140,-5,-7,-81,-1,-2,2004
586,586,10/09/2004,North Texas,31,48,259,12,5,84,0,1,Utah State,23,36,79,40,22,290,4,2,V,-3,8,12,180,-28,-17,-206,-4,-1,2004
587,587,10/09/2004,Northern Illinois,30,44,205,30,17,202,3,0,U-C-F,28,36,51,33,25,272,1,1,V,16,2,8,154,-3,-8,-70,2,-1,2004
588,588,10/09/2004,Northwestern,31,40,229,48,28,254,1,0,Indiana,24,40,100,50,27,329,1,1,H,11,7,0,129,-2,1,-75,0,-1,2004
589,589,10/09/2004,Notre Dame,23,51,149,24,11,173,0,1,Stanford,15,25,67,38,17,267,0,0,H,5.5,8,26,82,-14,-6,-94,0,1,2004
590,590,10/09/2004,Ohio,13,37,76,38,21,236,1,0,Marshall,16,28,109,35,20,170,1,2,H,-9.5,-3,9,-33,3,1,66,0,-2,2004
591,591,10/09/2004,Ohio State,13,25,99,31,15,125,0,2,Wisconsin,24,48,184,24,15,160,0,0,H,4,-11,-23,-85,7,0,-35,0,2,2004
592,592,10/09/2004,Oklahoma,12,52,301,27,14,113,2,1,Texas,0,40,154,23,8,86,0,3,N,7.5,12,12,147,4,6,27,2,-2,2004
593,593,10/09/2004,Oklahoma State,42,43,236,11,8,193,1,0,Colorado,14,30,127,46,28,318,2,1,V,4,28,13,109,-35,-20,-125,-1,-1,2004
594,594,10/09/2004,Oregon,41,46,209,56,36,437,0,3,Washington State,38,26,143,36,13,231,2,1,V,-3,3,20,66,20,23,206,-2,2,2004
595,595,10/09/2004,Penn State,13,17,18,51,29,293,0,0,Purdue,20,32,73,35,24,275,2,0,H,-8,-7,-15,-55,16,5,18,-2,0,2004
596,596,10/09/2004,Pittsburgh,27,37,126,19,14,234,0,0,Temple,22,38,144,45,30,314,0,0,V,10.5,5,-1,-18,-26,-16,-80,0,0,2004
597,597,10/09/2004,Purdue,20,32,73,35,24,275,2,0,Penn State,13,17,18,51,29,293,0,0,V,8,7,15,55,-16,-5,-18,2,0,2004
598,598,10/09/2004,Rice,44,77,496,5,1,5,0,1,Southern Methodist,10,32,116,29,17,209,2,1,H,13.5,34,45,380,-24,-16,-204,-2,0,2004
599,599,10/09/2004,Rutgers,37,27,49,40,31,344,1,2,Vanderbilt,34,40,136,21,14,260,0,1,V,-6.5,3,-13,-87,19,17,84,1,1,2004
600,600,10/09/2004,San Diego State,10,32,68,45,28,295,1,2,Wyoming,20,34,72,29,16,192,0,0,V,3,-10,-2,-4,16,12,103,1,2,2004
601,601,10/09/2004,San Jose State,6,42,111,9,7,22,0,0,Washington,21,53,259,16,7,75,2,0,V,-17,-15,-11,-148,-7,0,-53,-2,0,2004
602,602,10/09/2004,South Carolina,28,39,142,33,15,349,0,1,Mississippi,31,45,178,34,20,236,0,1,H,17,-3,-6,-36,-1,-5,113,0,0,2004
603,603,10/09/2004,Southern Cal,23,25,41,25,14,140,2,0,California,17,44,157,35,29,267,0,3,H,7.5,6,-19,-116,-10,-15,-127,2,-3,2004
604,604,10/09/2004,Southern Methodist,10,32,116,29,17,209,2,1,Rice,44,77,496,5,1,5,0,1,V,-13.5,-34,-45,-380,24,16,204,2,0,2004
605,605,10/09/2004,Stanford,15,25,67,38,17,267,0,0,Notre Dame,23,51,149,24,10,149,1,1,V,-5.5,-8,-26,-82,14,7,118,-1,-1,2004
606,606,10/09/2004,Syracuse,13,31,58,28,19,207,1,1,Florida State,17,43,258,26,15,169,1,2,H,-18,-4,-12,-200,2,4,38,0,-1,2004
607,607,10/09/2004,Temple,22,38,144,45,30,314,0,0,Pittsburgh,27,37,126,19,14,234,0,0,H,-10.5,-5,1,18,26,16,80,0,0,2004
608,608,10/09/2004,Tennessee,19,47,127,22,12,150,0,2,Georgia,14,29,56,41,19,209,0,1,V,-12.5,5,18,71,-19,-7,-59,0,1,2004
609,609,10/09/2004,Texas,0,40,154,23,8,86,0,3,Oklahoma,12,52,301,27,14,113,2,1,N,-7.5,-12,-12,-147,-4,-6,-27,-2,2,2004
610,610,10/09/2004,Texas A+M,27,37,162,31,19,257,0,0,Iowa State,3,42,142,43,18,161,2,0,V,7,24,-5,20,-12,1,96,-2,0,2004
611,611,10/09/2004,Texas Tech,70,16,57,60,47,451,1,0,Nebraska,10,37,93,42,15,199,5,2,H,7.5,60,-21,-36,18,32,252,-4,-2,2004
612,612,10/09/2004,Texas-El Paso,24,37,92,23,12,185,0,2,Fresno State,21,39,195,36,20,126,2,0,V,-17,3,-2,-103,-13,-8,59,-2,2,2004
613,613,10/09/2004,Toledo,59,64,350,29,25,299,0,1,Western Michigan,33,17,34,43,24,363,3,2,V,13,26,47,316,-14,1,-64,-3,-1,2004
614,614,10/09/2004,Tulane,25,27,43,28,15,223,2,0,East Carolina,27,47,158,23,13,107,0,2,V,-2.5,-2,-20,-115,5,2,116,2,-2,2004
615,615,10/09/2004,U-C-F,28,36,51,33,25,272,1,1,Northern Illinois,30,44,205,30,17,202,3,0,H,-16,-2,-8,-154,3,8,70,-2,1,2004
616,616,10/09/2004,U.C.L.A.,37,39,114,25,17,234,0,0,Arizona,17,39,258,25,13,93,1,0,H,9.5,20,0,-144,0,4,141,-1,0,2004
617,617,10/09/2004,UL-Lafayette,32,42,166,45,29,334,0,3,New Mexico State,35,42,210,25,16,274,1,2,V,3,-3,0,-44,20,13,60,-1,1,2004
618,618,10/09/2004,UL-Monroe,16,33,117,24,13,139,0,1,Idaho,14,31,83,35,25,210,1,0,V,-2,2,2,34,-11,-12,-71,-1,1,2004
619,619,10/09/2004,Utah State,23,36,79,40,22,290,4,2,North Texas,31,48,259,12,5,84,0,1,H,3,-8,-12,-180,28,17,206,4,1,2004
620,620,10/09/2004,Vanderbilt,34,40,136,21,14,260,0,1,Rutgers,37,27,49,40,31,344,1,2,H,6.5,-3,13,87,-19,-17,-84,-1,-1,2004
621,621,10/09/2004,Virginia Tech,17,50,210,18,12,119,0,2,Wake Forest,10,41,139,26,15,208,1,0,V,6,7,9,71,-8,-3,-89,-1,2,2004
622,622,10/09/2004,Wake Forest,10,41,139,23,13,224,1,0,Virginia Tech,17,50,210,21,14,135,0,2,H,-6,-7,-9,-71,2,-1,89,1,-2,2004
623,623,10/09/2004,Washington,21,53,259,16,7,75,2,0,San Jose State,6,42,111,9,7,22,0,0,H,17,15,11,148,7,0,53,2,0,2004
624,624,10/09/2004,Washington State,38,26,143,36,13,231,2,1,Oregon,41,46,209,56,36,437,0,3,H,3,-3,-20,-66,-20,-23,-206,2,-2,2004
625,625,10/09/2004,Western Michigan,33,17,34,43,24,363,3,2,Toledo,59,64,350,29,25,299,0,1,H,-13,-26,-47,-316,14,-1,64,3,1,2004
626,626,10/09/2004,Wisconsin,24,48,184,24,15,160,0,0,Ohio State,13,25,99,31,15,125,0,2,V,-4,11,23,85,-7,0,35,0,-2,2004
627,627,10/09/2004,Wyoming,20,34,72,29,16,192,0,0,San Diego State,10,32,68,45,28,295,1,2,H,-3,10,2,4,-16,-12,-103,-1,-2,2004
628,628,10/13/2004,Connecticut,19,32,97,47,24,268,3,0,West Virginia,31,49,324,20,12,138,1,1,H,-6.5,-12,-17,-227,27,12,130,2,-1,2004
629,629,10/13/2004,West Virginia,31,49,324,20,12,138,1,1,Connecticut,19,32,97,47,24,268,3,0,V,6.5,12,17,227,-27,-12,-130,-2,1,2004
630,630,10/14/2004,Louisville,38,41,214,36,24,293,1,1,Miami-Florida,41,33,123,37,25,308,1,0,V,-8,-3,8,91,-1,-1,-15,0,1,2004
631,631,10/14/2004,Miami-Florida,41,33,123,37,25,308,1,0,Louisville,38,41,214,36,24,293,1,1,H,8,3,-8,-91,1,1,15,0,-1,2004
632,632,10/15/2004,Alabama-Birmingham,41,33,136,24,15,337,1,0,Texas Christian,25,41,115,38,24,343,0,0,H,6,16,-8,21,-14,-9,-6,1,0,2004
633,633,10/15/2004,Texas Christian,25,41,115,38,24,343,0,0,Alabama-Birmingham,41,33,136,24,15,337,1,0,V,-6,-16,8,-21,14,9,6,-1,0,2004
634,634,10/16/2004,Akron,26,42,166,24,14,169,0,1,U-C-F,21,34,48,41,30,322,2,2,V,-2,5,8,118,-17,-16,-153,-2,-1,2004
635,635,10/16/2004,Alabama,27,51,262,9,4,72,1,0,Southern Miss,3,37,148,23,6,23,1,1,H,8,24,14,114,-14,-2,49,0,-1,2004
636,636,10/16/2004,Arizona,14,33,110,34,14,156,3,0,Oregon,28,42,156,30,21,336,0,2,V,-13,-14,-9,-46,4,-7,-180,3,-2,2004
637,637,10/16/2004,Arizona State,7,30,24,39,23,219,2,0,Southern Cal,45,38,145,28,17,301,0,1,V,-10.5,-38,-8,-121,11,6,-82,2,-1,2004
638,638,10/16/2004,Arkansas,20,29,128,29,14,209,0,0,Auburn,38,47,225,20,17,297,1,1,V,-12,-18,-18,-97,9,-3,-88,-1,-1,2004
639,639,10/16/2004,Arkansas State,13,40,124,23,11,114,0,0,Troy State,9,46,176,19,6,73,1,2,H,-14.5,4,-6,-52,4,5,41,-1,-2,2004
640,640,10/16/2004,Army,42,37,242,27,16,202,0,1,South Florida,35,53,367,23,10,116,1,1,V,-14.5,7,-16,-125,4,6,86,-1,0,2004
641,641,10/16/2004,Auburn,38,47,225,20,17,297,1,1,Arkansas,20,29,128,29,14,209,0,0,H,12,18,18,97,-9,3,88,1,1,2004
642,642,10/16/2004,Ball State,13,46,92,42,18,193,0,0,Bowling Green,51,31,135,28,20,302,0,0,V,-30,-38,15,-43,14,-2,-109,0,0,2004
643,643,10/16/2004,Baylor,27,38,100,40,25,300,1,1,Nebraska,59,42,169,20,13,342,0,0,V,-23,-32,-4,-69,20,12,-42,1,1,2004
644,644,10/16/2004,Boise State,45,56,264,34,18,261,2,0,Tulsa,42,32,107,29,19,305,1,0,V,19,3,24,157,5,-1,-44,1,0,2004
645,645,10/16/2004,Boston College,17,32,56,53,32,367,0,2,Pittsburgh,20,42,177,27,12,131,0,1,V,8,-3,-10,-121,26,20,236,0,1,2004
646,646,10/16/2004,Bowling Green,51,31,135,28,20,302,0,0,Ball State,13,46,92,42,18,193,0,0,H,30,38,-15,43,-14,2,109,0,0,2004
647,647,10/16/2004,Brigham Young,24,44,237,26,11,179,1,2,Wyoming,13,37,102,40,23,219,4,0,H,7.5,11,7,135,-14,-12,-40,-3,2,2004
648,648,10/16/2004,Buffalo,7,31,67,19,10,98,1,0,Miami-Ohio,25,45,116,36,25,306,1,1,H,-21,-18,-14,-49,-17,-15,-208,0,-1,2004
649,649,10/16/2004,California,45,43,290,30,19,260,0,1,U.C.L.A.,28,30,79,36,20,299,0,1,H,17,17,13,211,-6,-1,-39,0,0,2004
650,650,10/16/2004,Central Michigan,10,36,193,22,12,115,0,1,Northern Illinois,42,66,331,15,9,148,0,0,V,-19.5,-32,-30,-138,7,3,-33,0,1,2004
651,651,10/16/2004,Clemson,35,48,200,24,15,179,2,0,Utah State,6,30,-20,31,16,159,1,0,H,25,29,18,220,-7,-1,20,1,0,2004
652,652,10/16/2004,Colorado,19,34,141,34,18,163,3,0,Iowa State,14,47,164,33,16,239,1,3,H,11,5,-13,-23,1,2,-76,2,-3,2004
653,653,10/16/2004,Colorado State,21,38,63,28,17,133,1,1,San Diego State,17,32,128,41,19,238,2,1,V,-4.5,4,6,-65,-13,-2,-105,-1,0,2004
654,654,10/16/2004,Duke,7,40,84,23,11,100,0,2,Georgia Tech,24,38,183,21,11,147,2,1,V,-16.5,-17,2,-99,2,0,-47,-2,1,2004
655,655,10/16/2004,Eastern Michigan,35,34,200,36,14,229,1,1,Western Michigan,31,37,75,48,29,338,2,2,V,-3.5,4,-3,125,-12,-15,-109,-1,-1,2004
656,656,10/16/2004,Florida,52,32,141,25,20,360,1,1,Mid Tennessee St,16,37,78,38,25,223,2,0,H,28.5,36,-5,63,-13,-5,137,-1,1,2004
657,657,10/16/2004,Florida Atlantic,39,36,151,33,18,307,0,1,Northern Colorado,24,38,33,31,18,298,1,0,V, ,15,-2,118,2,0,9,-1,1,2004
658,658,10/16/2004,Florida State,36,39,192,27,21,278,0,0,Virginia,3,29,20,38,26,261,1,0,H,3,33,10,172,-11,-5,17,-1,0,2004
659,659,10/16/2004,Georgia,33,47,273,26,18,254,1,1,Vanderbilt,3,30,53,23,13,134,0,0,H,23.5,30,17,220,3,5,120,1,1,2004
660,660,10/16/2004,Georgia Tech,24,38,183,21,11,147,2,1,Duke,7,40,85,23,11,100,0,2,H,16.5,17,-2,98,-2,0,47,2,-1,2004
661,661,10/16/2004,Hawaii,20,14,77,65,32,359,2,2,Texas-El Paso,51,42,173,45,28,317,4,0,V,-3,-31,-28,-96,20,4,42,-2,2,2004
662,662,10/16/2004,Idaho,38,41,250,28,21,197,0,0,UL-Lafayette,25,38,183,49,21,339,2,1,H,-3.5,13,3,67,-21,0,-142,-2,-1,2004
663,663,10/16/2004,Illinois,19,30,98,40,20,156,3,1,Michigan,30,61,294,27,14,114,2,0,H,-17.5,-11,-31,-196,13,6,42,1,1,2004
664,664,10/16/2004,Iowa,33,37,117,39,26,331,0,1,Ohio State,7,29,27,26,14,150,1,2,H,2,26,8,90,13,12,181,-1,-1,2004
665,665,10/16/2004,Iowa State,14,47,164,33,16,239,1,3,Colorado,19,34,141,34,18,163,3,0,V,-11,-5,13,23,-1,-2,76,-2,3,2004
666,666,10/16/2004,Kansas State,21,25,1,41,21,246,0,3,Oklahoma,31,44,149,31,20,256,1,0,H,-19,-10,-19,-148,10,1,-10,-1,3,2004
667,667,10/16/2004,Kent State,17,34,113,34,13,122,3,0,Marshall,27,41,41,35,15,198,1,1,H,-13,-10,-7,72,-1,-2,-76,2,-1,2004
668,668,10/16/2004,Kentucky,7,35,80,35,22,171,1,3,South Carolina,12,43,213,16,9,105,2,3,H,-13,-5,-8,-133,19,13,66,-1,0,2004
669,669,10/16/2004,Louisiana Tech,41,40,277,27,19,313,0,1,Southern Methodist,10,31,62,53,26,288,4,1,V,8,31,9,215,-26,-7,25,-4,0,2004
670,670,10/16/2004,Marshall,27,41,41,35,15,198,1,1,Kent State,17,34,113,34,13,122,3,0,V,13,10,7,-72,1,2,76,-2,1,2004
671,671,10/16/2004,Maryland,3,37,68,19,7,24,0,0,No Carolina State,13,45,95,30,13,208,0,1,H,1.5,-10,-8,-27,-11,-6,-184,0,-1,2004
672,672,10/16/2004,Memphis,49,42,257,31,23,226,1,1,Tulane,24,34,90,35,16,231,1,0,H,23.5,25,8,167,-4,7,-5,0,1,2004
673,673,10/16/2004,Miami-Ohio,25,45,116,36,25,306,1,1,Buffalo,7,31,67,19,10,98,1,0,V,21,18,14,49,17,15,208,0,1,2004
674,674,10/16/2004,Michigan,30,61,294,27,14,114,2,0,Illinois,19,30,98,40,20,156,3,1,V,17.5,11,31,196,-13,-6,-42,-1,-1,2004
675,675,10/16/2004,Michigan State,51,52,324,32,21,312,2,1,Minnesota,17,29,102,33,11,211,2,0,H,-8,34,23,222,-1,10,101,0,1,2004
676,676,10/16/2004,Mid Tennessee St,16,37,78,38,25,223,2,0,Florida,52,32,141,25,20,360,1,1,V,-28.5,-36,5,-63,13,5,-137,1,-1,2004
677,677,10/16/2004,Minnesota,17,29,102,33,11,211,2,0,Michigan State,51,52,324,32,21,312,2,1,V,8,-34,-23,-222,1,-10,-101,0,-1,2004
678,678,10/16/2004,Mississippi,17,38,89,26,14,168,2,1,Tennessee,21,37,118,33,16,258,1,1,H,-10,-4,1,-29,-7,-2,-90,1,0,2004
679,679,10/16/2004,Missouri,20,47,173,34,20,185,2,0,Texas,28,39,193,20,8,106,2,1,V,-13.5,-8,8,-20,14,12,79,0,-1,2004
680,680,10/16/2004,Navy,9,61,216,6,3,44,0,1,Notre Dame,27,44,204,20,11,130,0,0,N,-6,-18,17,12,-14,-8,-86,0,1,2004
681,681,10/16/2004,Nebraska,59,42,169,20,13,342,0,0,Baylor,27,38,100,40,25,300,1,1,H,23,32,4,69,-20,-12,42,-1,-1,2004
682,682,10/16/2004,Nevada-Las Vegas,20,36,155,33,17,206,2,4,New Mexico,24,50,284,27,14,92,0,0,H,2,-4,-14,-129,6,3,114,2,4,2004
683,683,10/16/2004,Nevada-Reno,35,42,192,32,16,168,2,0,Rice,10,53,268,16,7,57,1,1,H,-7.5,25,-11,-76,16,9,111,1,-1,2004
684,684,10/16/2004,New Mexico,24,50,284,27,14,92,0,0,Nevada-Las Vegas,20,36,156,33,17,206,2,4,V,-2,4,14,128,-6,-3,-114,-2,-4,2004
685,685,10/16/2004,No Carolina State,13,45,95,30,13,208,0,1,Maryland,3,37,67,19,7,24,0,0,V,-1.5,10,8,28,11,6,184,0,1,2004
686,686,10/16/2004,North Carolina,16,27,48,34,16,173,1,1,Utah,46,46,288,40,31,381,1,1,V,-22.5,-30,-19,-240,-6,-15,-208,0,0,2004
687,687,10/16/2004,Northern Illinois,42,66,331,15,9,148,0,0,Central Michigan,10,36,193,22,12,115,0,1,H,19.5,32,30,138,-7,-3,33,0,-1,2004
688,688,10/16/2004,Notre Dame,27,44,204,20,11,130,0,0,Navy,9,61,216,6,3,44,0,1,N,6,18,-17,-12,14,8,86,0,-1,2004
689,689,10/16/2004,Ohio,13,37,98,31,14,132,1,2,Toledo,31,39,115,38,26,285,0,1,V,-12,-18,-2,-17,-7,-12,-153,1,1,2004
690,690,10/16/2004,Ohio State,7,29,27,26,14,150,1,2,Iowa,33,37,117,39,26,331,0,1,V,-2,-26,-8,-90,-13,-12,-181,1,1,2004
691,691,10/16/2004,Oklahoma,31,44,149,31,20,256,1,0,Kansas State,21,25,1,41,21,246,0,3,V,19,10,19,148,-10,-1,10,1,-3,2004
692,692,10/16/2004,Oklahoma State,20,53,182,26,15,202,0,2,Texas A+M,36,38,191,25,19,288,0,0,H,7,-16,15,-9,1,-4,-86,0,2,2004
693,693,10/16/2004,Oregon,28,42,156,30,21,336,0,2,Arizona,14,33,110,34,14,156,3,0,H,13,14,9,46,-4,7,180,-3,2,2004
694,694,10/16/2004,Oregon State,29,36,101,40,26,286,0,2,Washington,14,35,121,36,13,224,3,4,V,7.5,15,1,-20,4,13,62,-3,-2,2004
695,695,10/16/2004,Pittsburgh,20,42,177,27,12,131,0,1,Boston College,17,32,56,53,32,367,0,2,H,-8,3,10,121,-26,-20,-236,0,-1,2004
696,696,10/16/2004,Purdue,17,40,132,45,25,235,1,2,Wisconsin,20,30,84,32,17,211,1,0,H,7.5,-3,10,48,13,8,24,0,2,2004
697,697,10/16/2004,Rice,10,53,268,16,7,57,1,1,Nevada-Reno,35,42,192,32,16,168,2,0,V,7.5,-25,11,76,-16,-9,-111,-1,1,2004
698,698,10/16/2004,Rutgers,16,32,90,31,18,193,4,1,Temple,6,41,141,39,21,219,2,2,H,13,10,-9,-51,-8,-3,-26,2,-1,2004
699,699,10/16/2004,San Diego State,17,32,128,41,19,238,2,1,Colorado State,21,38,63,28,17,133,1,1,H,4.5,-4,-6,65,13,2,105,1,0,2004
700,700,10/16/2004,South Carolina,12,43,213,16,9,105,2,3,Kentucky,7,35,80,35,22,171,1,3,V,13,5,8,133,-19,-13,-66,1,0,2004
701,701,10/16/2004,South Florida,35,53,367,23,10,116,1,1,Army,42,37,242,27,16,202,0,1,H,14.5,-7,16,125,-4,-6,-86,1,0,2004
702,702,10/16/2004,Southern Cal,45,38,145,28,17,301,0,0,Arizona State,7,30,24,39,23,219,2,0,H,10.5,38,8,121,-11,-6,82,-2,0,2004
703,703,10/16/2004,Southern Methodist,10,31,62,53,26,288,4,1,Louisiana Tech,41,40,277,27,19,313,0,1,H,-8,-31,-9,-215,26,7,-25,4,0,2004
704,704,10/16/2004,Southern Miss,3,37,148,23,6,23,1,1,Alabama,27,51,262,9,4,72,1,0,V,-8,-24,-14,-114,14,2,-49,0,1,2004
705,705,10/16/2004,Stanford,23,41,139,33,16,244,1,0,Washington State,17,36,180,36,18,257,3,0,V,-2,6,5,-41,-3,-2,-13,-2,0,2004
706,706,10/16/2004,Temple,6,41,141,39,21,219,2,2,Rutgers,16,32,90,31,18,193,4,1,V,-13,-10,9,51,8,3,26,-2,1,2004
707,707,10/16/2004,Tennessee,21,37,118,33,16,258,1,1,Mississippi,17,38,89,26,14,168,2,1,V,10,4,-1,29,7,2,90,-1,0,2004
708,708,10/16/2004,Texas,28,39,193,20,8,106,2,1,Missouri,20,47,173,34,20,185,2,0,H,13.5,8,-8,20,-14,-12,-79,0,1,2004
709,709,10/16/2004,Texas A+M,36,38,191,25,19,288,0,0,Oklahoma State,20,53,182,26,15,202,0,2,V,-7,16,-15,9,-1,4,86,0,-2,2004
710,710,10/16/2004,Texas-El Paso,51,42,173,45,28,317,4,0,Hawaii,20,14,77,65,32,359,2,2,H,3,31,28,96,-20,-4,-42,2,-2,2004
711,711,10/16/2004,Toledo,31,39,115,38,26,285,0,1,Ohio,13,37,98,31,14,132,1,2,H,12,18,2,17,7,12,153,-1,-1,2004
712,712,10/16/2004,Troy State,9,46,176,19,6,73,1,2,Arkansas State,13,40,124,23,11,114,0,0,V,14.5,-4,6,52,-4,-5,-41,1,2,2004
713,713,10/16/2004,Tulane,24,34,90,35,16,231,1,0,Memphis,49,42,257,31,23,226,1,1,V,-23.5,-25,-8,-167,4,-7,5,0,-1,2004
714,714,10/16/2004,Tulsa,42,32,107,29,19,305,1,0,Boise State,45,56,264,34,18,261,2,0,H,-19,-3,-24,-157,-5,1,44,-1,0,2004
715,715,10/16/2004,U-C-F,21,34,48,41,30,322,2,2,Akron,26,42,166,24,14,169,0,1,H,2,-5,-8,-118,17,16,153,2,1,2004
716,716,10/16/2004,U.C.L.A.,28,30,79,36,20,299,0,1,California,45,43,290,30,19,260,0,1,V,-17,-17,-13,-211,6,1,39,0,0,2004
717,717,10/16/2004,UL-Lafayette,25,38,183,49,21,339,2,1,Idaho,38,41,250,28,21,197,0,0,V,3.5,-13,-3,-67,21,0,142,2,1,2004
718,718,10/16/2004,UL-Monroe,28,36,89,41,25,303,1,0,Florida Intl,20,22,41,48,25,217,2,1,H,8.5,8,14,48,-7,0,86,-1,-1,2004
719,719,10/16/2004,Utah,46,46,288,40,31,381,1,1,North Carolina,16,27,48,34,16,173,1,1,H,22.5,30,19,240,6,15,208,0,0,2004
720,720,10/16/2004,Utah State,6,30,-20,31,16,159,1,0,Clemson,35,48,200,24,15,179,2,0,V,-25,-29,-18,-220,7,1,-20,-1,0,2004
721,721,10/16/2004,Vanderbilt,3,30,53,23,13,134,0,0,Georgia,33,47,273,26,18,254,1,1,V,-23.5,-30,-17,-220,-3,-5,-120,-1,-1,2004
722,722,10/16/2004,Virginia,3,29,20,38,26,261,1,0,Florida State,36,39,192,27,21,278,0,0,V,-3,-33,-10,-172,11,5,-17,1,0,2004
723,723,10/16/2004,Virginia Tech,62,54,310,21,13,173,0,1,Florida A+M,0,37,60,38,19,139,3,2,H, ,62,17,250,-17,-6,34,-3,-1,2004
724,724,10/16/2004,Washington,14,35,121,36,13,224,3,4,Oregon State,29,36,101,40,26,286,0,2,H,-7.5,-15,-1,20,-4,-13,-62,3,2,2004
725,725,10/16/2004,Washington State,17,36,180,36,18,257,3,1,Stanford,23,41,139,33,16,244,1,0,H,2,-6,-5,41,3,2,13,2,1,2004
726,726,10/16/2004,Western Michigan,31,37,75,48,29,338,2,2,Eastern Michigan,35,34,200,36,14,229,1,1,H,3.5,-4,3,-125,12,15,109,1,1,2004
727,727,10/16/2004,Wisconsin,20,30,84,32,17,211,1,0,Purdue,17,40,132,45,25,235,1,2,V,-7.5,3,-10,-48,-13,-8,-24,0,-2,2004
728,728,10/16/2004,Wyoming,13,37,103,40,23,219,4,0,Brigham Young,24,44,237,26,11,179,1,2,V,-7.5,-11,-7,-134,14,12,40,3,-2,2004
729,729,10/21/2004,Syracuse,6,36,66,37,23,249,0,1,West Virginia,27,50,279,12,7,144,0,1,V,-14.5,-21,-14,-213,25,16,105,0,0,2004
730,730,10/21/2004,West Virginia,27,50,279,12,7,144,0,1,Syracuse,6,36,66,37,23,249,0,1,H,14.5,21,14,213,-25,-16,-105,0,0,2004
731,731,10/22/2004,Colorado State,30,50,233,22,11,167,1,1,Wyoming,7,29,80,39,26,256,2,2,H,3,23,21,153,-17,-15,-89,-1,-1,2004
732,732,10/22/2004,Louisville,41,41,172,39,28,345,0,1,South Florida,9,36,136,21,3,67,2,0,H,28.5,32,5,36,18,25,278,-2,1,2004
733,733,10/22/2004,South Florida,9,36,136,21,3,67,2,0,Louisville,41,41,172,39,28,345,0,1,V,-28.5,-32,-5,-36,-18,-25,-278,2,-1,2004
734,734,10/22/2004,Wyoming,7,29,80,39,26,256,2,2,Colorado State,30,50,233,22,11,167,1,1,V,-3,-23,-21,-153,17,15,89,1,1,2004
735,735,10/23/2004,Air Force,24,47,213,24,10,150,0,0,Brigham Young,41,39,173,32,21,354,1,1,H,1.5,-17,8,40,-8,-11,-204,-1,-1,2004
736,736,10/23/2004,Akron,35,43,192,33,21,246,0,3,Ball State,23,38,176,38,21,200,2,0,H,12,12,5,16,-5,0,46,-2,3,2004
737,737,10/23/2004,Alabama,13,39,105,28,14,113,1,1,Tennessee,17,34,63,22,10,132,2,0,V,-7,-4,5,42,6,4,-19,-1,1,2004
738,738,10/23/2004,Alabama-Birmingham,55,39,201,38,23,448,0,1,Tulane,59,26,108,49,36,417,0,0,V,18,-4,13,93,-11,-13,31,0,1,2004
739,739,10/23/2004,Arizona,0,29,86,32,13,159,1,1,California,38,41,192,30,22,267,2,0,H,-23,-38,-12,-106,2,-9,-108,-1,1,2004
740,740,10/23/2004,Arizona State,48,37,121,51,25,415,3,0,U.C.L.A.,42,35,210,45,30,325,4,0,H,7,6,2,-89,6,-5,90,-1,0,2004
741,741,10/23/2004,Arkansas,14,33,97,21,12,181,0,2,Georgia,20,47,131,30,22,382,0,2,H,-8,-6,-14,-34,-9,-10,-201,0,0,2004
742,742,10/23/2004,Arkansas State,24,40,306,38,16,164,1,0,UL-Lafayette,27,47,184,29,17,226,0,0,V,-3,-3,-7,122,9,-1,-62,1,0,2004
743,743,10/23/2004,Auburn,42,49,210,18,11,127,1,1,Kentucky,10,36,37,26,14,73,0,2,H,28,32,13,173,-8,-3,54,1,-1,2004
744,744,10/23/2004,Ball State,23,38,176,38,21,200,2,0,Akron,35,43,192,33,21,246,0,3,V,-12,-12,-5,-16,5,0,-46,2,-3,2004
745,745,10/23/2004,Baylor,25,41,140,39,31,310,0,4,Iowa State,26,39,109,20,12,148,0,0,H,-7.5,-1,2,31,19,19,162,0,4,2004
746,746,10/23/2004,Boise State,33,55,164,23,15,227,0,1,Fresno State,16,17,17,30,17,174,2,1,H,8,17,38,147,-7,-2,53,-2,0,2004
747,747,10/23/2004,Boston College,24,28,62,41,27,383,2,0,Notre Dame,23,34,104,33,20,231,2,0,V,-7,1,-6,-42,8,7,152,0,0,2004
748,748,10/23/2004,Bowling Green,41,31,76,48,30,405,0,0,Ohio,16,30,65,37,15,200,0,0,V,15,25,1,11,11,15,205,0,0,2004
749,749,10/23/2004,Brigham Young,41,39,173,32,21,354,1,1,Air Force,24,47,213,24,10,150,0,0,V,-1.5,17,-8,-40,8,11,204,1,1,2004
750,750,10/23/2004,Buffalo,14,37,202,22,10,101,1,0,Marshall,48,47,193,28,20,273,2,1,V,-26,-34,-10,9,-6,-10,-172,-1,-1,2004
751,751,10/23/2004,California,38,41,192,30,22,267,2,0,Arizona,0,29,86,32,13,159,1,1,V,23,38,12,106,-2,9,108,1,-1,2004
752,752,10/23/2004,Central Michigan,22,42,168,42,29,385,0,1,Toledo,27,32,123,42,29,375,1,0,V,-21.5,-5,10,45,0,0,10,-1,1,2004
753,753,10/23/2004,Cincinnati,49,59,242,18,13,182,0,0,Memphis,10,28,89,25,11,113,1,0,H,-4.5,39,31,153,-7,2,69,-1,0,2004
754,754,10/23/2004,Clemson,10,40,36,31,14,170,0,0,Maryland,7,37,83,31,14,111,2,0,H,4,3,3,-47,0,0,59,-2,0,2004
755,755,10/23/2004,Colorado,26,36,146,43,26,364,0,2,Texas A+M,29,46,238,39,24,294,0,0,V,-17.5,-3,-10,-92,4,2,70,0,2,2004
756,756,10/23/2004,Connecticut,45,34,258,29,18,260,1,3,Temple,31,41,199,44,21,276,1,0,H,17,14,-7,59,-15,-3,-16,0,3,2004
757,757,10/23/2004,Duke,16,34,95,32,20,242,1,0,Virginia,37,61,348,20,11,163,0,1,H,-24,-21,-27,-253,12,9,79,1,-1,2004
758,758,10/23/2004,East Carolina,10,27,-3,33,18,181,0,1,Southern Miss,51,60,264,12,8,119,0,0,V,-18.5,-41,-33,-267,21,10,62,0,1,2004
759,759,10/23/2004,Florida,31,30,181,35,20,260,1,2,Mississippi State,38,47,251,24,15,158,0,1,V,23,-7,-17,-70,11,5,102,1,1,2004
760,760,10/23/2004,Florida Atlantic,13,40,151,36,18,260,3,0,UL-Monroe,17,31,137,33,24,202,0,1,H,12.5,-4,9,14,3,-6,58,3,-1,2004
761,761,10/23/2004,Florida State,20,38,138,39,17,194,2,1,Wake Forest,17,45,133,29,15,137,1,0,V,14,3,-7,5,10,2,57,1,1,2004
762,762,10/23/2004,Fresno State,16,17,17,30,17,174,2,1,Boise State,33,55,164,23,15,227,0,1,V,-8,-17,-38,-147,7,2,-53,2,0,2004
763,763,10/23/2004,Georgia,20,47,131,30,22,382,0,2,Arkansas,14,33,97,21,12,181,0,2,V,8,6,14,34,9,10,201,0,0,2004
764,764,10/23/2004,Hawaii,46,30,108,40,26,341,2,0,San Jose State,28,47,315,24,10,82,1,1,H,22.5,18,-17,-207,16,16,259,1,-1,2004
765,765,10/23/2004,Houston,27,30,121,44,25,256,0,1,Texas Christian,34,51,229,30,20,284,1,0,V,-6.5,-7,-21,-108,14,5,-28,-1,1,2004
766,766,10/23/2004,Idaho,14,30,87,47,28,236,0,1,Mid Tennessee St,34,39,165,27,19,203,1,0,V,-12,-20,-9,-78,20,9,33,-1,1,2004
767,767,10/23/2004,Illinois,0,33,72,29,19,159,1,1,Minnesota,45,49,319,22,11,268,0,0,V,-19.5,-45,-16,-247,7,8,-109,1,1,2004
768,768,10/23/2004,Indiana,7,36,53,28,17,189,1,0,Ohio State,30,43,282,24,12,161,0,0,V,-13.5,-23,-7,-229,4,5,28,1,0,2004
769,769,10/23/2004,Iowa,6,40,42,31,14,126,1,1,Penn State,4,29,51,28,9,96,4,1,V,-2.5,2,11,-9,3,5,30,-3,0,2004
770,770,10/23/2004,Iowa State,26,39,109,20,12,148,0,0,Baylor,25,41,140,39,31,310,0,4,V,7.5,1,-2,-31,-19,-19,-162,0,-4,2004
771,771,10/23/2004,Kansas,10,34,72,35,17,184,2,1,Oklahoma,41,31,118,44,27,389,0,0,V,-27,-31,3,-46,-9,-10,-205,2,1,2004
772,772,10/23/2004,Kansas State,45,61,294,23,14,124,0,2,Nebraska,21,34,106,12,3,116,1,3,H,5.5,24,27,188,11,11,8,-1,-1,2004
773,773,10/23/2004,Kentucky,10,36,37,26,14,73,0,2,Auburn,42,49,210,18,11,127,1,1,V,-28,-32,-13,-173,8,3,-54,-1,1,2004
774,774,10/23/2004,Louisiana State,24,36,57,38,25,329,3,1,Troy State,20,40,90,17,7,60,0,0,H,23.5,4,-4,-33,21,18,269,3,1,2004
775,775,10/23/2004,Louisiana Tech,27,40,192,28,9,151,3,1,Texas-El Paso,44,40,150,30,17,259,0,2,H,2.5,-17,0,42,-2,-8,-108,3,-1,2004
776,776,10/23/2004,Marshall,48,47,193,28,20,273,2,1,Buffalo,14,37,202,22,10,101,1,0,H,26,34,10,-9,6,10,172,1,1,2004
777,777,10/23/2004,Maryland,7,37,83,31,14,111,2,0,Clemson,10,40,36,31,14,170,0,0,V,-4,-3,-3,47,0,0,-59,2,0,2004
778,778,10/23/2004,Memphis,10,28,89,25,11,113,1,0,Cincinnati,49,59,242,18,13,182,0,0,V,4.5,-39,-31,-153,7,-2,-69,1,0,2004
779,779,10/23/2004,Miami-Florida,45,46,151,30,15,265,1,1,No Carolina State,31,35,180,38,20,260,1,3,V,6.5,14,11,-29,-8,-5,5,0,-2,2004
780,780,10/23/2004,Miami-Ohio,43,38,206,40,24,288,2,1,U-C-F,7,34,88,22,8,72,1,1,H,22.5,36,4,118,18,16,216,1,0,2004
781,781,10/23/2004,Michigan,16,43,204,39,22,190,1,0,Purdue,14,33,50,30,14,213,1,1,V,-4,2,10,154,9,8,-23,0,-1,2004
782,782,10/23/2004,Mid Tennessee St,34,39,165,27,19,203,1,0,Idaho,14,30,87,47,28,236,0,1,H,12,20,9,78,-20,-9,-33,1,-1,2004
783,783,10/23/2004,Minnesota,45,49,319,22,11,268,0,0,Illinois,0,33,72,29,19,159,1,1,H,19.5,45,16,247,-7,-8,109,-1,-1,2004
784,784,10/23/2004,Mississippi State,38,47,251,24,15,158,0,1,Florida,31,30,181,35,20,260,1,2,H,-23,7,17,70,-11,-5,-102,-1,-1,2004
785,785,10/23/2004,Missouri,17,45,168,29,18,96,1,0,Oklahoma State,20,46,278,15,7,110,1,1,H,4,-3,-1,-110,14,11,-14,0,-1,2004
786,786,10/23/2004,Navy,14,52,263,15,4,79,0,0,Rice,13,53,223,5,5,35,0,0,H,8.5,1,-1,40,10,-1,44,0,0,2004
787,787,10/23/2004,Nebraska,21,34,106,12,3,116,1,3,Kansas State,45,61,294,23,14,124,0,2,V,-5.5,-24,-27,-188,-11,-11,-8,1,1,2004
788,788,10/23/2004,Nevada-Las Vegas,28,48,311,22,9,111,2,2,Utah,63,46,281,22,12,152,0,1,V,-24,-35,2,30,0,-3,-41,2,1,2004
789,789,10/23/2004,Nevada-Reno,54,42,192,33,20,299,0,1,Tulsa,48,60,312,31,14,197,3,1,H,3,6,-18,-120,2,6,102,-3,0,2004
790,790,10/23/2004,New Mexico,19,51,114,17,10,106,0,1,San Diego State,9,30,-19,32,16,165,2,0,H,4.5,10,21,133,-15,-6,-59,-2,1,2004
791,791,10/23/2004,New Mexico State,26,34,105,39,27,249,0,0,North Texas,36,43,262,14,10,139,0,0,V,-8.5,-10,-9,-157,25,17,110,0,0,2004
792,792,10/23/2004,No Carolina State,31,35,180,38,20,260,1,3,Miami-Florida,45,46,151,30,15,265,1,1,H,-6.5,-14,-11,29,8,5,-5,0,2,2004
793,793,10/23/2004,North Texas,36,43,262,14,10,139,0,0,New Mexico State,26,34,105,39,27,249,0,0,H,8.5,10,9,157,-25,-17,-110,0,0,2004
794,794,10/23/2004,Northern Illinois,59,41,265,25,17,387,0,0,Western Michigan,38,40,204,45,26,290,2,0,V,19,21,1,61,-20,-9,97,-2,0,2004
795,795,10/23/2004,Northwestern,12,36,149,37,16,185,1,0,Wisconsin,24,53,208,21,13,178,1,1,V,-11.5,-12,-17,-59,16,3,7,0,-1,2004
796,796,10/23/2004,Notre Dame,23,34,104,33,20,231,2,0,Boston College,24,28,62,41,27,383,2,0,H,7,-1,6,42,-8,-7,-152,0,0,2004
797,797,10/23/2004,Ohio,16,30,65,37,15,200,0,0,Bowling Green,41,31,76,48,30,405,0,0,H,-15,-25,-1,-11,-11,-15,-205,0,0,2004
798,798,10/23/2004,Ohio State,30,43,282,24,12,161,0,0,Indiana,7,36,53,28,17,189,1,0,H,13.5,23,7,229,-4,-5,-28,-1,0,2004
799,799,10/23/2004,Oklahoma,41,31,118,44,27,389,0,0,Kansas,10,34,72,35,17,184,2,1,H,27,31,-3,46,9,10,205,-2,-1,2004
800,800,10/23/2004,Oklahoma State,20,46,278,15,7,110,1,1,Missouri,17,45,168,29,18,96,1,0,V,-4,3,1,110,-14,-11,14,0,1,2004
801,801,10/23/2004,Oregon,16,39,149,33,22,275,1,1,Stanford,13,29,-8,39,23,269,0,0,V,-2.5,3,10,157,-6,-1,6,1,1,2004
802,802,10/23/2004,Oregon State,38,50,171,40,18,270,1,0,Washington State,19,31,119,41,15,201,2,1,H,8,19,19,52,-1,3,69,-1,-1,2004
803,803,10/23/2004,Penn State,4,29,51,28,9,96,4,1,Iowa,6,40,42,31,14,126,1,1,H,2.5,-2,-11,9,-3,-5,-30,3,0,2004
804,804,10/23/2004,Pittsburgh,41,42,79,43,27,318,1,1,Rutgers,17,22,56,57,31,351,4,1,H,4.5,24,20,23,-14,-4,-33,-3,0,2004
805,805,10/23/2004,Purdue,14,33,50,30,14,213,1,1,Michigan,16,43,204,39,22,190,1,0,H,4,-2,-10,-154,-9,-8,23,0,1,2004
806,806,10/23/2004,Rice,13,53,223,5,5,35,0,0,Navy,14,52,263,15,4,79,0,0,V,-8.5,-1,1,-40,-10,1,-44,0,0,2004
807,807,10/23/2004,Rutgers,17,22,56,57,31,351,4,1,Pittsburgh,41,42,79,43,27,318,1,1,V,-4.5,-24,-20,-23,14,4,33,3,0,2004
808,808,10/23/2004,San Diego State,9,30,-19,32,16,165,2,0,New Mexico,19,51,114,17,10,106,0,1,V,-4.5,-10,-21,-133,15,6,59,2,-1,2004
809,809,10/23/2004,San Jose State,28,47,315,24,10,82,1,1,Hawaii,46,30,108,40,26,341,2,0,V,-22.5,-18,17,207,-16,-16,-259,-1,1,2004
810,810,10/23/2004,Southern Cal,38,42,197,48,28,256,1,1,Washington,0,27,50,28,7,63,1,2,H,37.5,38,15,147,20,21,193,0,-1,2004
811,811,10/23/2004,Southern Miss,51,60,264,12,8,119,0,0,East Carolina,10,27,-3,33,18,181,0,1,H,18.5,41,33,267,-21,-10,-62,0,-1,2004
812,812,10/23/2004,Stanford,13,29,-8,39,23,269,0,0,Oregon,16,39,149,33,22,275,1,1,H,2.5,-3,-10,-157,6,1,-6,-1,-1,2004
813,813,10/23/2004,Temple,31,41,199,44,21,276,1,0,Connecticut,45,34,258,29,18,260,1,3,V,-17,-14,7,-59,15,3,16,0,-3,2004
814,814,10/23/2004,Tennessee,17,34,63,22,10,132,2,0,Alabama,13,39,105,28,14,113,1,1,H,7,4,-5,-42,-6,-4,19,1,-1,2004
815,815,10/23/2004,Texas,51,71,351,15,10,142,0,0,Texas Tech,21,11,-17,51,34,403,1,0,V,-2.5,30,60,368,-36,-24,-261,-1,0,2004
816,816,10/23/2004,Texas A+M,29,46,238,39,24,294,0,0,Colorado,26,36,146,43,26,364,0,2,H,17.5,3,10,92,-4,-2,-70,0,-2,2004
817,817,10/23/2004,Texas Christian,34,51,229,30,20,284,1,0,Houston,27,30,121,44,25,256,0,1,H,6.5,7,21,108,-14,-5,28,1,-1,2004
818,818,10/23/2004,Texas Tech,21,11,-17,51,34,403,1,0,Texas,51,71,351,15,10,142,0,0,H,2.5,-30,-60,-368,36,24,261,1,0,2004
819,819,10/23/2004,Texas-El Paso,44,40,150,30,17,259,0,2,Louisiana Tech,27,40,192,28,9,151,3,1,V,-2.5,17,0,-42,2,8,108,-3,1,2004
820,820,10/23/2004,Toledo,27,32,123,42,29,375,1,0,Central Michigan,22,42,168,42,29,385,0,1,H,21.5,5,-10,-45,0,0,-10,1,-1,2004
821,821,10/23/2004,Troy State,20,40,90,17,7,60,0,0,Louisiana State,24,36,57,38,25,329,3,1,V,-23.5,-4,4,33,-21,-18,-269,-3,-1,2004
822,822,10/23/2004,Tulane,59,26,108,49,36,417,0,0,Alabama-Birmingham,55,39,201,38,23,448,0,1,H,-18,4,-13,-93,11,13,-31,0,-1,2004
823,823,10/23/2004,Tulsa,48,60,312,31,14,197,3,1,Nevada-Reno,54,42,192,33,20,299,0,1,V,-3,-6,18,120,-2,-6,-102,3,0,2004
824,824,10/23/2004,U-C-F,7,34,88,22,8,72,1,1,Miami-Ohio,43,38,206,40,24,288,2,1,V,-22.5,-36,-4,-118,-18,-16,-216,-1,0,2004
825,825,10/23/2004,U.C.L.A.,42,35,210,45,30,325,4,0,Arizona State,48,37,121,51,25,415,3,0,V,-7,-6,-2,89,-6,5,-90,1,0,2004
826,826,10/23/2004,UL-Lafayette,27,47,188,29,17,226,0,0,Arkansas State,24,40,306,38,16,164,1,0,H,3,3,7,-118,-9,1,62,-1,0,2004
827,827,10/23/2004,UL-Monroe,17,31,137,33,24,202,0,1,Florida Atlantic,13,40,151,36,18,260,3,0,V,-12.5,4,-9,-14,-3,6,-58,-3,1,2004
828,828,10/23/2004,Utah,63,46,281,22,12,152,0,1,Nevada-Las Vegas,28,48,311,22,9,111,2,2,H,24,35,-2,-30,0,3,41,-2,-1,2004
829,829,10/23/2004,Vanderbilt,19,38,210,21,15,156,0,0,Eastern Kentucky,7,40,184,32,22,276,0,1,H, ,12,-2,26,-11,-7,-120,0,-1,2004
830,830,10/23/2004,Virginia,37,61,348,20,11,163,0,1,Duke,16,34,95,32,20,242,1,0,V,24,21,27,253,-12,-9,-79,-1,1,2004
831,831,10/23/2004,Wake Forest,17,45,133,29,15,137,1,0,Florida State,20,38,138,39,17,194,2,1,H,-14,-3,7,-5,-10,-2,-57,-1,-1,2004
832,832,10/23/2004,Washington,0,27,50,28,7,63,1,2,Southern Cal,38,42,197,48,28,256,1,1,V,-37.5,-38,-15,-147,-20,-21,-193,0,1,2004
833,833,10/23/2004,Washington State,19,31,119,41,15,201,2,1,Oregon State,38,50,171,40,18,270,1,0,V,-8,-19,-19,-52,1,-3,-69,1,1,2004
834,834,10/23/2004,Western Michigan,38,40,204,45,26,290,2,0,Northern Illinois,59,41,265,25,17,387,0,0,H,-19,-21,-1,-61,20,9,-97,2,0,2004
835,835,10/23/2004,Wisconsin,24,53,208,21,13,178,1,1,Northwestern,12,36,149,37,16,185,1,0,H,11.5,12,17,59,-16,-3,-7,0,1,2004
836,836,10/28/2004,Georgia Tech,20,40,166,29,14,179,2,2,Virginia Tech,34,33,142,31,18,304,1,2,H,-5.5,-14,7,24,-2,-4,-125,1,0,2004
837,837,10/28/2004,Virginia Tech,34,33,142,31,18,304,1,2,Georgia Tech,20,40,166,29,14,179,2,2,V,5.5,14,-7,-24,2,4,125,-1,0,2004
838,838,10/29/2004,Boise State,69,50,425,19,11,164,0,0,Hawaii,3,21,73,55,26,227,5,1,H,23,66,29,352,-36,-15,-63,-5,-1,2004
839,839,10/29/2004,Hawaii,3,21,73,55,26,227,5,1,Boise State,69,50,425,19,11,164,0,0,V,-23,-66,-29,-352,36,15,63,5,1,2004
840,840,10/30/2004,Air Force,26,48,231,21,10,189,1,1,Wyoming,43,59,291,29,20,268,0,0,V,-2,-17,-11,-60,-8,-10,-79,1,1,2004
841,841,10/30/2004,Arizona,14,34,96,38,19,235,2,2,Oregon State,28,37,61,31,17,249,0,1,H,-7,-14,-3,35,7,2,-14,2,1,2004
842,842,10/30/2004,Arizona State,0,25,125,41,25,238,1,4,California,27,43,234,29,15,165,0,0,V,-16.5,-27,-18,-109,12,10,73,1,4,2004
843,843,10/30/2004,Army,28,31,195,30,17,230,2,1,East Carolina,38,47,177,36,26,285,0,0,V,3,-10,-16,18,-6,-9,-55,2,1,2004
844,844,10/30/2004,Auburn,35,39,205,22,11,234,1,1,Mississippi,14,42,147,30,18,286,1,1,V,15.5,21,-3,58,-8,-7,-52,0,0,2004
845,845,10/30/2004,Ball State,31,44,154,48,31,244,0,0,Northern Illinois,38,53,373,18,7,142,0,0,H,-20.5,-7,-9,-219,30,24,102,0,0,2004
846,846,10/30/2004,Baylor,35,24,77,50,32,262,0,1,Texas A+M,34,42,170,32,21,291,1,2,H,-25,1,-18,-93,18,11,-29,-1,-1,2004
847,847,10/30/2004,Bowling Green,41,39,168,44,30,333,0,0,Eastern Michigan,20,27,45,52,25,388,1,2,H,28.5,21,12,123,-8,5,-55,-1,-2,2004
848,848,10/30/2004,California,27,43,234,29,15,165,0,0,Arizona State,0,25,125,41,25,238,1,4,H,16.5,27,18,109,-12,-10,-73,-1,-4,2004
849,849,10/30/2004,Central Michigan,24,40,166,39,21,205,1,0,Western Michigan,21,42,125,31,19,256,1,2,H,8,3,-2,41,8,2,-51,0,-2,2004
850,850,10/30/2004,Cincinnati,21,48,255,26,13,155,0,0,Texas Christian,10,35,146,33,15,221,1,0,H,7,11,13,109,-7,-2,-66,-1,0,2004
851,851,10/30/2004,Clemson,26,34,82,34,15,185,0,1,No Carolina State,20,35,126,45,24,255,5,1,H,-1,6,-1,-44,-11,-9,-70,-5,0,2004
852,852,10/30/2004,Colorado,7,18,3,37,21,218,2,1,Texas,31,66,326,15,8,71,2,0,H,-14,-24,-48,-323,22,13,147,0,1,2004
853,853,10/30/2004,Colorado State,17,34,35,37,20,285,1,2,New Mexico,26,45,181,17,7,110,0,0,H,2,-9,-11,-146,20,13,175,1,2,2004
854,854,10/30/2004,Connecticut,30,35,121,51,39,445,2,3,Syracuse,42,37,281,19,11,125,0,0,V,-3,-12,-2,-160,32,28,320,2,3,2004
855,855,10/30/2004,Duke,22,32,123,45,28,300,0,2,Wake Forest,24,50,272,24,12,128,2,1,V,-16,-2,-18,-149,21,16,172,-2,1,2004
856,856,10/30/2004,East Carolina,38,47,177,36,26,285,0,0,Army,28,31,195,30,17,230,2,1,H,-3,10,16,-18,6,9,55,-2,-1,2004
857,857,10/30/2004,Eastern Michigan,20,27,45,52,25,388,1,2,Bowling Green,41,39,168,44,30,333,0,0,V,-28.5,-21,-12,-123,8,-5,55,1,2,2004
858,858,10/30/2004,Florida,24,35,211,35,22,247,0,0,Georgia,31,38,150,23,15,255,0,1,N,-6.5,-7,-3,61,12,7,-8,0,-1,2004
859,859,10/30/2004,Florida Atlantic,38,42,276,33,15,315,1,0,Florida A+M,8,30,103,46,24,239,2,1,V, ,30,12,173,-13,-9,76,-1,-1,2004
860,860,10/30/2004,Florida State,17,23,50,51,22,304,2,0,Maryland,20,38,54,40,21,333,1,1,V,13,-3,-15,-4,11,1,-29,1,-1,2004
861,861,10/30/2004,Fresno State,42,41,269,23,15,196,0,0,Southern Methodist,0,39,121,29,16,235,2,2,H,27.5,42,2,148,-6,-1,-39,-2,-2,2004
862,862,10/30/2004,Georgia,31,38,150,23,15,255,0,1,Florida,24,35,211,35,22,247,0,0,N,6.5,7,3,-61,-12,-7,8,0,1,2004
863,863,10/30/2004,Houston,24,45,183,24,14,267,1,0,Tulane,3,30,65,37,19,185,2,1,H,10,21,15,118,-13,-5,82,-1,-1,2004
864,864,10/30/2004,Idaho,7,37,81,42,18,261,5,2,Troy State,47,48,280,15,3,48,1,0,V,-26,-40,-11,-199,27,15,213,4,2,2004
865,865,10/30/2004,Illinois,13,25,58,42,22,210,1,1,Iowa,23,36,76,34,24,243,1,0,H,-13,-10,-11,-18,8,-2,-33,0,1,2004
866,866,10/30/2004,Indiana,30,51,238,26,13,161,0,0,Minnesota,21,41,169,30,11,182,1,0,H,-17,9,10,69,-4,2,-21,-1,0,2004
867,867,10/30/2004,Iowa,23,36,76,34,24,243,1,0,Illinois,13,25,58,42,22,210,1,1,V,13,10,11,18,-8,2,33,0,-1,2004
868,868,10/30/2004,Iowa State,13,54,141,19,9,51,1,0,Kansas,7,34,80,31,14,128,3,1,H,-4,6,20,61,-12,-5,-77,-2,-1,2004
869,869,10/30/2004,Kansas,7,34,80,31,14,128,3,1,Iowa State,13,54,141,19,9,51,1,0,V,4,-6,-20,-61,12,5,77,2,1,2004
870,870,10/30/2004,Kansas State,25,34,167,42,26,248,1,0,Texas Tech,35,29,91,39,27,326,0,0,H,2,-10,5,76,3,-1,-78,1,0,2004
871,871,10/30/2004,Kent State,42,43,278,26,18,150,0,0,Ohio,16,39,129,28,15,218,3,0,H,3,26,4,149,-2,3,-68,-3,0,2004
872,872,10/30/2004,Kentucky,7,35,84,33,17,167,1,0,Mississippi State,22,49,340,18,7,79,2,1,V,-3,-15,-14,-256,15,10,88,-1,-1,2004
873,873,10/30/2004,Louisiana State,24,44,273,11,6,102,0,2,Vanderbilt,7,39,103,29,17,186,0,2,H,24,17,5,170,-18,-11,-84,0,0,2004
874,874,10/30/2004,Marshall,20,42,173,35,19,155,1,0,U-C-F,3,35,49,14,7,55,1,1,H,25,17,7,124,21,12,100,0,-1,2004
875,875,10/30/2004,Maryland,20,38,54,40,21,333,1,1,Florida State,17,23,50,51,22,304,2,0,H,-13,3,15,4,-11,-1,29,-1,1,2004
876,876,10/30/2004,Miami-Florida,28,23,77,35,20,338,0,0,North Carolina,31,50,279,29,21,266,1,0,V,21,-3,-27,-202,6,-1,72,-1,0,2004
877,877,10/30/2004,Michigan,45,44,223,35,24,273,0,1,Michigan State,37,57,368,26,18,167,0,0,H,10.5,8,-13,-145,9,6,106,0,1,2004
878,878,10/30/2004,Michigan State,37,57,368,26,18,167,0,0,Michigan,45,44,223,35,24,273,0,1,V,-10.5,-8,13,145,-9,-6,-106,0,-1,2004
879,879,10/30/2004,Mid Tennessee St,21,35,86,32,22,317,0,1,Utah State,0,26,30,27,18,126,0,0,H,9.5,21,9,56,5,4,191,0,1,2004
880,880,10/30/2004,Minnesota,21,41,169,30,11,182,1,0,Indiana,30,51,238,26,13,161,0,0,V,17,-9,-10,-69,4,-2,21,1,0,2004
881,881,10/30/2004,Mississippi,14,42,147,30,18,286,1,1,Auburn,35,39,205,22,11,234,1,1,H,-15.5,-21,3,-58,8,7,52,0,0,2004
882,882,10/30/2004,Mississippi State,22,49,340,18,7,79,2,1,Kentucky,7,35,84,33,17,167,1,0,H,3,15,14,256,-15,-10,-88,1,1,2004
883,883,10/30/2004,Missouri,3,35,51,56,24,277,1,1,Nebraska,24,41,209,18,4,26,0,0,V,3,-21,-6,-158,38,20,251,1,1,2004
884,884,10/30/2004,Navy,34,60,346,11,8,95,0,1,Delaware,20,18,59,50,30,255,0,1,H, ,14,42,287,-39,-22,-160,0,0,2004
885,885,10/30/2004,Nebraska,24,41,209,18,4,26,0,0,Missouri,3,35,51,56,24,277,1,1,H,-3,21,6,158,-38,-20,-251,-1,-1,2004
886,886,10/30/2004,New Mexico,26,45,181,17,7,110,0,0,Colorado State,17,34,35,37,20,285,1,2,V,-2,9,11,146,-20,-13,-175,-1,-2,2004
887,887,10/30/2004,New Mexico State,56,39,217,37,29,429,1,0,Florida Intl,31,33,318,27,15,180,4,0,H,10,25,6,-101,10,14,249,-3,0,2004
888,888,10/30/2004,No Carolina State,20,35,126,45,24,255,5,1,Clemson,26,34,82,34,15,185,0,1,V,1,-6,1,44,11,9,70,5,0,2004
889,889,10/30/2004,North Carolina,31,50,279,29,21,266,1,0,Miami-Florida,28,23,77,35,20,338,0,0,H,-21,3,27,202,-6,1,-72,1,0,2004
890,890,10/30/2004,North Texas,45,49,206,13,8,145,0,2,UL-Monroe,30,46,224,45,23,233,2,1,H,8,15,3,-18,-32,-15,-88,-2,1,2004
891,891,10/30/2004,Northern Illinois,38,53,373,18,7,142,0,0,Ball State,31,44,154,48,31,244,0,0,V,20.5,7,9,219,-30,-24,-102,0,0,2004
892,892,10/30/2004,Northwestern,13,33,130,30,11,148,0,0,Purdue,10,41,122,42,20,210,1,1,H,-10,3,-8,8,-12,-9,-62,-1,-1,2004
893,893,10/30/2004,Ohio,16,39,129,28,15,218,3,0,Kent State,42,43,278,26,18,150,0,0,V,-3,-26,-4,-149,2,-3,68,3,0,2004
894,894,10/30/2004,Ohio State,21,44,143,8,6,59,0,2,Penn State,10,50,177,22,7,69,2,0,H,7,11,-6,-34,-14,-1,-10,-2,2,2004
895,895,10/30/2004,Oklahoma,38,45,267,26,14,221,0,2,Oklahoma State,35,41,150,20,8,207,0,0,V,14,3,4,117,6,6,14,0,2,2004
896,896,10/30/2004,Oklahoma State,35,41,150,20,8,207,0,0,Oklahoma,38,45,267,26,14,221,0,2,H,-14,-3,-4,-117,-6,-6,-14,0,-2,2004
897,897,10/30/2004,Oregon,31,41,158,35,21,134,1,1,Washington,6,30,45,36,14,211,4,3,H,20,25,11,113,-1,7,-77,-3,-2,2004
898,898,10/30/2004,Oregon State,28,37,61,31,17,249,0,1,Arizona,14,34,96,38,19,235,2,2,V,7,14,3,-35,-7,-2,14,-2,-1,2004
899,899,10/30/2004,Penn State,10,50,177,22,7,69,2,0,Ohio State,21,44,143,8,6,59,0,2,V,-7,-11,6,34,14,1,10,2,-2,2004
900,900,10/30/2004,Purdue,10,41,122,42,20,210,1,1,Northwestern,13,33,130,30,11,148,0,0,V,10,-3,8,-8,12,9,62,1,1,2004
901,901,10/30/2004,Rice,22,49,220,19,9,139,1,0,Tulsa,39,47,210,17,12,211,1,1,V,1,-17,2,10,2,-3,-72,0,-1,2004
902,902,10/30/2004,Rutgers,30,39,87,46,35,324,2,2,West Virginia,35,54,267,14,9,165,0,0,H,-15,-5,-15,-180,32,26,159,2,2,2004
903,903,10/30/2004,San Diego State,28,33,162,43,21,252,2,0,Utah,51,44,173,36,25,375,0,1,H,-20,-23,-11,-11,7,-4,-123,2,-1,2004
904,904,10/30/2004,San Jose State,20,49,132,29,15,173,2,3,Texas-El Paso,38,31,144,23,17,228,1,0,H,-14,-18,18,-12,6,-2,-55,1,3,2004
905,905,10/30/2004,South Carolina,29,37,226,49,34,341,3,0,Tennessee,43,36,246,20,11,166,1,0,H,1.5,-14,1,-20,29,23,175,2,0,2004
906,906,10/30/2004,Southern Cal,42,54,186,30,23,235,1,2,Washington State,12,25,-9,40,17,165,1,3,V,25,30,29,195,-10,6,70,0,-1,2004
907,907,10/30/2004,Southern Methodist,0,39,121,29,16,235,2,2,Fresno State,42,41,269,23,15,196,0,0,V,-27.5,-42,-2,-148,6,1,39,2,2,2004
908,908,10/30/2004,Stanford,0,33,83,46,24,224,3,0,U.C.L.A.,21,36,246,28,17,177,1,1,V,-4,-21,-3,-163,18,7,47,2,-1,2004
909,909,10/30/2004,Syracuse,42,37,281,19,11,125,0,0,Connecticut,30,35,121,51,39,445,2,3,H,3,12,2,160,-32,-28,-320,-2,-3,2004
910,910,10/30/2004,Tennessee,43,36,246,20,11,166,1,0,South Carolina,29,37,226,49,34,341,3,0,V,-1.5,14,-1,20,-29,-23,-175,-2,0,2004
911,911,10/30/2004,Texas,31,66,326,15,8,71,2,0,Colorado,7,18,3,37,21,218,2,1,V,14,24,48,323,-22,-13,-147,0,-1,2004
912,912,10/30/2004,Texas A+M,34,42,170,32,21,291,1,2,Baylor,35,24,77,50,32,262,0,1,V,25,-1,18,93,-18,-11,29,1,1,2004
913,913,10/30/2004,Texas Christian,10,35,146,33,15,221,1,0,Cincinnati,21,48,255,26,13,155,0,0,V,-7,-11,-13,-109,7,2,66,1,0,2004
914,914,10/30/2004,Texas Tech,35,29,91,39,27,326,0,0,Kansas State,25,34,167,42,26,248,1,0,V,-2,10,-5,-76,-3,1,78,-1,0,2004
915,915,10/30/2004,Texas-El Paso,38,31,144,23,17,228,1,0,San Jose State,20,49,132,29,15,173,2,3,V,14,18,-18,12,-6,2,55,-1,-3,2004
916,916,10/30/2004,Troy State,47,48,280,15,3,48,1,0,Idaho,7,37,81,42,18,261,5,2,H,26,40,11,199,-27,-15,-213,-4,-2,2004
917,917,10/30/2004,Tulane,3,30,65,37,19,185,2,1,Houston,24,45,183,24,14,267,1,0,V,-10,-21,-15,-118,13,5,-82,1,1,2004
918,918,10/30/2004,Tulsa,39,47,210,17,12,211,1,1,Rice,22,49,220,19,9,139,1,0,H,-1,17,-2,-10,-2,3,72,0,1,2004
919,919,10/30/2004,U-C-F,3,35,49,14,7,55,1,1,Marshall,20,42,173,35,19,155,1,0,V,-25,-17,-7,-124,-21,-12,-100,0,1,2004
920,920,10/30/2004,U.C.L.A.,21,36,246,28,17,177,1,1,Stanford,0,33,83,46,24,224,3,0,H,4,21,3,163,-18,-7,-47,-2,1,2004
921,921,10/30/2004,UL-Monroe,30,46,224,45,23,233,2,1,North Texas,45,49,206,13,8,145,0,2,V,-8,-15,-3,18,32,15,88,2,-1,2004
922,922,10/30/2004,Utah,51,44,173,36,25,375,0,1,San Diego State,28,33,162,43,21,252,2,0,V,20,23,11,11,-7,4,123,-2,1,2004
923,923,10/30/2004,Utah State,0,26,30,27,18,126,0,0,Mid Tennessee St,21,35,86,32,22,317,0,1,V,-9.5,-21,-9,-56,-5,-4,-191,0,-1,2004
924,924,10/30/2004,Vanderbilt,7,39,103,29,17,186,0,2,Louisiana State,24,44,273,11,6,102,0,2,V,-24,-17,-5,-170,18,11,84,0,0,2004
925,925,10/30/2004,Wake Forest,24,50,272,24,12,128,2,1,Duke,22,32,123,45,28,300,0,2,H,16,2,18,149,-21,-16,-172,2,-1,2004
926,926,10/30/2004,Washington,6,30,45,36,14,211,4,3,Oregon,31,41,158,35,21,134,1,1,V,-20,-25,-11,-113,1,-7,77,3,2,2004
927,927,10/30/2004,Washington State,12,25,-9,40,17,165,1,3,Southern Cal,42,54,186,30,23,235,1,2,H,-25,-30,-29,-195,10,-6,-70,0,1,2004
928,928,10/30/2004,West Virginia,35,54,267,14,9,165,0,0,Rutgers,30,39,87,46,35,324,2,2,V,15,5,15,180,-32,-26,-159,-2,-2,2004
929,929,10/30/2004,Western Michigan,21,42,125,31,19,256,1,2,Central Michigan,24,40,166,39,21,205,1,0,V,-8,-3,2,-41,-8,-2,51,0,2,2004
930,930,10/30/2004,Wyoming,43,59,291,29,20,268,0,0,Air Force,26,48,231,21,10,189,1,1,H,2,17,11,60,8,10,79,-1,-1,2004
931,931,11/02/2004,Miami-Ohio,23,40,76,41,24,295,0,1,Toledo,16,36,177,36,23,203,1,3,H,6,7,4,-101,5,1,92,-1,-2,2004
932,932,11/02/2004,Toledo,16,36,177,36,23,203,1,3,Miami-Ohio,23,40,76,41,24,295,0,1,V,-6,-7,-4,101,-5,-1,-92,1,2,2004
933,933,11/03/2004,Alabama-Birmingham,20,38,110,39,20,232,1,1,South Florida,45,48,318,15,7,186,0,0,H,17,-25,-10,-208,24,13,46,1,1,2004
934,934,11/03/2004,South Florida,45,48,318,15,7,186,0,0,Alabama-Birmingham,20,38,110,39,20,232,1,1,V,-17,25,10,208,-24,-13,-46,-1,-1,2004
935,935,11/04/2004,Louisville,56,48,278,34,24,321,0,2,Memphis,49,39,242,46,24,361,1,1,V,13.5,7,9,36,-12,0,-40,-1,1,2004
936,936,11/04/2004,Memphis,49,39,242,46,24,361,1,1,Louisville,56,48,278,34,24,321,0,2,H,-13.5,-7,-9,-36,12,0,40,1,-1,2004
937,937,11/05/2004,Akron,31,33,82,45,28,322,2,0,Marshall,28,27,115,53,37,439,1,2,H,-9.5,3,6,-33,-8,-9,-117,1,-2,2004
938,938,11/05/2004,Marshall,28,27,115,53,37,439,1,2,Akron,31,33,82,45,28,322,2,0,V,9.5,-3,-6,33,8,9,117,-1,2,2004
939,939,11/05/2004,North Texas,27,47,210,15,9,104,1,0,UL-Lafayette,17,28,78,36,24,169,1,2,V,2,10,19,132,-21,-15,-65,0,-2,2004
940,940,11/05/2004,UL-Lafayette,17,28,78,36,24,169,1,2,North Texas,27,47,210,15,9,104,1,0,H,-2,-10,-19,-132,21,15,65,0,2,2004
941,941,11/06/2004,Air Force,31,66,345,8,7,84,0,0,Army,22,36,243,38,20,192,1,1,V,3,9,30,102,-30,-13,-108,-1,-1,2004
942,942,11/06/2004,Alabama,30,47,260,15,9,119,2,1,Mississippi State,14,41,126,20,7,114,0,1,H,17.5,16,6,134,-5,2,5,2,0,2004
943,943,11/06/2004,Arizona,23,38,87,25,11,164,0,3,Washington,13,39,100,47,16,197,2,2,V,-1,10,-1,-13,-22,-5,-33,-2,1,2004
944,944,11/06/2004,Arizona State,34,46,168,43,28,415,1,3,Stanford,31,36,37,35,16,246,4,1,H,12,3,10,131,8,12,169,-3,2,2004
945,945,11/06/2004,Arkansas,32,45,247,24,12,138,2,1,South Carolina,35,41,211,24,16,159,1,0,V,-4,-3,4,36,0,-4,-21,1,1,2004
946,946,11/06/2004,Arkansas State,31,36,152,43,19,264,4,1,Idaho,45,58,297,21,16,160,0,3,V,3.5,-14,-22,-145,22,3,104,4,-2,2004
947,947,11/06/2004,Army,22,36,243,38,20,192,1,1,Air Force,31,66,345,8,7,84,0,0,H,-3,-9,-30,-102,30,13,108,1,1,2004
948,948,11/06/2004,Baylor,17,34,158,26,13,120,0,0,Texas Tech,42,35,158,50,38,406,1,0,V,-29,-25,-1,0,-24,-25,-286,-1,0,2004
949,949,11/06/2004,Boston College,21,37,82,38,22,296,2,2,Rutgers,10,32,73,43,29,302,3,0,H,15,11,5,9,-5,-7,-6,-1,2,2004
950,950,11/06/2004,Bowling Green,52,43,350,22,18,316,0,1,Western Michigan,0,32,82,48,20,213,3,1,H,30,52,11,268,-26,-2,103,-3,0,2004
951,951,11/06/2004,Brigham Young,49,43,187,27,16,339,0,1,San Diego State,16,35,163,47,21,229,2,1,H,11.5,33,8,24,-20,-5,110,-2,0,2004
952,952,11/06/2004,Buffalo,7,31,4,20,10,112,1,1,Kent State,33,48,322,25,17,167,0,1,H,-7.5,-26,-17,-318,-5,-7,-55,1,0,2004
953,953,11/06/2004,California,28,36,219,32,21,275,0,2,Oregon,27,34,141,33,19,218,0,0,H,18,1,2,78,-1,2,57,0,2,2004
954,954,11/06/2004,Central Michigan,58,47,138,35,24,319,2,2,Eastern Michigan,61,46,184,54,31,367,1,0,V,2.5,-3,1,-46,-19,-7,-48,1,2,2004
955,955,11/06/2004,Cincinnati,52,45,122,27,19,308,0,0,Southern Miss,24,36,137,29,13,194,2,2,V,-6,28,9,-15,-2,6,114,-2,-2,2004
956,956,11/06/2004,Clemson,24,36,113,37,21,258,1,0,Miami-Florida,17,38,101,46,22,245,0,1,V,-17,7,-2,12,-9,-1,13,1,-1,2004
957,957,11/06/2004,Colorado,30,37,112,31,18,153,3,1,Kansas,21,38,92,36,24,250,1,1,V,-2,9,-1,20,-5,-6,-97,2,0,2004
958,958,11/06/2004,Colorado State,31,39,226,26,12,194,3,2,Utah,63,45,242,29,23,292,0,0,V,-25,-32,-6,-16,-3,-11,-98,3,2,2004
959,959,11/06/2004,Duke,7,33,61,33,21,169,3,2,Florida State,29,31,180,30,20,314,1,0,V,-30,-22,2,-119,3,1,-145,2,2,2004
960,960,11/06/2004,East Carolina,24,32,117,34,21,267,4,0,Houston,34,53,236,23,13,251,2,1,V,-16,-10,-21,-119,11,8,16,2,-1,2004
961,961,11/06/2004,Eastern Michigan,61,46,184,54,31,367,1,0,Central Michigan,58,47,138,35,24,319,2,2,H,-2.5,3,-1,46,19,7,48,-1,-2,2004
962,962,11/06/2004,Florida,34,38,193,29,22,307,1,3,Vanderbilt,17,52,254,26,12,118,0,0,V,11.5,17,-14,-61,3,10,189,1,3,2004
963,963,11/06/2004,Florida Atlantic,6,33,-12,28,15,260,2,0,Troy State,24,45,135,18,8,128,0,1,V,-12,-18,-12,-147,10,7,132,2,-1,2004
964,964,11/06/2004,Florida State,29,31,180,30,20,314,1,0,Duke,7,33,61,33,21,169,3,2,H,30,22,-2,119,-3,-1,145,-2,-2,2004
965,965,11/06/2004,Fresno State,52,32,107,19,13,203,0,0,Rice,21,63,286,19,9,157,3,1,V,7,31,-31,-179,0,4,46,-3,-1,2004
966,966,11/06/2004,Georgia,62,45,245,30,19,344,0,3,Kentucky,17,23,54,44,25,290,2,1,V,24,45,22,191,-14,-6,54,-2,2,2004
967,967,11/06/2004,Georgia Tech,24,33,178,28,9,91,3,0,No Carolina State,14,33,57,38,22,234,3,0,V,-7.5,10,0,121,-10,-13,-143,0,0,2004
968,968,11/06/2004,Hawaii,34,20,86,42,26,285,1,1,Louisiana Tech,23,48,275,26,12,147,0,1,H,4,11,-28,-189,16,14,138,1,0,2004
969,969,11/06/2004,Houston,34,53,236,23,13,251,2,1,East Carolina,24,32,117,34,21,267,4,0,H,16,10,21,119,-11,-8,-16,-2,1,2004
970,970,11/06/2004,Idaho,45,58,297,21,16,160,0,3,Arkansas State,31,36,152,43,19,264,4,1,H,-3.5,14,22,145,-22,-3,-104,-4,2,2004
971,971,11/06/2004,Illinois,26,34,199,27,12,152,0,0,Indiana,22,41,156,28,18,250,2,0,H,2,4,-7,43,-1,-6,-98,-2,0,2004
972,972,11/06/2004,Indiana,22,41,156,28,18,250,2,0,Illinois,26,34,199,27,12,152,0,0,V,-2,-4,7,-43,1,6,98,2,0,2004
973,973,11/06/2004,Iowa,23,34,43,46,25,278,1,0,Purdue,21,27,52,45,27,305,2,3,H,2,2,7,-9,1,-2,-27,-1,-3,2004
974,974,11/06/2004,Iowa State,34,36,102,39,18,364,1,0,Nebraska,27,35,195,43,19,249,1,0,H,-4.5,7,1,-93,-4,-1,115,0,0,2004
975,975,11/06/2004,Kansas,21,38,92,36,24,250,1,1,Colorado,30,37,110,31,18,153,3,1,H,2,-9,1,-18,5,6,97,-2,0,2004
976,976,11/06/2004,Kansas State,35,40,225,24,10,148,0,1,Missouri,24,38,239,35,16,238,2,2,V,-2.5,11,2,-14,-11,-6,-90,-2,-1,2004
977,977,11/06/2004,Kent State,33,48,322,25,17,167,0,1,Buffalo,7,31,4,20,10,112,1,1,V,7.5,26,17,318,5,7,55,-1,0,2004
978,978,11/06/2004,Kentucky,17,23,54,44,25,290,2,1,Georgia,62,45,245,30,19,344,0,3,H,-24,-45,-22,-191,14,6,-54,2,-2,2004
979,979,11/06/2004,Louisiana Tech,23,48,275,26,12,147,0,1,Hawaii,34,20,86,42,26,285,1,1,V,-4,-11,28,189,-16,-14,-138,-1,0,2004
980,980,11/06/2004,Maryland,0,27,51,23,12,163,2,1,Virginia,16,61,295,17,10,114,1,1,V,-13,-16,-34,-244,6,2,49,1,0,2004
981,981,11/06/2004,Miami-Florida,17,38,101,46,22,245,0,1,Clemson,24,36,113,37,21,258,1,0,H,17,-7,2,-12,9,1,-13,-1,1,2004
982,982,11/06/2004,Michigan State,19,34,145,46,29,262,3,0,Ohio State,32,35,169,21,13,138,0,1,H,-2,-13,-1,-24,25,16,124,3,-1,2004
983,983,11/06/2004,Mid Tennessee St,10,24,18,33,15,133,3,1,New Mexico State,44,53,208,37,26,398,0,2,V,2,-34,-29,-190,-4,-11,-265,3,-1,2004
984,984,11/06/2004,Minnesota,14,18,73,34,17,258,0,1,Wisconsin,38,60,228,26,19,297,0,0,V,-7,-24,-42,-155,8,-2,-39,0,1,2004
985,985,11/06/2004,Mississippi State,14,41,126,20,7,114,0,1,Alabama,30,47,260,15,9,119,2,1,V,-17.5,-16,-6,-134,5,-2,-5,-2,0,2004
986,986,11/06/2004,Missouri,24,38,239,35,16,238,2,2,Kansas State,35,40,225,23,10,148,0,1,H,2.5,-11,-2,14,12,6,90,2,1,2004
987,987,11/06/2004,Navy,10,56,262,17,4,50,1,1,Tulane,42,43,215,19,18,323,0,0,V,9.5,-32,13,47,-2,-14,-273,1,1,2004
988,988,11/06/2004,Nebraska,27,35,195,42,19,249,1,0,Iowa State,34,36,102,39,18,364,1,0,V,4.5,-7,-1,93,3,1,-115,0,0,2004
989,989,11/06/2004,Nevada-Las Vegas,45,50,209,34,20,223,2,1,Wyoming,53,42,83,37,23,240,1,1,H,5,-8,8,126,-3,-3,-17,1,0,2004
990,990,11/06/2004,Nevada-Reno,42,42,202,35,25,252,0,1,San Jose State,24,28,32,27,16,273,0,2,H,14,18,14,170,8,9,-21,0,-1,2004
991,991,11/06/2004,New Mexico State,44,53,208,37,26,398,0,2,Mid Tennessee St,10,24,18,33,15,133,3,1,H,-2,34,29,190,4,11,265,-3,1,2004
992,992,11/06/2004,No Carolina State,14,33,57,38,22,234,3,0,Georgia Tech,24,33,178,28,9,91,3,0,H,7.5,-10,0,-121,10,13,143,0,0,2004
993,993,11/06/2004,North Carolina,24,26,131,21,14,165,1,0,Virginia Tech,27,51,270,18,7,100,0,0,H,-10,-3,-25,-139,3,7,65,1,0,2004
994,994,11/06/2004,Northwestern,14,44,186,27,15,205,1,1,Penn State,7,30,97,35,21,183,1,0,V,-5.5,7,14,89,-8,-6,22,0,1,2004
995,995,11/06/2004,Notre Dame,17,36,98,23,12,118,0,0,Tennessee,13,39,58,36,21,269,1,0,V,-7,4,-3,40,-13,-9,-151,-1,0,2004
996,996,11/06/2004,Ohio,17,39,94,32,16,165,2,0,U-C-F,16,41,78,20,8,126,1,1,V,1,1,-2,16,12,8,39,1,-1,2004
997,997,11/06/2004,Ohio State,32,35,169,21,13,138,0,1,Michigan State,19,34,145,46,29,262,3,0,V,2,13,1,24,-25,-16,-124,-3,1,2004
998,998,11/06/2004,Oklahoma,42,42,141,35,19,292,0,0,Texas A+M,35,33,129,38,20,360,1,2,V,12.5,7,9,12,-3,-1,-68,-1,-2,2004
999,999,11/06/2004,Oklahoma State,35,47,178,18,12,224,1,0,Texas,56,42,324,22,18,278,2,0,V,-13.5,-21,5,-146,-4,-6,-54,-1,0,2004
1000,1000,11/06/2004,Oregon,27,34,141,33,19,218,0,0,California,28,36,219,32,21,275,0,2,V,-18,-1,-2,-78,1,-2,-57,0,-2,2004
1001,1001,11/06/2004,Oregon State,20,25,34,51,22,330,2,1,Southern Cal,28,44,210,31,17,205,1,2,H,-17,-8,-19,-176,20,5,125,1,-1,2004
1002,1002,11/06/2004,Penn State,7,30,97,35,21,183,1,0,Northwestern,14,44,186,27,15,205,1,1,H,5.5,-7,-14,-89,8,6,-22,0,-1,2004
1003,1003,11/06/2004,Pittsburgh,31,39,101,42,28,342,0,0,Syracuse,38,52,239,29,16,230,1,1,V,-4,-7,-13,-138,13,12,112,-1,-1,2004
1004,1004,11/06/2004,Purdue,21,27,52,45,27,305,2,3,Iowa,23,34,43,46,25,278,1,0,V,-2,-2,-7,9,-1,2,27,1,3,2004
1005,1005,11/06/2004,Rice,21,63,286,19,9,157,3,1,Fresno State,52,32,107,19,13,203,0,0,H,-7,-31,31,179,0,-4,-46,3,1,2004
1006,1006,11/06/2004,Rutgers,10,32,73,43,29,302,3,0,Boston College,21,37,82,38,22,296,2,2,V,-15,-11,-5,-9,5,7,6,1,-2,2004
1007,1007,11/06/2004,San Diego State,16,35,163,47,21,229,2,1,Brigham Young,49,43,187,27,16,339,0,1,V,-11.5,-33,-8,-24,20,5,-110,2,0,2004
1008,1008,11/06/2004,San Jose State,24,28,32,27,16,273,0,2,Nevada-Reno,42,42,202,35,25,252,0,1,V,-14,-18,-14,-170,-8,-9,21,0,1,2004
1009,1009,11/06/2004,South Carolina,35,41,211,24,16,159,1,0,Arkansas,32,45,247,24,12,138,2,1,H,4,3,-4,-36,0,4,21,-1,-1,2004
1010,1010,11/06/2004,Southern Cal,28,44,210,31,17,205,1,2,Oregon State,20,25,34,51,22,330,2,1,V,17,8,19,176,-20,-5,-125,-1,1,2004
1011,1011,11/06/2004,Southern Methodist,41,45,189,26,15,201,0,1,Tulsa,35,42,103,31,14,250,2,0,H,-12,6,3,86,-5,1,-49,-2,1,2004
1012,1012,11/06/2004,Southern Miss,24,36,137,29,13,194,2,2,Cincinnati,52,45,122,27,19,308,0,0,H,6,-28,-9,15,2,-6,-114,2,2,2004
1013,1013,11/06/2004,Stanford,31,36,37,35,16,246,4,1,Arizona State,34,46,168,43,28,415,1,3,V,-12,-3,-10,-131,-8,-12,-169,3,-2,2004
1014,1014,11/06/2004,Syracuse,38,52,239,29,16,230,1,1,Pittsburgh,31,39,101,42,28,342,0,0,H,4,7,13,138,-13,-12,-112,1,1,2004
1015,1015,11/06/2004,Temple,21,43,237,24,16,206,1,0,West Virginia,42,47,237,19,14,174,1,1,V,-27,-21,-4,0,5,2,32,0,-1,2004
1016,1016,11/06/2004,Tennessee,13,39,58,36,21,269,1,0,Notre Dame,17,36,98,23,12,118,0,0,H,7,-4,3,-40,13,9,151,1,0,2004
1017,1017,11/06/2004,Texas,56,42,322,22,18,278,2,0,Oklahoma State,35,47,178,18,12,224,1,0,H,13.5,21,-5,144,4,6,54,1,0,2004
1018,1018,11/06/2004,Texas A+M,35,33,129,38,20,360,1,2,Oklahoma,42,42,141,35,19,292,0,0,H,-12.5,-7,-9,-12,3,1,68,1,2,2004
1019,1019,11/06/2004,Texas Tech,42,35,158,50,38,406,1,0,Baylor,17,34,158,26,13,120,0,0,H,29,25,1,0,24,25,286,1,0,2004
1020,1020,11/06/2004,Troy State,24,45,135,18,8,128,0,1,Florida Atlantic,6,33,-12,28,15,260,2,0,H,12,18,12,147,-10,-7,-132,-2,1,2004
1021,1021,11/06/2004,Tulane,42,43,215,19,18,323,0,0,Navy,10,56,262,17,4,50,1,1,H,-9.5,32,-13,-47,2,14,273,-1,-1,2004
1022,1022,11/06/2004,Tulsa,35,42,103,31,14,250,2,0,Southern Methodist,41,45,189,26,15,201,0,1,V,12,-6,-3,-86,5,-1,49,2,-1,2004
1023,1023,11/06/2004,U-C-F,16,41,78,20,8,126,1,1,Ohio,17,39,94,32,16,165,2,0,H,-1,-1,2,-16,-12,-8,-39,-1,1,2004
1024,1024,11/06/2004,U.C.L.A.,29,27,107,39,18,201,1,2,Washington State,31,61,321,27,17,185,0,1,H,14,-2,-34,-214,12,1,16,1,1,2004
1025,1025,11/06/2004,UL-Monroe,32,36,128,32,22,284,2,0,Utah State,25,35,115,36,22,278,1,0,H,5.5,7,1,13,-4,0,6,1,0,2004
1026,1026,11/06/2004,Utah,63,45,242,29,23,292,0,0,Colorado State,31,39,226,26,12,194,3,2,H,25,32,6,16,3,11,98,-3,-2,2004
1027,1027,11/06/2004,Utah State,25,35,115,36,22,278,1,0,UL-Monroe,32,36,128,32,22,284,2,0,V,-5.5,-7,-1,-13,4,0,-6,-1,0,2004
1028,1028,11/06/2004,Vanderbilt,17,52,254,26,12,118,0,0,Florida,34,38,193,29,22,307,1,3,H,-11.5,-17,14,61,-3,-10,-189,-1,-3,2004
1029,1029,11/06/2004,Virginia,16,61,295,17,10,114,1,1,Maryland,0,27,51,23,12,163,2,1,H,13,16,34,244,-6,-2,-49,-1,0,2004
1030,1030,11/06/2004,Virginia Tech,27,51,270,18,7,100,0,0,North Carolina,24,26,131,21,14,165,1,0,V,10,3,25,139,-3,-7,-65,-1,0,2004
1031,1031,11/06/2004,Washington,13,39,100,47,16,197,2,2,Arizona,23,38,87,25,11,164,0,3,H,1,-10,1,13,22,5,33,2,-1,2004
1032,1032,11/06/2004,Washington State,31,61,321,27,17,185,0,1,U.C.L.A.,29,27,107,39,18,201,1,2,V,-14,2,34,214,-12,-1,-16,-1,-1,2004
1033,1033,11/06/2004,West Virginia,42,47,237,19,14,174,1,1,Temple,21,43,237,24,16,206,1,0,H,27,21,4,0,-5,-2,-32,0,1,2004
1034,1034,11/06/2004,Western Michigan,0,32,82,48,20,213,3,1,Bowling Green,52,43,350,22,18,316,0,1,V,-30,-52,-11,-268,26,2,-103,3,0,2004
1035,1035,11/06/2004,Wisconsin,38,60,228,26,19,297,0,0,Minnesota,14,18,73,34,17,258,0,1,H,7,24,42,155,-8,2,39,0,-1,2004
1036,1036,11/06/2004,Wyoming,53,42,83,37,23,240,1,1,Nevada-Las Vegas,45,50,209,34,20,223,2,1,V,-5,8,-8,-126,3,3,17,-1,0,2004
1037,1037,11/09/2004,Northern Illinois,17,23,85,22,10,95,1,0,Toledo,31,54,215,37,28,297,1,0,H,6.5,-14,-31,-130,-15,-18,-202,0,0,2004
1038,1038,11/09/2004,Toledo,31,54,215,37,28,297,1,0,Northern Illinois,17,23,85,22,10,95,1,0,V,-6.5,14,31,130,15,18,202,0,0,2004
1039,1039,11/10/2004,Louisville,55,43,213,32,18,374,0,2,Texas Christian,28,41,113,26,13,195,1,1,H,23.5,27,2,100,6,5,179,-1,1,2004
1040,1040,11/10/2004,Texas Christian,28,41,113,26,13,195,1,1,Louisville,55,43,213,32,18,374,0,2,V,-23.5,-27,-2,-100,-6,-5,-179,1,-1,2004
1041,1041,11/11/2004,Arkansas State,16,49,210,23,11,103,1,1,Utah State,7,23,51,40,17,215,3,1,H,6,9,26,159,-17,-6,-112,-2,0,2004
1042,1042,11/11/2004,Florida State,17,50,48,18,5,73,1,1,No Carolina State,10,34,23,25,9,100,0,2,V,7,7,16,25,-7,-4,-27,1,-1,2004
1043,1043,11/11/2004,No Carolina State,10,34,23,25,9,100,0,2,Florida State,17,50,48,18,5,73,1,1,H,-7,-7,-16,-25,7,4,27,-1,1,2004
1044,1044,11/11/2004,Utah State,7,23,51,40,17,215,3,1,Arkansas State,16,49,210,23,11,103,1,1,V,-6,-9,-26,-159,17,6,112,2,0,2004
1045,1045,11/12/2004,Fresno State,70,64,503,11,8,176,1,2,Hawaii,14,22,106,45,26,167,2,2,H,21.5,56,42,397,-34,-18,9,-1,0,2004
1046,1046,11/12/2004,Hawaii,14,22,106,45,26,167,2,2,Fresno State,70,64,503,11,8,176,1,2,V,-21.5,-56,-42,-397,34,18,-9,1,0,2004
1047,1047,11/12/2004,Memphis,30,42,280,37,21,247,1,1,Southern Miss,26,35,141,38,17,202,1,0,H,6.5,4,7,139,-1,4,45,0,1,2004
1048,1048,11/12/2004,Southern Miss,26,35,141,38,17,202,1,0,Memphis,30,42,280,37,21,247,1,1,V,-6.5,-4,-7,-139,1,-4,-45,0,-1,2004
1049,1049,11/13/2004,Air Force,31,65,353,20,10,133,2,4,San Diego State,37,43,224,33,17,232,1,1,H,5,-6,22,129,-13,-7,-99,1,3,2004
1050,1050,11/13/2004,Akron,31,44,102,22,15,190,0,0,Ohio,19,38,138,27,14,157,2,3,V,0,12,6,-36,-5,1,33,-2,-3,2004
1051,1051,11/13/2004,Alabama,10,43,82,15,7,114,1,1,Louisiana State,26,44,192,14,6,91,0,1,V,-9,-16,-1,-110,1,1,23,1,0,2004
1052,1052,11/13/2004,Alabama-Birmingham,20,31,120,25,14,238,1,1,Houston,7,48,102,39,19,196,0,0,H,9.5,13,-17,18,-14,-5,42,1,1,2004
1053,1053,11/13/2004,Arizona,9,25,90,32,15,165,2,0,Southern Cal,49,38,216,40,31,369,0,3,V,-36.5,-40,-13,-126,-8,-16,-204,2,-3,2004
1054,1054,11/13/2004,Arizona State,45,43,141,43,27,366,0,1,Washington State,28,35,141,37,20,236,1,1,H,14.5,17,8,0,6,7,130,-1,0,2004
1055,1055,11/13/2004,Arkansas,35,51,297,20,13,155,0,0,Mississippi,3,28,175,34,15,168,0,1,H,9.5,32,23,122,-14,-2,-13,0,-1,2004
1056,1056,11/13/2004,Army,31,27,88,41,22,232,2,0,Tulane,45,48,243,32,23,350,1,1,V,-7,-14,-21,-155,9,-1,-118,1,-1,2004
1057,1057,11/13/2004,Auburn,24,37,186,23,19,218,1,0,Georgia,6,29,85,27,17,194,1,1,H,3.5,18,8,101,-4,2,24,0,-1,2004
1058,1058,11/13/2004,Ball State,21,31,137,20,12,117,1,0,U-C-F,17,53,196,21,13,131,0,1,H,3.5,4,-22,-59,-1,-1,-14,1,-1,2004
1059,1059,11/13/2004,Baylor,21,33,127,39,19,271,1,0,Oklahoma State,49,54,305,15,8,164,0,0,V,-26,-28,-21,-178,24,11,107,1,0,2004
1060,1060,11/13/2004,Boise State,56,56,280,24,15,200,1,1,San Jose State,49,58,179,33,16,288,1,1,V,32.5,7,-2,101,-9,-1,-88,0,0,2004
1061,1061,11/13/2004,Boston College,36,36,81,30,18,162,0,0,West Virginia,17,50,238,37,21,224,2,1,V,-7,19,-14,-157,-7,-3,-62,-2,-1,2004
1062,1062,11/13/2004,Bowling Green,56,35,154,37,24,389,1,1,Marshall,35,30,98,56,35,363,3,1,H,9,21,5,56,-19,-11,26,-2,0,2004
1063,1063,11/13/2004,Brigham Young,14,34,58,38,23,259,1,2,New Mexico,21,46,114,12,7,143,1,0,H,6.5,-7,-12,-56,26,16,116,0,2,2004
1064,1064,11/13/2004,Buffalo,36,48,223,22,7,164,1,1,Central Michigan,6,39,56,45,24,245,1,1,H,-5,30,9,167,-23,-17,-81,0,0,2004
1065,1065,11/13/2004,California,42,44,304,24,13,175,2,0,Washington,12,33,84,44,20,328,3,1,V,30.5,30,11,220,-20,-7,-153,-1,-1,2004
1066,1066,11/13/2004,Central Michigan,6,39,56,45,24,245,1,1,Buffalo,36,48,223,22,7,164,1,1,V,5,-30,-9,-167,23,17,81,0,0,2004
1067,1067,11/13/2004,Clemson,13,35,133,27,12,117,2,2,Duke,16,38,21,32,20,213,1,0,V,12,-3,-3,112,-5,-8,-96,1,2,2004
1068,1068,11/13/2004,Colorado,38,36,157,27,15,225,1,0,Kansas State,31,41,160,34,22,212,1,1,H,-1.5,7,-5,-3,-7,-7,13,0,-1,2004
1069,1069,11/13/2004,Colorado State,45,40,129,19,14,255,0,0,Nevada-Las Vegas,10,41,179,28,11,108,1,2,H,6.5,35,-1,-50,-9,3,147,-1,-2,2004
1070,1070,11/13/2004,Connecticut,10,24,20,49,28,205,0,0,Georgia Tech,30,37,122,38,22,288,0,1,V,-7.5,-20,-13,-102,11,6,-83,0,-1,2004
1071,1071,11/13/2004,Duke,16,38,21,32,20,213,1,0,Clemson,13,35,133,27,12,117,2,2,H,-12,3,3,-112,5,8,96,-1,-2,2004
1072,1072,11/13/2004,East Carolina,17,30,91,27,15,156,2,0,South Florida,41,56,276,16,12,233,0,3,V,-14.5,-24,-26,-185,11,3,-77,2,-3,2004
1073,1073,11/13/2004,Eastern Michigan,17,29,127,34,17,129,1,1,Kent State,69,41,250,35,29,325,0,0,V,-13,-52,-12,-123,-1,-12,-196,1,1,2004
1074,1074,11/13/2004,Florida,48,28,92,31,18,319,2,0,South Carolina,14,42,147,29,14,132,4,0,H,7,34,-14,-55,2,4,187,-2,0,2004
1075,1075,11/13/2004,Florida Atlantic,7,47,159,25,12,118,1,3,New Mexico State,35,42,188,29,16,225,0,0,H,6,-28,5,-29,-4,-4,-107,1,3,2004
1076,1076,11/13/2004,Georgia,6,29,85,27,17,194,1,1,Auburn,24,37,186,23,19,218,1,0,V,-3.5,-18,-8,-101,4,-2,-24,0,1,2004
1077,1077,11/13/2004,Georgia Tech,30,37,122,38,22,288,0,1,Connecticut,10,24,20,49,28,205,0,0,H,7.5,20,13,102,-11,-6,83,0,1,2004
1078,1078,11/13/2004,Houston,7,48,102,39,19,196,0,0,Alabama-Birmingham,20,31,120,25,14,238,1,1,V,-9.5,-13,17,-18,14,5,-42,-1,-1,2004
1079,1079,11/13/2004,Idaho,29,36,98,42,24,328,3,0,North Texas,51,44,334,18,13,168,0,0,V,-15,-22,-8,-236,24,11,160,3,0,2004
1080,1080,11/13/2004,Indiana,18,46,138,22,11,137,1,0,Penn State,22,40,131,24,12,182,2,0,H,-4,-4,6,7,-2,-1,-45,-1,0,2004
1081,1081,11/13/2004,Iowa,29,27,6,39,24,333,0,0,Minnesota,27,54,337,17,9,73,3,1,V,-5,2,-27,-331,22,15,260,-3,-1,2004
1082,1082,11/13/2004,Kansas,23,27,40,41,23,308,1,1,Texas,27,49,292,40,22,289,2,0,H,-23.5,-4,-22,-252,1,1,19,-1,1,2004
1083,1083,11/13/2004,Kansas State,31,41,160,34,22,212,1,1,Colorado,38,36,157,27,15,225,1,0,V,1.5,-7,5,3,7,7,-13,0,1,2004
1084,1084,11/13/2004,Kent State,69,41,250,35,29,325,0,0,Eastern Michigan,17,29,127,34,17,129,1,1,H,13,52,12,123,1,12,196,-1,-1,2004
1085,1085,11/13/2004,Kentucky,14,35,164,30,18,125,0,0,Vanderbilt,13,43,172,32,16,202,0,1,H,-5,1,-8,-8,-2,2,-77,0,-1,2004
1086,1086,11/13/2004,Louisiana State,26,44,192,14,6,91,0,1,Alabama,10,43,82,15,7,114,1,1,H,9,16,1,110,-1,-1,-23,-1,0,2004
1087,1087,11/13/2004,Louisiana Tech,38,43,269,26,11,164,0,2,Tulsa,21,47,198,27,13,156,2,4,H,6,17,-4,71,-1,-2,8,-2,-2,2004
1088,1088,11/13/2004,Marshall,35,30,98,56,35,363,3,1,Bowling Green,56,35,154,37,24,389,1,1,V,-9,-21,-5,-56,19,11,-26,2,0,2004
1089,1089,11/13/2004,Miami-Florida,31,40,203,33,18,177,0,0,Virginia,21,36,221,25,10,94,2,0,V,-3.5,10,4,-18,8,8,83,-2,0,2004
1090,1090,11/13/2004,Miami-Ohio,42,37,203,33,23,349,1,0,Western Michigan,21,27,57,37,21,254,0,0,V,21,21,10,146,-4,2,95,1,0,2004
1091,1091,11/13/2004,Michigan,42,39,231,29,20,190,0,0,Northwestern,20,34,190,44,24,215,0,0,H,14.5,22,5,41,-15,-4,-25,0,0,2004
1092,1092,11/13/2004,Michigan State,49,44,430,20,10,121,1,0,Wisconsin,14,41,217,39,21,179,0,1,H,-7,35,3,213,-19,-11,-58,1,-1,2004
1093,1093,11/13/2004,Mid Tennessee St,37,38,213,37,26,241,0,1,UL-Monroe,24,36,137,47,25,291,2,0,H,7,13,2,76,-10,1,-50,-2,1,2004
1094,1094,11/13/2004,Minnesota,27,54,337,17,9,73,3,1,Iowa,29,27,6,39,24,333,0,0,H,5,-2,27,331,-22,-15,-260,3,1,2004
1095,1095,11/13/2004,Mississippi,3,28,175,34,15,168,0,1,Arkansas,35,51,297,20,13,155,0,0,V,-9.5,-32,-23,-122,14,2,13,0,1,2004
1096,1096,11/13/2004,Nebraska,3,40,201,13,8,73,1,0,Oklahoma,30,31,98,36,30,413,0,0,V,-29.5,-27,9,103,-23,-22,-340,1,0,2004
1097,1097,11/13/2004,Nevada-Las Vegas,10,41,179,28,11,108,1,2,Colorado State,45,40,129,19,14,255,0,0,V,-6.5,-35,1,50,9,-3,-147,1,2,2004
1098,1098,11/13/2004,Nevada-Reno,20,26,86,48,30,354,1,3,Southern Methodist,38,52,170,23,14,230,2,2,V,6,-18,-26,-84,25,16,124,-1,1,2004
1099,1099,11/13/2004,New Mexico,21,46,114,12,7,143,1,0,Brigham Young,14,34,58,38,23,259,1,2,V,-6.5,7,12,56,-26,-16,-116,0,-2,2004
1100,1100,11/13/2004,New Mexico State,35,42,188,29,16,225,0,0,Florida Atlantic,7,47,159,25,12,118,1,3,V,-6,28,-5,29,4,4,107,-1,-3,2004
1101,1101,11/13/2004,North Carolina,31,38,166,37,19,234,1,1,Wake Forest,24,49,226,29,12,109,1,0,V,-5,7,-11,-60,8,7,125,0,1,2004
1102,1102,11/13/2004,North Texas,51,44,334,18,13,168,0,0,Idaho,29,36,98,42,24,328,3,0,H,15,22,8,236,-24,-11,-160,-3,0,2004
1103,1103,11/13/2004,Northwestern,20,34,190,44,24,215,0,0,Michigan,42,39,231,29,20,190,0,0,V,-14.5,-22,-5,-41,15,4,25,0,0,2004
1104,1104,11/13/2004,Notre Dame,38,34,179,26,15,259,2,0,Pittsburgh,41,38,98,42,26,334,0,1,H,11.5,-3,-4,81,-16,-11,-75,2,-1,2004
1105,1105,11/13/2004,Ohio,19,38,138,27,14,157,2,3,Akron,31,44,102,22,15,190,0,0,H,0,-12,-6,36,5,-1,-33,2,3,2004
1106,1106,11/13/2004,Ohio State,17,30,146,29,14,192,3,1,Purdue,24,43,120,42,29,264,1,0,V,-6,-7,-13,26,-13,-15,-72,2,1,2004
1107,1107,11/13/2004,Oklahoma,30,31,98,36,30,413,0,0,Nebraska,3,40,201,13,8,73,1,0,H,29.5,27,-9,-103,23,22,340,-1,0,2004
1108,1108,11/13/2004,Oklahoma State,49,54,305,15,8,164,0,0,Baylor,21,33,127,39,19,271,1,0,H,26,28,21,178,-24,-11,-107,-1,0,2004
1109,1109,11/13/2004,Oregon,26,29,145,29,15,192,2,0,U.C.L.A.,34,56,227,22,12,215,0,1,H,8.5,-8,-27,-82,7,3,-23,2,-1,2004
1110,1110,11/13/2004,Oregon State,24,38,36,42,29,334,4,0,Stanford,19,21,1,45,17,247,1,0,V,3,5,17,35,-3,12,87,3,0,2004
1111,1111,11/13/2004,Penn State,22,40,131,24,12,182,2,0,Indiana,18,46,138,22,11,137,1,0,V,4,4,-6,-7,2,1,45,1,0,2004
1112,1112,11/13/2004,Pittsburgh,41,38,98,42,26,334,0,1,Notre Dame,38,34,179,26,15,259,2,0,V,-11.5,3,4,-81,16,11,75,-2,1,2004
1113,1113,11/13/2004,Purdue,24,43,120,42,29,264,1,0,Ohio State,17,30,146,29,14,192,3,1,H,6,7,13,-26,13,15,72,-2,-1,2004
1114,1114,11/13/2004,Rice,28,79,312,14,6,97,1,2,Texas-El Paso,35,28,83,28,19,191,1,2,V,-14,-7,51,229,-14,-13,-94,0,0,2004
1115,1115,11/13/2004,San Diego State,37,43,224,33,17,232,1,1,Air Force,31,65,353,20,10,133,2,4,V,-5,6,-22,-129,13,7,99,-1,-3,2004
1116,1116,11/13/2004,San Jose State,49,58,179,33,16,288,1,1,Boise State,56,56,280,24,15,200,1,1,H,-32.5,-7,2,-101,9,1,88,0,0,2004
1117,1117,11/13/2004,South Carolina,14,42,147,29,14,132,4,0,Florida,48,28,92,31,18,319,2,0,V,-7,-34,14,55,-2,-4,-187,2,0,2004
1118,1118,11/13/2004,South Florida,41,56,276,16,12,233,0,3,East Carolina,17,30,91,27,15,156,2,0,H,14.5,24,26,185,-11,-3,77,-2,3,2004
1119,1119,11/13/2004,Southern Cal,49,38,216,40,31,369,0,3,Arizona,9,25,90,32,15,165,2,0,H,36.5,40,13,126,8,16,204,-2,3,2004
1120,1120,11/13/2004,Southern Methodist,38,52,170,23,14,230,2,2,Nevada-Reno,20,26,86,48,30,354,1,3,H,-6,18,26,84,-25,-16,-124,1,-1,2004
1121,1121,11/13/2004,Stanford,19,21,1,45,17,247,1,0,Oregon State,24,38,36,42,29,334,4,0,H,-3,-5,-17,-35,3,-12,-87,-3,0,2004
1122,1122,11/13/2004,Syracuse,24,36,235,35,20,240,1,2,Temple,34,58,285,20,11,181,0,0,V,8,-10,-22,-50,15,9,59,1,2,2004
1123,1123,11/13/2004,Temple,34,58,285,20,11,181,0,0,Syracuse,24,36,235,35,20,240,1,2,H,-8,10,22,50,-15,-9,-59,-1,-2,2004
1124,1124,11/13/2004,Texas,27,49,292,40,22,289,2,0,Kansas,23,27,40,41,23,308,1,1,V,23.5,4,22,252,-1,-1,-19,1,-1,2004
1125,1125,11/13/2004,Texas A+M,32,38,182,27,16,254,0,0,Texas Tech,25,26,117,50,31,294,3,0,H,2,7,12,65,-23,-15,-40,-3,0,2004
1126,1126,11/13/2004,Texas Tech,25,26,117,50,31,294,3,0,Texas A+M,32,38,182,27,16,254,0,0,V,-2,-7,-12,-65,23,15,40,3,0,2004
1127,1127,11/13/2004,Texas-El Paso,35,28,83,28,19,191,1,2,Rice,28,79,312,14,6,97,1,2,H,14,7,-51,-229,14,13,94,0,0,2004
1128,1128,11/13/2004,Troy State,13,51,196,14,9,100,0,1,UL-Lafayette,10,33,135,35,17,147,3,0,V,14.5,3,18,61,-21,-8,-47,-3,1,2004
1129,1129,11/13/2004,Tulane,45,48,243,32,23,350,1,1,Army,31,27,88,41,22,232,2,0,H,7,14,21,155,-9,1,118,-1,1,2004
1130,1130,11/13/2004,Tulsa,21,47,198,27,13,156,2,4,Louisiana Tech,38,43,269,26,11,164,0,2,V,-6,-17,4,-71,1,2,-8,2,2,2004
1131,1131,11/13/2004,U-C-F,17,53,196,21,13,131,0,1,Ball State,21,31,137,20,12,117,1,0,V,-3.5,-4,22,59,1,1,14,-1,1,2004
1132,1132,11/13/2004,U.C.L.A.,34,56,227,22,12,215,0,1,Oregon,26,29,145,29,15,192,2,0,V,-8.5,8,27,82,-7,-3,23,-2,1,2004
1133,1133,11/13/2004,UL-Lafayette,10,33,135,35,17,147,3,0,Troy State,13,51,196,14,9,100,0,1,H,-14.5,-3,-18,-61,21,8,47,3,-1,2004
1134,1134,11/13/2004,UL-Monroe,24,36,137,47,25,291,2,0,Mid Tennessee St,37,38,213,37,26,241,0,1,V,-7,-13,-2,-76,10,-1,50,2,-1,2004
1135,1135,11/13/2004,Utah,45,42,244,27,17,244,0,1,Wyoming,28,39,132,28,17,278,2,1,V,21,17,3,112,-1,0,-34,-2,0,2004
1136,1136,11/13/2004,Vanderbilt,13,43,172,32,16,202,0,1,Kentucky,14,35,164,30,18,125,0,0,V,5,-1,8,8,2,-2,77,0,1,2004
1137,1137,11/13/2004,Virginia,21,36,221,25,10,94,2,0,Miami-Florida,31,40,203,33,18,177,0,0,H,3.5,-10,-4,18,-8,-8,-83,2,0,2004
1138,1138,11/13/2004,Wake Forest,24,49,226,29,12,109,1,0,North Carolina,31,38,166,37,19,234,1,1,H,5,-7,11,60,-8,-7,-125,0,-1,2004
1139,1139,11/13/2004,Washington,12,33,84,44,20,328,3,1,California,42,44,304,24,13,175,2,0,H,-30.5,-30,-11,-220,20,7,153,1,1,2004
1140,1140,11/13/2004,Washington State,28,35,141,37,20,236,1,1,Arizona State,45,43,141,43,27,366,0,1,V,-14.5,-17,-8,0,-6,-7,-130,1,0,2004
1141,1141,11/13/2004,West Virginia,17,50,238,37,21,224,2,1,Boston College,36,36,81,30,18,162,0,0,H,7,-19,14,157,7,3,62,2,1,2004
1142,1142,11/13/2004,Western Michigan,21,27,57,37,21,254,0,0,Miami-Ohio,42,37,203,33,23,349,1,0,H,-21,-21,-10,-146,4,-2,-95,-1,0,2004
1143,1143,11/13/2004,Wisconsin,14,41,217,39,21,179,0,1,Michigan State,49,44,430,20,10,121,1,0,V,7,-35,-3,-213,19,11,58,-1,1,2004
1144,1144,11/13/2004,Wyoming,28,39,132,28,17,278,2,1,Utah,45,42,244,27,17,244,0,1,H,-21,-17,-3,-112,1,0,34,2,0,2004
1145,1145,11/18/2004,Arkansas State,7,31,139,24,9,101,1,2,North Texas,31,44,202,25,17,200,0,0,H,-4.5,-24,-13,-63,-1,-8,-99,1,2,2004
1146,1146,11/18/2004,Maryland,6,30,56,31,16,141,4,1,Virginia Tech,55,50,239,14,8,137,0,0,V,-9.5,-49,-20,-183,17,8,4,4,1,2004
1147,1147,11/18/2004,North Texas,31,44,202,25,17,200,0,0,Arkansas State,7,31,139,24,9,101,1,2,V,4.5,24,13,63,1,8,99,-1,-2,2004
1148,1148,11/18/2004,Virginia Tech,55,50,239,14,8,137,0,0,Maryland,6,30,56,31,16,141,4,1,H,9.5,49,20,183,-17,-8,-4,-4,-1,2004
1149,1149,11/20/2004,Air Force,47,70,373,19,11,203,0,0,Colorado State,17,28,108,27,17,229,1,0,H,-1.5,30,42,265,-8,-6,-26,-1,0,2004
1150,1150,11/20/2004,Akron,27,28,10,43,26,436,0,0,Miami-Ohio,37,36,229,28,18,208,0,1,H,-8.5,-10,-8,-219,15,8,228,0,-1,2004
1151,1151,11/20/2004,Alabama,13,31,50,30,17,226,1,0,Auburn,21,41,74,24,18,224,1,1,H,-11,-8,-10,-24,6,-1,2,0,-1,2004
1152,1152,11/20/2004,Alabama-Birmingham,20,36,158,32,20,199,0,2,Army,14,39,102,46,26,319,0,1,V,12,6,-3,56,-14,-6,-120,0,1,2004
1153,1153,11/20/2004,Arkansas,24,50,167,27,18,215,1,0,Mississippi State,21,31,150,27,20,214,0,0,V,10,3,19,17,0,-2,1,1,0,2004
1154,1154,11/20/2004,Army,14,39,102,46,26,319,0,1,Alabama-Birmingham,20,36,158,32,20,199,0,2,H,-12,-6,3,-56,14,6,120,0,-1,2004
1155,1155,11/20/2004,Auburn,21,41,74,24,18,224,1,1,Alabama,13,31,50,30,17,226,1,0,V,11,8,10,24,-6,1,-2,0,1,2004
1156,1156,11/20/2004,Ball State,40,44,115,34,22,397,0,0,Central Michigan,41,43,223,23,15,208,1,1,V,-4.5,-1,1,-108,11,7,189,-1,-1,2004
1157,1157,11/20/2004,Baylor,0,31,26,22,14,130,0,1,Oklahoma,35,47,302,34,21,199,0,0,H,-36.5,-35,-16,-276,-12,-7,-69,0,1,2004
1158,1158,11/20/2004,Boise State,55,55,278,34,22,351,0,2,Louisiana Tech,14,33,156,34,16,138,2,1,H,24,41,22,122,0,6,213,-2,1,2004
1159,1159,11/20/2004,Boston College,34,32,183,30,20,236,0,0,Temple,17,37,120,39,26,288,1,1,V,15,17,-5,63,-9,-6,-52,-1,-1,2004
1160,1160,11/20/2004,Brigham Young,21,27,81,33,17,213,1,1,Utah,52,48,354,26,17,184,2,0,V,-18,-31,-21,-273,7,0,29,-1,1,2004
1161,1161,11/20/2004,Buffalo,0,28,61,21,4,35,1,0,Connecticut,29,39,192,39,29,285,0,0,V,-25,-29,-11,-131,-18,-25,-250,1,0,2004
1162,1162,11/20/2004,California,41,51,307,17,14,167,0,1,Stanford,6,30,24,28,9,156,1,1,H,23.5,35,21,283,-11,5,11,-1,0,2004
1163,1163,11/20/2004,Central Michigan,41,43,223,23,15,208,1,1,Ball State,40,44,115,34,22,397,0,0,H,4.5,1,-1,108,-11,-7,-189,1,1,2004
1164,1164,11/20/2004,Cincinnati,45,39,200,37,30,377,0,1,South Florida,23,28,180,32,14,143,0,0,H,12,22,11,20,5,16,234,0,1,2004
1165,1165,11/20/2004,Clemson,29,48,162,28,15,151,1,0,South Carolina,7,28,66,27,9,131,1,1,H,3,22,20,96,1,6,20,0,-1,2004
1166,1166,11/20/2004,Colorado State,17,28,108,27,17,229,1,0,Air Force,47,70,373,19,11,203,0,0,V,1.5,-30,-42,-265,8,6,26,1,0,2004
1167,1167,11/20/2004,Connecticut,29,39,192,39,29,285,0,0,Buffalo,0,28,61,21,4,35,1,0,H,25,29,11,131,18,25,250,-1,0,2004
1168,1168,11/20/2004,Duke,17,25,53,35,19,181,1,1,North Carolina,40,48,285,24,17,201,0,1,H,-7,-23,-23,-232,11,2,-20,1,0,2004
1169,1169,11/20/2004,East Carolina,35,28,92,49,27,336,4,0,Memphis,38,45,242,37,21,200,1,0,H,-19,-3,-17,-150,12,6,136,3,0,2004
1170,1170,11/20/2004,Eastern Michigan,16,28,156,51,23,267,5,1,Northern Illinois,34,62,408,27,16,158,0,0,H,-17,-18,-34,-252,24,7,109,5,1,2004
1171,1171,11/20/2004,Florida,20,40,140,40,20,237,1,1,Florida State,13,24,34,49,23,314,2,0,V,-7,7,16,106,-9,-3,-77,-1,1,2004
1172,1173,11/20/2004,Florida State,13,24,34,49,23,314,2,0,Florida,20,40,140,40,20,237,1,1,H,7,-7,-16,-106,9,3,77,1,-1,2004
1173,1174,11/20/2004,Fresno State,54,46,279,18,11,171,1,0,Nevada-Reno,17,37,166,32,18,186,1,1,H,27.5,37,9,113,-14,-7,-15,0,-1,2004
1174,1175,11/20/2004,Georgia Tech,10,34,86,33,19,226,2,2,Virginia,30,41,207,28,19,171,0,0,H,-4,-20,-7,-121,5,0,55,2,2,2004
1175,1176,11/20/2004,Hawaii,52,25,87,38,27,413,3,0,Idaho,21,36,92,29,19,242,0,2,H,20,31,-11,-5,9,8,171,3,-2,2004
1176,1177,11/20/2004,Houston,27,35,71,44,29,375,1,0,Louisville,65,42,242,27,22,424,1,0,H,-22,-38,-7,-171,17,7,-49,0,0,2004
1177,1178,11/20/2004,Idaho,21,36,92,29,19,242,0,2,Hawaii,52,25,87,38,27,413,3,0,V,-20,-31,11,5,-9,-8,-171,-3,2,2004
1178,1179,11/20/2004,Illinois,21,49,129,33,20,149,0,1,Northwestern,28,34,156,31,18,184,1,0,V,-13,-7,15,-27,2,2,-35,-1,1,2004
1179,1180,11/20/2004,Indiana,24,39,119,34,21,239,0,1,Purdue,63,34,173,56,35,590,0,1,V,-21,-39,5,-54,-22,-14,-351,0,0,2004
1180,1181,11/20/2004,Iowa,30,39,76,24,15,186,3,0,Wisconsin,7,30,41,39,18,145,2,2,H,3,23,9,35,-15,-3,41,1,-2,2004
1181,1182,11/20/2004,Iowa State,37,43,161,30,16,234,0,0,Kansas State,23,46,257,18,6,58,2,2,V,-10,14,-3,-96,12,10,176,-2,-2,2004
1182,1183,11/20/2004,Kansas,31,42,135,36,24,239,1,1,Missouri,14,27,-6,40,15,262,1,0,V,-11,17,15,141,-4,9,-23,0,1,2004
1183,1184,11/20/2004,Kansas State,23,46,257,18,6,58,2,2,Iowa State,37,43,161,30,16,234,0,0,H,10,-14,3,96,-12,-10,-176,2,2,2004
1184,1185,11/20/2004,Louisiana State,27,52,360,24,8,81,1,0,Mississippi,24,33,156,26,10,98,2,0,H,21,3,19,204,-2,-2,-17,-1,0,2004
1185,1186,11/20/2004,Louisiana Tech,14,33,156,34,16,138,2,1,Boise State,55,55,278,34,22,351,0,2,V,-24,-41,-22,-122,0,-6,-213,2,-1,2004
1186,1187,11/20/2004,Louisville,65,42,242,27,22,424,1,0,Houston,27,35,71,44,29,375,1,0,V,22,38,7,171,-17,-7,49,0,0,2004
1187,1188,11/20/2004,Marshall,31,31,260,28,18,169,3,1,Western Michigan,21,30,79,41,27,339,2,0,H,28,10,1,181,-13,-9,-170,1,1,2004
1188,1189,11/20/2004,Memphis,38,45,242,37,21,200,1,0,East Carolina,35,28,92,49,27,336,4,0,V,19,3,17,150,-12,-6,-136,-3,0,2004
1189,1190,11/20/2004,Miami-Florida,52,39,155,27,19,424,0,0,Wake Forest,7,43,157,12,5,36,0,1,H,18.5,45,-4,-2,15,14,388,0,-1,2004
1190,1191,11/20/2004,Miami-Ohio,37,36,229,28,18,208,0,1,Akron,27,28,10,43,26,436,0,0,V,8.5,10,8,219,-15,-8,-228,0,1,2004
1191,1192,11/20/2004,Michigan,21,22,71,54,27,328,2,0,Ohio State,37,47,205,23,13,241,0,0,V,4,-16,-25,-134,31,14,87,2,0,2004
1192,1193,11/20/2004,Michigan State,13,33,161,40,20,177,5,0,Penn State,37,50,192,19,11,105,1,0,V,3.5,-24,-17,-31,21,9,72,4,0,2004
1193,1194,11/20/2004,Mid Tennessee St,17,25,139,46,27,193,3,1,Troy State,37,43,222,17,8,144,0,3,V,-14,-20,-18,-83,29,19,49,3,-2,2004
1194,1195,11/20/2004,Mississippi,24,33,156,26,10,98,2,0,Louisiana State,27,52,360,24,8,81,1,0,V,-21,-3,-19,-204,2,2,17,1,0,2004
1195,1196,11/20/2004,Mississippi State,21,31,150,27,20,214,0,0,Arkansas,24,50,167,27,18,215,1,0,H,-10,-3,-19,-17,0,2,-1,-1,0,2004
1196,1197,11/20/2004,Missouri,14,27,-6,40,15,262,1,0,Kansas,31,42,135,36,24,239,1,1,H,11,-17,-15,-141,4,-9,23,0,-1,2004
1197,1198,11/20/2004,Navy,54,67,476,7,4,137,0,2,Rutgers,21,21,33,52,33,390,2,2,H,3,33,46,443,-45,-29,-253,-2,0,2004
1198,1199,11/20/2004,Nevada-Las Vegas,3,41,81,45,21,216,2,2,San Diego State,21,31,109,26,16,175,0,1,V,-8.5,-18,10,-28,19,5,41,2,1,2004
1199,1200,11/20/2004,Nevada-Reno,17,37,166,32,18,186,1,1,Fresno State,54,46,279,18,11,171,1,0,V,-27.5,-37,-9,-113,14,7,15,0,1,2004
1200,1201,11/20/2004,New Mexico,16,45,304,15,5,40,1,1,Wyoming,9,40,33,35,20,234,1,0,H,8.5,7,5,271,-20,-15,-194,0,1,2004
1201,1202,11/20/2004,New Mexico State,25,32,116,43,24,346,1,3,Utah State,34,47,206,25,21,215,1,3,V,6.5,-9,-15,-90,18,3,131,0,0,2004
1202,1203,11/20/2004,North Carolina,40,48,285,24,17,201,0,1,Duke,17,25,53,35,19,181,1,1,V,7,23,23,232,-11,-2,20,-1,0,2004
1203,1204,11/20/2004,Northern Illinois,34,62,408,27,16,158,0,0,Eastern Michigan,16,28,156,51,23,267,5,1,V,17,18,34,252,-24,-7,-109,-5,-1,2004
1204,1205,11/20/2004,Northwestern,28,34,156,31,18,184,1,0,Illinois,21,49,129,33,20,149,0,1,H,13,7,-15,27,-2,-2,35,1,-1,2004
1205,1206,11/20/2004,Ohio State,37,47,205,23,13,241,0,0,Michigan,21,22,71,54,27,328,2,0,H,-4,16,25,134,-31,-14,-87,-2,0,2004
1206,1207,11/20/2004,Oklahoma,35,47,302,34,21,199,0,0,Baylor,0,31,26,22,14,130,0,1,V,36.5,35,16,276,12,7,69,0,-1,2004
1207,1208,11/20/2004,Oregon,21,40,109,32,13,126,3,0,Oregon State,50,37,87,42,25,368,1,0,V,-3,-29,3,22,-10,-12,-242,2,0,2004
1208,1209,11/20/2004,Oregon State,50,37,87,42,25,368,1,0,Oregon,21,40,109,32,13,126,3,0,H,3,29,-3,-22,10,12,242,-2,0,2004
1209,1210,11/20/2004,Penn State,37,50,192,19,11,105,1,0,Michigan State,13,33,161,40,20,177,5,0,H,-3.5,24,17,31,-21,-9,-72,-4,0,2004
1210,1211,11/20/2004,Purdue,63,34,173,56,35,590,0,1,Indiana,24,39,119,34,21,239,0,1,H,21,39,-5,54,22,14,351,0,0,2004
1211,1212,11/20/2004,Rutgers,21,21,33,52,33,390,2,2,Navy,54,67,476,7,4,137,0,2,V,-3,-33,-46,-443,45,29,253,2,0,2004
1212,1213,11/20/2004,San Diego State,21,31,109,26,16,175,0,1,Nevada-Las Vegas,3,41,81,45,21,216,2,2,H,8.5,18,-10,28,-19,-5,-41,-2,-1,2004
1213,1214,11/20/2004,San Jose State,24,43,245,25,9,111,1,0,Tulsa,34,49,295,18,13,147,0,1,V,-12,-10,-6,-50,7,-4,-36,1,-1,2004
1214,1215,11/20/2004,South Carolina,7,28,66,27,9,131,1,1,Clemson,29,48,162,28,15,151,1,0,V,-3,-22,-20,-96,-1,-6,-20,0,1,2004
1215,1216,11/20/2004,South Florida,23,28,180,32,14,143,0,0,Cincinnati,45,39,200,37,30,377,0,1,V,-12,-22,-11,-20,-5,-16,-234,0,-1,2004
1216,1217,11/20/2004,Southern Methodist,27,32,122,33,21,234,1,0,Texas-El Paso,57,40,165,32,23,363,1,0,V,-21.5,-30,-8,-43,1,-2,-129,0,0,2004
1217,1218,11/20/2004,Southern Miss,17,34,66,48,20,254,2,1,Texas Christian,42,48,234,34,19,250,1,0,V,0,-25,-14,-168,14,1,4,1,1,2004
1218,1219,11/20/2004,Stanford,6,30,24,28,9,156,1,1,California,41,51,307,17,14,167,0,1,V,-23.5,-35,-21,-283,11,-5,-11,1,0,2004
1219,1220,11/20/2004,Temple,17,37,120,39,26,288,1,1,Boston College,34,32,183,30,20,236,0,0,H,-15,-17,5,-63,9,6,52,1,1,2004
1220,1221,11/20/2004,Tennessee,38,38,236,30,19,189,2,0,Vanderbilt,33,33,106,33,22,314,2,2,V,12.5,5,5,130,-3,-3,-125,0,-2,2004
1221,1222,11/20/2004,Texas Christian,42,48,234,34,19,250,1,0,Southern Miss,17,34,66,48,20,254,2,1,H,0,25,14,168,-14,-1,-4,-1,-1,2004
1222,1223,11/20/2004,Texas-El Paso,57,40,165,32,23,363,1,0,Southern Methodist,27,32,122,33,21,234,1,0,H,21.5,30,8,43,-1,2,129,0,0,2004
1223,1224,11/20/2004,Troy State,37,43,222,17,8,144,0,3,Mid Tennessee St,17,25,139,46,27,193,3,1,H,14,20,18,83,-29,-19,-49,-3,2,2004
1224,1225,11/20/2004,Tulsa,34,49,295,18,13,147,0,1,San Jose State,24,43,245,25,9,111,1,0,H,12,10,6,50,-7,4,36,-1,1,2004
1225,1226,11/20/2004,UL-Lafayette,10,44,186,31,18,195,2,1,UL-Monroe,13,32,122,38,17,172,1,0,V,-3,-3,12,64,-7,1,23,1,1,2004
1226,1227,11/20/2004,UL-Monroe,13,32,122,38,17,172,1,0,UL-Lafayette,10,44,186,31,18,195,2,1,H,3,3,-12,-64,7,-1,-23,-1,-1,2004
1227,1228,11/20/2004,Utah,52,48,354,26,17,184,2,0,Brigham Young,21,27,81,33,17,213,1,1,H,18,31,21,273,-7,0,-29,1,-1,2004
1228,1229,11/20/2004,Utah State,34,49,204,27,23,201,1,3,New Mexico State,25,30,114,41,22,332,1,3,H,-6.5,9,19,90,-14,1,-131,0,0,2004
1229,1230,11/20/2004,Vanderbilt,33,33,106,33,22,314,2,2,Tennessee,38,38,236,30,19,189,2,0,H,-12.5,-5,-5,-130,3,3,125,0,2,2004
1230,1231,11/20/2004,Virginia,30,41,207,28,19,171,0,0,Georgia Tech,10,34,86,33,19,226,2,2,V,4,20,7,121,-5,0,-55,-2,-2,2004
1231,1232,11/20/2004,Wake Forest,7,43,157,12,5,36,0,1,Miami-Florida,52,39,155,27,19,424,0,0,V,-18.5,-45,4,2,-15,-14,-388,0,1,2004
1232,1233,11/20/2004,Washington,25,37,71,34,16,177,3,1,Washington State,28,44,153,24,15,240,0,2,V,-13,-3,-7,-82,10,1,-63,3,-1,2004
1233,1234,11/20/2004,Washington State,28,44,153,24,15,240,0,2,Washington,25,37,71,34,16,177,3,1,H,13,3,7,82,-10,-1,63,-3,1,2004
1234,1235,11/20/2004,Western Michigan,21,30,79,41,27,339,2,0,Marshall,31,31,260,28,18,169,3,1,V,-28,-10,-1,-181,13,9,170,-1,-1,2004
1235,1236,11/20/2004,Wisconsin,7,30,41,39,18,145,2,2,Iowa,30,39,76,24,15,186,3,0,V,-3,-23,-9,-35,15,3,-41,-1,2,2004
1236,1237,11/20/2004,Wyoming,9,40,33,35,20,234,1,0,New Mexico,16,45,304,15,5,40,1,1,V,-8.5,-7,-5,-271,20,15,194,0,-1,2004
1237,1238,11/23/2004,Bowling Green,41,34,139,60,36,415,0,1,Toledo,49,39,179,39,24,338,2,1,V,4.5,-8,-5,-40,21,12,77,-2,0,2004
1238,1239,11/23/2004,Kent State,41,37,113,39,29,426,0,1,U-C-F,24,36,72,34,23,337,2,2,V,9.5,17,1,41,5,6,89,-2,-1,2004
1239,1240,11/23/2004,Toledo,49,39,179,39,24,338,2,1,Bowling Green,41,34,139,60,36,415,0,1,H,-4.5,8,5,40,-21,-12,-77,2,0,2004
1240,1241,11/23/2004,U-C-F,24,36,72,34,23,337,2,2,Kent State,41,37,113,39,29,426,0,1,H,-9.5,-17,-1,-41,-5,-6,-89,2,1,2004
1241,1242,11/25/2004,Connecticut,41,48,223,30,19,264,2,0,Rutgers,35,30,88,40,27,366,0,2,V,4,6,18,135,-10,-8,-102,2,-2,2004
1242,1243,11/25/2004,Pittsburgh,16,35,143,38,14,165,1,0,West Virginia,13,49,213,27,14,145,2,0,H,-3,3,-14,-70,11,0,20,-1,0,2004
1243,1244,11/25/2004,Rutgers,35,30,88,40,27,366,0,2,Connecticut,41,48,223,30,19,264,2,0,H,-4,-6,-18,-135,10,8,102,-2,2,2004
1244,1245,11/25/2004,West Virginia,13,49,213,27,14,145,2,0,Pittsburgh,16,35,143,38,14,165,1,0,V,3,-3,14,70,-11,0,-20,1,0,2004
1245,1246,11/26/2004,Arizona,34,39,149,32,18,249,1,1,Arizona State,27,29,90,51,31,414,1,4,H,-14,7,10,59,-19,-13,-165,0,-3,2004
1246,1247,11/26/2004,Arizona State,27,29,90,51,31,414,1,4,Arizona,34,39,149,32,18,249,1,1,V,14,-7,-10,-59,19,13,165,0,3,2004
1247,1248,11/26/2004,Arkansas,14,31,95,32,12,152,3,0,Louisiana State,43,53,295,14,10,173,0,1,H,-3.5,-29,-22,-200,18,2,-21,3,-1,2004
1248,1249,11/26/2004,Colorado,26,48,198,29,18,222,1,1,Nebraska,20,23,67,55,29,306,4,0,V,-2.5,6,25,131,-26,-11,-84,-3,1,2004
1249,1250,11/26/2004,Louisiana State,43,53,295,14,10,173,0,1,Arkansas,14,31,95,32,12,152,3,0,V,3.5,29,22,200,-18,-2,21,-3,1,2004
1250,1251,11/26/2004,Nebraska,20,23,67,55,29,306,4,0,Colorado,26,48,198,29,18,222,1,1,H,2.5,-6,-25,-131,26,11,84,3,-1,2004
1251,1252,11/26/2004,Texas,26,61,274,18,12,131,0,1,Texas A+M,13,25,31,38,20,247,1,0,H,10.5,13,36,243,-20,-8,-116,-1,1,2004
1252,1253,11/26/2004,Texas A+M,13,25,31,38,20,247,1,0,Texas,26,61,274,18,12,131,0,1,V,-10.5,-13,-36,-243,20,8,116,1,-1,2004
1253,1254,11/27/2004,Alabama-Birmingham,21,31,125,30,11,206,1,1,Southern Miss,26,40,125,26,14,162,0,1,V,1,-5,-9,0,4,-3,44,1,0,2004
1254,1255,11/27/2004,Boise State,58,49,287,27,19,271,2,0,Nevada-Reno,21,27,70,46,27,304,2,1,V,24.5,37,22,217,-19,-8,-33,0,-1,2004
1255,1256,11/27/2004,Boston College,17,29,71,51,24,200,3,1,Syracuse,43,52,309,16,9,88,2,0,H,11,-26,-23,-238,35,15,112,1,1,2004
1256,1257,11/27/2004,Cincinnati,7,57,153,27,8,33,2,2,Louisville,70,31,357,15,10,134,0,1,V,-24,-63,26,-204,12,-2,-101,2,1,2004
1257,1258,11/27/2004,East Carolina,14,38,30,28,10,110,2,0,No Carolina State,52,42,160,35,18,227,1,3,N,-22.5,-38,-4,-130,-7,-8,-117,1,-3,2004
1258,1260,11/27/2004,Fresno State,62,52,313,19,12,228,1,2,San Jose State,28,42,190,25,12,149,0,1,V,27,34,10,123,-6,0,79,1,1,2004
1259,1261,11/27/2004,Georgia,19,33,34,28,11,192,0,1,Georgia Tech,13,35,24,42,16,170,0,0,H,15,6,-2,10,-14,-5,22,0,1,2004
1260,1262,11/27/2004,Georgia Tech,13,35,24,42,16,170,0,0,Georgia,19,33,34,28,11,192,0,1,V,-15,-6,2,-10,14,5,-22,0,-1,2004
1261,1263,11/27/2004,Hawaii,49,23,93,58,31,405,2,0,Northwestern,41,46,216,41,19,319,1,0,H,-6,8,-23,-123,17,12,86,1,0,2004
1262,1264,11/27/2004,Iowa State,14,50,143,29,16,206,1,0,Missouri,17,50,208,24,13,150,1,1,H,5,-3,0,-65,5,3,56,0,-1,2004
1263,1265,11/27/2004,Kentucky,31,29,105,32,20,218,1,0,Tennessee,37,40,204,43,27,402,2,0,V,-23,-6,-11,-99,-11,-7,-184,-1,0,2004
1264,1266,11/27/2004,Louisville,70,31,357,15,10,134,0,1,Cincinnati,7,57,153,27,8,33,2,2,H,24,63,-26,204,-12,2,101,-2,-1,2004
1265,1267,11/27/2004,Maryland,13,47,131,28,16,164,0,1,Wake Forest,7,46,149,22,10,123,0,1,H,5.5,6,1,-18,6,6,41,0,0,2004
1266,1268,11/27/2004,Memphis,31,51,328,21,12,142,0,0,South Florida,15,40,240,37,18,191,0,0,V,4,16,11,88,-16,-6,-49,0,0,2004
1267,1269,11/27/2004,Mississippi,20,62,283,26,13,138,3,1,Mississippi State,3,26,70,28,8,150,1,2,H,5,17,36,213,-2,5,-12,2,-1,2004
1268,1270,11/27/2004,Mississippi State,3,26,70,28,8,150,1,2,Mississippi,20,62,283,26,13,138,3,1,V,-5,-17,-36,-213,2,-5,12,-2,1,2004
1269,1271,11/27/2004,Missouri,17,50,208,24,13,150,1,1,Iowa State,14,50,143,29,16,206,1,0,V,-5,3,0,65,-5,-3,-56,0,1,2004
1270,1272,11/27/2004,Nevada-Reno,21,27,70,46,27,304,2,1,Boise State,58,49,287,27,19,271,2,0,H,-24.5,-37,-22,-217,19,8,33,0,1,2004
1271,1273,11/27/2004,No Carolina State,52,42,160,35,18,227,1,3,East Carolina,14,38,30,28,10,110,2,0,N,22.5,38,4,130,7,8,117,-1,3,2004
1272,1274,11/27/2004,Notre Dame,10,37,195,30,15,105,0,0,Southern Cal,41,28,83,35,25,405,0,0,V,-24,-31,9,112,-5,-10,-300,0,0,2004
1273,1275,11/27/2004,Oklahoma State,15,44,176,14,7,66,0,0,Texas Tech,31,33,155,46,31,281,1,1,V,-4,-16,11,21,-32,-24,-215,-1,-1,2004
1274,1276,11/27/2004,San Jose State,28,42,190,25,12,149,0,1,Fresno State,62,52,313,19,12,228,1,2,H,-27,-34,-10,-123,6,0,-79,-1,-1,2004
1275,1277,11/27/2004,South Florida,15,40,240,37,18,191,0,0,Memphis,31,51,328,21,12,142,0,0,H,-4,-16,-11,-88,16,6,49,0,0,2004
1276,1278,11/27/2004,Southern Cal,41,28,83,35,25,405,0,0,Notre Dame,10,37,195,30,15,105,0,0,H,24,31,-9,-112,5,10,300,0,0,2004
1277,1279,11/27/2004,Southern Miss,26,40,125,26,14,162,0,1,Alabama-Birmingham,21,31,125,30,11,206,1,1,H,-1,5,9,0,-4,3,-44,-1,0,2004
1278,1280,11/27/2004,Syracuse,43,52,309,16,9,88,2,0,Boston College,17,29,71,51,24,200,3,1,V,-11,26,23,238,-35,-15,-112,-1,-1,2004
1279,1281,11/27/2004,Tennessee,37,40,204,43,27,402,2,0,Kentucky,31,29,105,32,20,218,1,0,H,23,6,11,99,11,7,184,1,0,2004
1280,1282,11/27/2004,Texas Christian,31,44,197,37,20,280,1,1,Tulane,35,37,94,37,22,282,1,0,H,14.5,-4,7,103,0,-2,-2,0,1,2004
1281,1283,11/27/2004,Texas Tech,31,33,155,46,31,281,1,1,Oklahoma State,15,44,176,14,7,66,0,0,H,4,16,-11,-21,32,24,215,1,1,2004
1282,1284,11/27/2004,Texas-El Paso,35,38,181,44,21,312,3,1,Tulsa,37,54,207,15,9,76,1,0,V,7,-2,-16,-26,29,12,236,2,1,2004
1283,1285,11/27/2004,Tulane,35,37,94,37,22,282,1,0,Texas Christian,31,44,197,37,20,280,1,1,V,-14.5,4,-7,-103,0,2,2,0,-1,2004
1284,1286,11/27/2004,Tulsa,37,54,207,15,9,76,1,0,Texas-El Paso,35,38,181,44,21,312,3,1,H,-7,2,16,26,-29,-12,-236,-2,-1,2004
1285,1287,11/27/2004,Virginia,10,46,188,14,8,111,0,2,Virginia Tech,24,40,147,22,16,200,0,1,V,-3.5,-14,6,41,-8,-8,-89,0,1,2004
1286,1288,11/27/2004,Virginia Tech,24,40,147,22,16,200,0,1,Virginia,10,46,188,14,8,111,0,2,H,3.5,14,-6,-41,8,8,89,0,-1,2004
1287,1289,11/27/2004,Wake Forest,7,46,149,22,10,123,0,1,Maryland,13,47,131,28,16,164,0,1,V,-5.5,-6,-1,18,-6,-6,-41,0,0,2004
1288,1290,11/29/2004,Louisiana Tech,51,50,242,11,7,174,0,0,Rice,14,59,257,12,5,72,1,2,V,-2.5,37,-9,-15,-1,2,102,-1,-2,2004
1289,1291,11/29/2004,Rice,14,59,257,12,5,72,1,2,Louisiana Tech,51,50,242,11,7,174,0,0,H,2.5,-37,9,15,1,-2,-102,1,2,2004
1290,1292,12/02/2004,Miami-Ohio,27,28,58,33,20,304,2,0,Toledo,35,46,186,25,18,251,1,0,N,-1.5,-8,-18,-128,8,2,53,1,0,2004
1291,1293,12/02/2004,Toledo,35,46,186,25,18,251,1,0,Miami-Ohio,27,28,58,33,20,304,2,0,N,1.5,8,18,128,-8,-2,-53,-1,0,2004
1292,1294,12/04/2004,Army,13,34,149,42,21,170,1,0,Navy,42,54,305,11,7,100,0,1,N,-12.5,-29,-20,-156,31,14,70,1,-1,2004
1293,1295,12/04/2004,Auburn,38,49,185,36,27,374,1,1,Tennessee,28,24,228,20,8,69,0,0,N,14,10,25,-43,16,19,305,1,1,2004
1294,1296,12/04/2004,California,26,44,323,28,15,223,1,0,Southern Miss,16,24,23,37,17,304,0,0,V,25,10,20,300,-9,-2,-81,1,0,2004
1295,1297,12/04/2004,Colorado,3,16,-4,28,9,50,1,0,Oklahoma,42,46,236,32,24,262,2,1,N,-23.5,-39,-30,-240,-4,-15,-212,-1,-1,2004
1296,1298,12/04/2004,Florida Atlantic,17,38,105,34,25,311,0,0,Florida Intl,10,20,50,44,26,277,0,0,N,14,7,18,55,-10,-1,34,0,0,2004
1297,1299,12/04/2004,Hawaii,41,23,120,49,29,416,0,0,Michigan State,38,49,268,33,22,330,0,0,H,-7,3,-26,-148,16,7,86,0,0,2004
1298,1300,12/04/2004,Louisville,55,45,216,35,27,306,0,0,Tulane,7,27,53,25,12,112,1,1,V,31,48,18,163,10,15,194,-1,-1,2004
1299,1301,12/04/2004,Miami-Florida,10,22,51,31,16,139,1,1,Virginia Tech,16,48,149,18,11,148,0,2,H,7,-6,-26,-98,13,5,-9,1,-1,2004
1300,1302,12/04/2004,Michigan State,38,49,268,33,22,330,0,0,Hawaii,41,23,120,49,29,416,0,0,V,7,-3,26,148,-16,-7,-86,0,0,2004
1301,1303,12/04/2004,Navy,42,54,305,11,7,100,0,1,Army,13,34,149,42,21,170,1,0,N,12.5,29,20,156,-31,-14,-70,-1,1,2004
1302,1304,12/04/2004,Oklahoma,42,46,236,32,24,262,2,1,Colorado,3,16,-4,28,9,50,1,0,N,23.5,39,30,240,4,15,212,1,1,2004
1303,1305,12/04/2004,Pittsburgh,43,34,53,32,20,422,0,1,South Florida,14,41,146,35,18,206,2,2,V,6,29,-7,-93,-3,2,216,-2,-1,2004
1304,1306,12/04/2004,South Florida,14,41,146,35,18,206,2,2,Pittsburgh,43,34,53,32,20,422,0,1,H,-6,-29,7,93,3,-2,-216,2,1,2004
1305,1307,12/04/2004,Southern Cal,29,37,235,34,24,242,1,1,U.C.L.A.,24,25,17,34,20,278,2,1,V,21,5,12,218,0,4,-36,-1,0,2004
1306,1308,12/04/2004,Southern Miss,16,24,23,37,17,304,0,0,California,26,44,323,28,15,223,1,0,H,-25,-10,-20,-300,9,2,81,-1,0,2004
1307,1309,12/04/2004,Tennessee,28,24,228,20,8,69,0,0,Auburn,38,49,185,36,27,374,1,1,N,-14,-10,-25,43,-16,-19,-305,-1,-1,2004
1308,1310,12/04/2004,Tulane,7,27,53,25,12,112,1,1,Louisville,55,45,216,35,27,306,0,0,H,-31,-48,-18,-163,-10,-15,-194,1,1,2004
1309,1311,12/04/2004,U.C.L.A.,24,25,17,34,20,278,2,1,Southern Cal,29,37,235,34,24,242,1,1,H,-21,-5,-12,-218,0,-4,36,1,0,2004
1310,1312,12/04/2004,Virginia Tech,16,48,149,18,11,148,0,2,Miami-Florida,10,22,51,31,16,139,1,1,V,-7,6,26,98,-13,-5,9,-1,1,2004
