,Unnamed: 0,Date,TeamName,ScoreOff,RushAttOff,RushYdsOff,PassAttOff,PassCompOff,PassYdsOff,PassIntOff,FumblesOff,Opponent,ScoreDef,RushAttDef,RushYdsDef,PassAttDef,PassCompDef,PassYdsDef,PassIntDef,FumblesDef,Site,Line ,ScoreDiff,RushAttDiff,RushYdsDiff,PassAttDiff,PassCompDiff,PassYdsDiff,PassIntDiff,FumblesDiff,season
0,0,08/28/2008,Ball State,48,31,190,26,22,297,0,0,Northeastern,14,32,93,37,20,231,0,0,H, ,34,-1,97,-11,2,66,0,0,2008
1,1,08/28/2008,Baylor,13,34,94,30,15,156,2,3,Wake Forest,41,44,156,36,27,220,0,2,H,-12 ,-28,-10,-62,-6,-12,-64,2,1,2008
2,2,08/28/2008,Buffalo,42,50,263,16,10,221,0,2,UTEP,17,26,67,37,20,199,3,0,H,3,25,24,196,-21,-10,22,-3,2,2008
3,3,08/28/2008,Central Michigan,31,44,172,31,21,217,0,0,Eastern Illinois,12,31,83,28,19,201,0,1,H, ,19,13,89,3,2,16,0,-1,2008
4,4,08/28/2008,Cincinnati,40,44,209,35,26,348,0,1,Eastern Kentucky,7,28,48,18,13,147,1,1,H, ,33,16,161,17,13,201,-1,0,2008
5,5,08/28/2008,Connecticut,35,43,218,30,18,233,3,2,Hofstra,3,28,40,28,17,130,2,1,H, ,32,15,178,2,1,103,1,1,2008
6,6,08/28/2008,Eastern Michigan,52,53,413,29,21,224,0,1,Indiana State,0,31,75,23,7,57,3,0,H, ,52,22,338,6,14,167,-3,1,2008
7,7,08/28/2008,Georgia Tech,41,46,349,15,8,135,0,2,Jacksonville St,14,31,122,37,22,136,2,2,H, ,27,15,227,-22,-14,-1,-2,0,2008
8,8,08/28/2008,Iowa State,44,42,229,19,13,159,0,3,South Dakota State,17,25,180,37,23,170,5,1,H, ,27,17,49,-18,-10,-11,-5,2,2008
9,9,08/28/2008,Miami-Florida,52,38,224,27,17,192,0,1,Charleston Southern,7,30,49,22,11,77,0,1,H, ,45,8,175,5,6,115,0,0,2008
10,10,08/28/2008,Miami-Ohio,13,25,96,42,19,244,3,0,Vanderbilt,34,50,269,16,9,91,0,2,H,3.5,-21,-25,-173,26,10,153,3,-2,2008
11,11,08/28/2008,Middle Tennessee,17,50,84,34,20,200,1,1,Troy,31,36,164,28,17,136,1,3,H,-6,-14,14,-80,6,3,64,0,-2,2008
12,12,08/28/2008,No Carolina State,0,37,89,20,5,49,2,2,South Carolina,34,42,171,27,17,198,4,0,V,-14,-34,-5,-82,-7,-12,-149,-2,2,2008
13,13,08/28/2008,Oregon State,28,28,86,54,34,404,2,1,Stanford,36,48,210,17,10,91,0,0,V,2.5,-8,-20,-124,37,24,313,2,1,2008
14,14,08/28/2008,South Carolina,34,42,171,27,17,198,4,0,No Carolina State,0,37,89,20,5,49,2,2,H,14,34,5,82,7,12,149,2,-2,2008
15,15,08/28/2008,Stanford,36,48,210,17,10,91,0,0,Oregon State,28,28,86,54,34,404,2,1,H,-2.5,8,20,124,-37,-24,-313,-2,-1,2008
16,16,08/28/2008,Troy,31,36,164,28,17,136,1,3,Middle Tennessee,17,50,84,34,20,200,1,1,V,6,14,-14,80,-6,-3,-64,0,2,2008
17,17,08/28/2008,UTEP,17,26,67,37,20,199,3,0,Buffalo,42,50,263,16,10,221,0,2,V,-3,-25,-24,-196,21,10,-22,3,-2,2008
18,18,08/28/2008,Vanderbilt,34,50,269,16,9,91,0,2,Miami-Ohio,13,25,96,42,19,244,3,0,V,-3.5,21,25,173,-26,-10,-153,-3,2,2008
19,19,08/28/2008,Wake Forest,41,44,156,36,27,220,0,2,Baylor,13,34,94,30,15,156,2,3,V,12,28,10,62,6,12,64,-2,-1,2008
20,20,08/29/2008,Army,7,58,210,15,6,74,1,2,Temple,35,30,84,23,16,166,1,1,H,-7,-28,28,126,-8,-10,-92,0,1,2008
21,21,08/29/2008,Rice,56,44,208,37,24,258,0,2,S-M-U,27,14,11,49,30,326,3,2,H,3,29,30,197,-12,-6,-68,-3,0,2008
22,22,08/29/2008,S-M-U,27,14,11,49,30,326,3,2,Rice,56,44,208,37,24,258,0,2,V,-3,-29,-30,-197,12,6,68,3,0,2008
23,23,08/29/2008,Temple,35,30,84,23,16,166,1,1,Army,7,58,210,15,6,74,1,2,V,7,28,-28,-126,8,10,92,0,-1,2008
24,24,08/30/2008,Air Force,41,76,433,12,8,75,0,2,Southern Utah,7,23,7,25,15,123,0,2,H, ,34,53,426,-13,-7,-48,0,0,2008
25,25,08/30/2008,Akron,17,22,70,37,22,227,0,1,Wisconsin,38,63,404,10,7,75,1,2,V,-26.5,-21,-41,-334,27,15,152,-1,-1,2008
26,26,08/30/2008,Alabama,34,50,239,30,22,180,0,0,Clemson,10,14,0,34,20,188,1,1,N,-4.5,24,36,239,-4,2,-8,-1,-1,2008
27,27,08/30/2008,Arizona,70,49,265,31,23,256,0,0,Idaho,0,25,64,27,10,48,4,1,H,27,70,24,201,4,13,208,-4,-1,2008
28,28,08/30/2008,Arizona State,30,23,94,36,23,387,0,1,Northern Arizona,13,42,139,36,19,169,0,0,H, ,17,-19,-45,0,4,218,0,1,2008
29,29,08/30/2008,Arkansas,28,21,76,41,25,318,1,2,Western Illinois,24,46,157,26,10,105,0,0,H, ,4,-25,-81,15,15,213,1,2,2008
30,30,08/30/2008,Arkansas State,18,45,255,28,15,160,0,1,Texas A+M,14,36,133,27,19,170,2,2,V,-18.5,4,9,122,1,-4,-10,-2,-1,2008
31,31,08/30/2008,Auburn,34,46,321,27,13,85,1,0,UL-Monroe,0,30,84,38,20,136,0,2,H,26,34,16,237,-11,-7,-51,1,-2,2008
32,32,08/30/2008,Boise State,49,37,230,29,19,352,0,2,Idaho State,7,45,115,23,16,92,0,1,H, ,42,-8,115,6,3,260,0,1,2008
33,33,08/30/2008,Boston College,21,47,230,18,12,106,0,0,Kent State,0,36,126,21,13,134,2,1,N,10,21,11,104,-3,-1,-28,-2,-1,2008
34,34,08/30/2008,Bowling Green,27,28,64,42,26,190,1,0,Pittsburgh,17,35,129,51,29,264,1,3,V,-13.5,10,-7,-65,-9,-3,-74,0,-3,2008
35,35,08/30/2008,Brigham Young,41,28,77,41,34,486,0,4,Northern Iowa,17,40,149,25,17,213,0,2,H, ,24,-12,-72,16,17,273,0,2,2008
36,36,08/30/2008,California,38,36,203,30,20,264,2,0,Michigan State,31,31,81,48,20,321,1,0,H,5,7,5,122,-18,0,-57,1,0,2008
37,37,08/30/2008,Clemson,10,14,0,34,20,188,1,1,Alabama,34,50,239,30,22,180,0,0,N,4.5,-24,-36,-239,4,-2,8,1,1,2008
38,38,08/30/2008,Duke,31,48,218,31,18,146,0,2,James Madison,7,37,188,11,4,51,1,2,H, ,24,11,30,20,14,95,-1,0,2008
39,39,08/30/2008,East Carolina,27,41,158,25,19,211,0,2,Virginia Tech,22,35,104,23,14,139,2,0,N,-9,5,6,54,2,5,72,-2,2,2008
40,40,08/30/2008,Florida,56,38,255,17,10,151,0,0,Hawaii,10,24,60,39,21,181,4,2,H,34.5,46,14,195,-22,-11,-30,-4,-2,2008
41,41,08/30/2008,Florida Atlantic,10,23,37,39,17,255,1,1,Texas,52,46,232,35,28,271,0,0,V,-24,-42,-23,-195,4,-11,-16,1,1,2008
42,42,08/30/2008,Florida Intl,10,26,66,29,10,73,2,1,Kansas,40,36,128,52,37,256,1,1,V,-36,-30,-10,-62,-23,-27,-183,1,0,2008
43,43,08/30/2008,Georgia,45,32,212,27,17,323,0,1,Georgia Southern,21,35,102,36,19,188,1,0,H, ,24,-3,110,-9,-2,135,-1,1,2008
44,44,08/30/2008,Hawaii,10,24,60,39,21,181,4,2,Florida,56,38,255,17,10,151,0,0,V,-34.5,-46,-14,-195,22,11,30,4,2,2008
45,45,08/30/2008,Houston,55,33,148,49,39,467,0,1,Southern Univ,3,23,35,39,25,217,1,2,H, ,52,10,113,10,14,250,-1,-1,2008
46,46,08/30/2008,Idaho,0,25,64,27,10,48,4,1,Arizona,70,49,265,31,23,256,0,0,V,-27,-70,-24,-201,-4,-13,-208,4,1,2008
47,47,08/30/2008,Illinois,42,35,81,42,26,451,2,0,Missouri,52,37,226,45,26,323,1,1,N,-9,-10,-2,-145,-3,0,128,1,-1,2008
48,48,08/30/2008,Indiana,31,41,297,30,18,153,1,0,Western Kentucky,13,31,63,31,19,219,0,1,H,19,18,10,234,-1,-1,-66,1,-1,2008
49,49,08/30/2008,Iowa,46,44,245,29,18,212,1,0,Maine,3,35,137,23,9,83,2,0,H, ,43,9,108,6,9,129,-1,0,2008
50,50,08/30/2008,Kansas,40,36,128,52,37,256,1,1,Florida Intl,10,26,66,29,10,73,2,1,H,36,30,10,62,23,27,183,-1,0,2008
51,51,08/30/2008,Kansas State,45,36,165,42,27,306,1,1,North Texas,6,26,105,29,16,100,0,0,H,27,39,10,60,13,11,206,1,1,2008
52,52,08/30/2008,Kent State,0,36,126,21,13,134,2,1,Boston College,21,47,230,18,12,106,0,0,N,-10,-21,-11,-104,3,1,28,2,1,2008
53,53,08/30/2008,Louisiana State,41,40,266,24,13,193,1,0,Appalachian State,13,28,52,33,14,187,0,0,H, ,28,12,214,-9,-1,6,1,0,2008
54,54,08/30/2008,Louisiana Tech,22,32,94,41,14,175,2,1,Mississippi State,14,31,91,40,22,257,3,2,H,-7.5,8,1,3,1,-8,-82,-1,-1,2008
55,55,08/30/2008,Marshall,35,32,229,22,11,161,1,1,Illinois State,10,40,98,43,24,229,1,0,H, ,25,-8,131,-21,-13,-68,0,1,2008
56,56,08/30/2008,Maryland,14,45,271,21,11,126,2,0,Delaware,7,34,121,23,14,128,2,0,H, ,7,11,150,-2,-3,-2,0,0,2008
57,57,08/30/2008,Memphis,24,40,188,44,24,265,2,0,Mississippi,41,36,216,23,11,222,0,0,V,-7.5,-17,4,-28,21,13,43,2,0,2008
58,58,08/30/2008,Michigan,23,25,36,38,19,167,1,2,Utah,25,43,36,34,21,305,1,2,H,3,-2,-18,0,4,-2,-138,0,0,2008
59,59,08/30/2008,Michigan State,31,31,81,48,20,321,1,0,California,38,36,203,30,20,264,2,0,V,-5,-7,-5,-122,18,0,57,-1,0,2008
60,60,08/30/2008,Minnesota,31,31,127,37,24,298,0,1,Northern Illinois,27,31,72,30,17,326,0,1,H,8,4,0,55,7,7,-28,0,0,2008
61,61,08/30/2008,Mississippi,41,36,216,23,11,222,0,0,Memphis,24,40,188,44,24,265,2,0,H,7.5,17,-4,28,-21,-13,-43,-2,0,2008
62,62,08/30/2008,Mississippi State,14,31,91,40,22,257,3,2,Louisiana Tech,22,32,94,41,14,175,2,1,V,7.5,-8,-1,-3,-1,8,82,1,1,2008
63,63,08/30/2008,Missouri,52,37,226,45,26,323,1,1,Illinois,42,35,81,42,26,451,2,0,N,9,10,2,145,3,0,-128,-1,1,2008
64,64,08/30/2008,Navy,41,58,558,5,2,44,0,1,Towson,13,26,30,47,29,330,1,0,H, ,28,32,528,-42,-27,-286,-1,1,2008
65,65,08/30/2008,Nebraska,47,31,138,36,20,345,2,0,Western Michigan,24,25,8,49,30,342,1,1,H,14,23,6,130,-13,-10,3,1,-1,2008
66,66,08/30/2008,Nevada-Las Vegas,27,30,132,32,19,221,0,0,Utah State,17,37,111,33,18,203,1,1,H,12.5,10,-7,21,-1,1,18,-1,-1,2008
67,67,08/30/2008,Nevada-Reno,49,53,426,32,18,203,1,2,Grambling,13,40,5,27,13,225,2,0,H, ,36,13,421,5,5,-22,-1,2,2008
68,68,08/30/2008,New Mexico,3,32,56,24,7,130,2,1,Texas Christian,26,48,171,26,16,120,1,0,H,-6.5,-23,-16,-115,-2,-9,10,1,1,2008
69,69,08/30/2008,North Carolina,35,29,163,26,15,221,1,1,McNeese State,27,46,152,32,18,239,1,1,H, ,8,-17,11,-6,-3,-18,0,0,2008
70,70,08/30/2008,North Texas,6,26,105,29,16,100,0,0,Kansas State,45,36,165,42,27,306,1,1,V,-27,-39,-10,-60,-13,-11,-206,-1,-1,2008
71,71,08/30/2008,Northern Illinois,27,31,72,30,17,326,0,1,Minnesota,31,31,127,37,24,298,0,1,V,-8,-4,0,-55,-7,-7,28,0,0,2008
72,72,08/30/2008,Northwestern,30,42,269,35,23,215,1,1,Syracuse,10,30,122,28,14,103,1,0,H,12,20,12,147,7,9,112,0,1,2008
73,73,08/30/2008,Ohio,20,21,39,41,29,248,1,1,Wyoming,21,40,160,22,14,111,2,0,V,-13.5,-1,-19,-121,19,15,137,-1,1,2008
74,74,08/30/2008,Ohio State,43,43,251,31,21,244,0,1,Youngstown State,0,21,-11,18,12,85,0,1,H, ,43,22,262,13,9,159,0,0,2008
75,75,08/30/2008,Oklahoma,57,46,182,38,31,305,1,0,Chattanooga,2,36,16,17,3,20,0,0,H, ,55,10,166,21,28,285,1,0,2008
76,76,08/30/2008,Oklahoma State,39,42,174,27,20,193,1,0,Washington State,13,34,114,25,12,82,1,0,N,7,26,8,60,2,8,111,0,0,2008
77,77,08/30/2008,Oregon,44,44,256,28,16,240,1,0,Washington,10,43,95,35,17,147,0,1,H,13.5,34,1,161,-7,-1,93,1,-1,2008
78,78,08/30/2008,Penn State,66,43,334,26,19,260,0,0,Coastal Carolina,10,32,52,31,18,198,1,0,H, ,56,11,282,-5,1,62,-1,0,2008
79,79,08/30/2008,Pittsburgh,17,35,129,51,29,264,1,3,Bowling Green,27,28,64,42,26,190,1,0,H,13.5,-10,7,65,9,3,74,0,3,2008
80,80,08/30/2008,San Diego State,27,23,27,45,27,352,2,3,Cal-San Luis Obispo,29,51,263,21,12,220,0,1,H, ,-2,-28,-236,24,15,132,2,2,2008
81,81,08/30/2008,San Jose State,13,24,42,34,26,231,2,1,UC-Davis,10,30,61,34,21,193,2,1,H, ,3,-6,-19,0,5,38,0,0,2008
82,82,08/30/2008,South Florida,56,52,300,19,14,220,1,3,Tennessee-Martin,7,28,59,26,9,38,1,0,H, ,49,24,241,-7,5,182,0,3,2008
83,83,08/30/2008,Southern Cal,52,41,218,37,27,340,1,1,Virginia,7,21,32,35,18,155,1,3,V,19.5,45,20,186,2,9,185,0,-2,2008
84,84,08/30/2008,Southern Miss,51,61,427,22,14,206,2,0,UL-Lafayette,21,43,263,24,11,131,2,2,H,10,30,18,164,-2,3,75,0,-2,2008
85,85,08/30/2008,Syracuse,10,30,122,28,14,103,1,0,Northwestern,30,42,269,35,23,215,1,1,V,-12,-20,-12,-147,-7,-9,-112,0,-1,2008
86,86,08/30/2008,Texas,52,46,232,35,28,271,0,0,Florida Atlantic,10,23,37,39,17,255,1,1,H,24,42,23,195,-4,11,16,-1,-1,2008
87,87,08/30/2008,Texas A+M,14,36,133,27,19,170,2,2,Arkansas State,18,45,255,28,15,160,0,1,H,18.5,-4,-9,-122,-1,4,10,2,1,2008
88,88,08/30/2008,Texas Christian,26,48,171,26,16,120,1,0,New Mexico,3,32,56,24,7,130,2,1,V,6.5,23,16,115,2,9,-10,-1,-1,2008
89,89,08/30/2008,Texas Tech,49,25,103,58,43,536,1,1,Eastern Washington,24,22,23,63,38,341,3,0,H, ,25,3,80,-5,5,195,-2,1,2008
90,90,08/30/2008,Tulsa,45,38,240,25,21,361,0,0,U-A-B,22,36,245,31,17,169,1,2,V,13.5,23,2,-5,-6,4,192,-1,-2,2008
91,91,08/30/2008,U-A-B,22,36,245,31,17,169,1,2,Tulsa,45,38,240,25,21,361,0,0,H,-13.5,-23,-2,5,6,-4,-192,1,2,2008
92,92,08/30/2008,U-C-F,17,59,228,16,9,90,0,1,So Carolina State,0,23,52,21,11,74,1,1,H, ,17,36,176,-5,-2,16,-1,0,2008
93,93,08/30/2008,UL-Lafayette,21,43,263,24,11,131,2,2,Southern Miss,51,61,427,22,14,206,2,0,V,-10,-30,-18,-164,2,-3,-75,0,2,2008
94,94,08/30/2008,UL-Monroe,0,30,84,38,20,136,0,2,Auburn,34,46,321,27,13,85,1,0,V,-26,-34,-16,-237,11,7,51,-1,2,2008
95,95,08/30/2008,Utah,25,43,36,34,21,305,1,2,Michigan,23,25,36,38,19,167,1,2,V,-3,2,18,0,-4,2,138,0,0,2008
96,96,08/30/2008,Utah State,17,37,111,33,18,203,1,1,Nevada-Las Vegas,27,30,132,32,19,221,0,0,V,-12.5,-10,7,-21,1,-1,-18,1,1,2008
97,97,08/30/2008,Virginia,7,21,32,35,18,155,1,3,Southern Cal,52,41,218,37,27,340,1,1,H,-19.5,-45,-20,-186,-2,-9,-185,0,2,2008
98,98,08/30/2008,Virginia Tech,22,35,104,23,14,139,2,0,East Carolina,27,41,158,25,19,211,0,2,N,9,-5,-6,-54,-2,-5,-72,2,-2,2008
99,99,08/30/2008,Washington,10,43,95,35,17,147,0,1,Oregon,44,44,256,28,16,240,1,0,V,-13.5,-34,-1,-161,7,1,-93,-1,1,2008
100,100,08/30/2008,Washington State,13,34,114,25,12,82,1,0,Oklahoma State,39,42,174,27,20,193,1,0,N,-7,-26,-8,-60,-2,-8,-111,0,0,2008
101,101,08/30/2008,West Virginia,48,22,149,34,26,205,1,0,Villanova,21,50,133,37,21,266,2,1,H, ,27,-28,16,-3,5,-61,-1,-1,2008
102,102,08/30/2008,Western Kentucky,13,31,63,31,19,219,0,1,Indiana,31,41,297,30,18,153,1,0,V,-19,-18,-10,-234,1,1,66,-1,1,2008
103,103,08/30/2008,Western Michigan,24,25,8,49,30,342,1,1,Nebraska,47,31,138,36,20,345,2,0,V,-14,-23,-6,-130,13,10,-3,-1,1,2008
104,104,08/30/2008,Wisconsin,38,63,404,10,7,75,1,2,Akron,17,22,70,37,22,227,0,1,H,26.5,21,41,334,-27,-15,-152,1,1,2008
105,105,08/30/2008,Wyoming,21,40,160,22,14,111,2,0,Ohio,20,21,39,41,29,248,1,1,H,13.5,1,19,121,-19,-15,-137,1,-1,2008
106,106,08/31/2008,Colorado,38,36,153,29,20,214,1,1,Colorado State,17,26,71,38,27,187,2,0,N,11.5,21,10,82,-9,-7,27,-1,1,2008
107,107,08/31/2008,Colorado State,17,26,71,38,27,187,2,0,Colorado,38,36,153,29,20,214,1,1,N,-11.5,-21,-10,-82,9,7,-27,1,-1,2008
108,108,08/31/2008,Kentucky,27,33,63,31,16,147,0,1,Louisville,2,29,53,43,20,152,3,2,V,-3.5,25,4,10,-12,-4,-5,-3,-1,2008
109,109,08/31/2008,Louisville,2,29,53,43,20,152,3,2,Kentucky,27,33,63,31,16,147,0,1,H,3.5,-25,-4,-10,12,4,5,3,1,2008
110,110,09/01/2008,Fresno State,24,39,206,24,11,216,0,0,Rutgers,7,34,106,39,20,263,2,0,V,-3,17,5,100,-15,-9,-47,-2,0,2008
111,111,09/01/2008,Rutgers,7,34,106,39,20,263,2,0,Fresno State,24,39,206,24,11,216,0,0,H,3,-17,-5,-100,15,9,47,2,0,2008
112,112,09/01/2008,Tennessee,24,34,177,42,19,189,1,1,U.C.L.A.,27,31,29,43,25,259,4,0,V,7.5,-3,3,148,-1,-6,-70,-3,1,2008
113,113,09/01/2008,U.C.L.A.,27,31,29,43,25,259,4,0,Tennessee,24,34,177,42,19,189,1,1,H,-7.5,3,-3,-148,1,6,70,3,-1,2008
114,114,09/04/2008,South Carolina,17,29,92,39,23,233,2,1,Vanderbilt,24,41,135,13,8,90,0,1,V,9.5,-7,-12,-43,26,15,143,2,0,2008
115,115,09/04/2008,Vanderbilt,24,41,135,13,8,90,0,1,South Carolina,17,29,92,39,23,233,2,1,H,-9.5,7,12,43,-26,-15,-143,-2,0,2008
116,116,09/05/2008,Ball State,35,29,162,28,21,326,2,0,Navy,23,59,346,11,6,67,1,0,H,7,12,-30,-184,17,15,259,1,0,2008
117,117,09/05/2008,Navy,23,59,346,11,6,67,1,0,Ball State,35,29,162,28,21,326,2,0,V,-7,-12,30,184,-17,-15,-259,-1,0,2008
118,118,09/06/2008,Air Force,23,63,261,4,3,15,1,0,Wyoming,3,33,140,22,8,76,1,4,V,-3,20,30,121,-18,-5,-61,0,-4,2008
119,119,09/06/2008,Akron,42,46,218,26,20,260,1,0,Syracuse,28,43,218,20,13,135,1,1,V,-4.5,14,3,0,6,7,125,0,-1,2008
120,120,09/06/2008,Alabama,20,26,99,23,11,73,0,1,Tulane,6,32,86,50,29,232,0,0,H,29.5,14,-6,13,-27,-18,-159,0,1,2008
121,121,09/06/2008,Arizona,41,33,153,34,26,299,0,1,Toledo,16,24,74,31,21,170,0,0,H,23.5,25,9,79,3,5,129,0,1,2008
122,122,09/06/2008,Arizona State,41,36,127,36,27,345,1,1,Stanford,17,30,113,31,14,120,3,0,H,14.5,24,6,14,5,13,225,-2,1,2008
123,123,09/06/2008,Arkansas,28,36,183,34,22,323,0,0,UL-Monroe,27,26,71,40,23,270,0,0,H,14,1,10,112,-6,-1,53,0,0,2008
124,124,09/06/2008,Arkansas State,83,44,441,10,9,229,0,1,Texas Southern,10,39,95,31,10,128,2,3,H, ,73,5,346,-21,-1,101,-2,-2,2008
125,125,09/06/2008,Army,10,55,169,11,7,95,0,4,New Hampshire,28,38,184,17,12,138,1,1,H, ,-18,17,-15,-6,-5,-43,-1,3,2008
126,126,09/06/2008,Auburn,27,41,132,34,21,248,1,3,Southern Miss,13,27,37,50,33,268,2,1,H,19.5,14,14,95,-16,-12,-20,-1,2,2008
127,127,09/06/2008,Baylor,51,39,207,26,20,330,0,1,Northwestern St(LA),6,37,52,33,18,138,1,1,H, ,45,2,155,-7,2,192,-1,0,2008
128,128,09/06/2008,Boston College,16,41,120,36,18,142,2,1,Georgia Tech,19,40,162,13,6,73,0,3,H,6.5,-3,1,-42,23,12,69,2,-2,2008
129,129,09/06/2008,Bowling Green,17,26,128,45,29,261,1,4,Minnesota,42,45,164,25,21,233,0,0,H,5,-25,-19,-36,20,8,28,1,4,2008
130,130,09/06/2008,Brigham Young,28,27,142,41,30,338,1,1,Washington,27,35,133,32,17,204,0,0,V,8,1,-8,9,9,13,134,1,1,2008
131,131,09/06/2008,Buffalo,16,32,125,34,21,223,1,0,Pittsburgh,27,31,111,34,22,241,1,0,V,-13.5,-11,1,14,0,-1,-18,0,0,2008
132,132,09/06/2008,California,66,40,391,24,14,114,0,1,Washington State,3,35,57,30,13,110,4,0,V,13.5,63,5,334,-6,1,4,-4,1,2008
133,133,09/06/2008,Central Michigan,17,22,59,44,23,250,1,0,Georgia,56,36,263,33,23,289,0,1,V,-24,-39,-14,-204,11,0,-39,1,-1,2008
134,134,09/06/2008,Cincinnati,26,29,87,42,22,239,2,0,Oklahoma,52,44,197,38,29,395,2,0,V,-22.5,-26,-15,-110,4,-7,-156,0,0,2008
135,135,09/06/2008,Clemson,45,34,252,29,21,273,0,2,The Citadel,17,26,89,40,25,338,3,0,H, ,28,8,163,-11,-4,-65,-3,2,2008
136,136,09/06/2008,Colorado,31,33,90,39,28,261,1,1,Eastern Washington,24,22,47,51,32,303,2,1,H, ,7,11,43,-12,-4,-42,-1,0,2008
137,137,09/06/2008,Colorado State,23,29,95,33,21,321,1,0,Sacramento State,20,32,105,26,15,205,0,1,H, ,3,-3,-10,7,6,116,1,-1,2008
138,138,09/06/2008,Connecticut,12,55,293,22,10,86,1,1,Temple,9,34,128,28,11,170,2,0,V,6.5,3,21,165,-6,-1,-84,-1,1,2008
139,139,09/06/2008,Duke,20,44,178,47,29,294,0,1,Northwestern,24,27,77,33,15,251,0,0,H,-6.5,-4,17,101,14,14,43,0,1,2008
140,140,09/06/2008,East Carolina,24,42,143,29,23,243,0,0,West Virginia,3,36,179,18,11,72,0,2,H,-7.5,21,6,-36,11,12,171,0,-2,2008
141,141,09/06/2008,Eastern Michigan,10,28,127,31,14,215,0,0,Michigan State,42,52,238,16,11,180,0,1,V,-21,-32,-24,-111,15,3,35,0,-1,2008
142,142,09/06/2008,Florida,26,27,89,35,21,256,0,0,Miami-Florida,3,37,61,22,12,79,0,0,H,23,23,-10,28,13,9,177,0,0,2008
143,143,09/06/2008,Florida Atlantic,49,25,196,35,22,358,0,1,U-A-B,34,35,156,48,26,326,0,0,H,14,15,-10,40,-13,-4,32,0,1,2008
144,144,09/06/2008,Florida Intl,0,27,56,36,19,162,2,1,Iowa,42,41,241,25,17,271,1,1,V,-27,-42,-14,-185,11,2,-109,1,0,2008
145,145,09/06/2008,Florida State,69,32,290,25,17,271,0,0,Western Carolina,0,33,57,25,10,119,0,1,H, ,69,-1,233,0,7,152,0,-1,2008
146,146,09/06/2008,Georgia,56,36,263,33,23,289,0,1,Central Michigan,17,22,59,44,23,250,1,0,H,24,39,14,204,-11,0,39,-1,1,2008
147,147,09/06/2008,Georgia Tech,19,40,162,13,6,73,0,3,Boston College,16,41,120,36,18,142,2,1,V,-6.5,3,-1,42,-23,-12,-69,-2,2,2008
148,148,09/06/2008,Hawaii,36,34,133,34,20,305,0,2,Weber State,17,26,-20,40,24,233,2,0,H, ,19,8,153,-6,-4,72,-2,2,2008
149,149,09/06/2008,Houston,37,22,96,62,35,387,0,1,Oklahoma State,56,51,379,21,14,320,2,1,V,-15.5,-19,-29,-283,41,21,67,-2,0,2008
150,150,09/06/2008,Idaho,42,41,235,13,8,170,0,0,Idaho State,27,22,75,66,36,308,4,0,H, ,15,19,160,-53,-28,-138,-4,0,2008
151,151,09/06/2008,Illinois,47,53,399,27,17,134,2,3,Eastern Illinois,21,37,176,17,7,102,2,1,H, ,26,16,223,10,10,32,0,2,2008
152,152,09/06/2008,Indiana,45,53,254,28,21,222,0,1,Murray State,3,27,28,28,19,121,1,2,H, ,42,26,226,0,2,101,-1,-1,2008
153,153,09/06/2008,Iowa,42,41,241,25,17,271,1,1,Florida Intl,0,27,56,36,19,162,2,1,H,27,42,14,185,-11,-2,109,-1,0,2008
154,154,09/06/2008,Iowa State,48,45,160,21,15,214,0,1,Kent State,28,43,243,24,11,167,0,4,H,8,20,2,-83,-3,4,47,0,-3,2008
155,155,09/06/2008,Kansas,29,33,126,38,32,412,0,0,Louisiana Tech,0,27,148,33,12,119,1,0,H,22,29,6,-22,5,20,293,-1,0,2008
156,156,09/06/2008,Kansas State,69,43,177,23,17,304,0,0,Montana State,10,36,83,35,17,108,2,2,H, ,59,7,94,-12,0,196,-2,-2,2008
157,157,09/06/2008,Kent State,28,43,243,24,11,167,0,4,Iowa State,48,45,160,21,15,214,0,1,V,-8,-20,-2,83,3,-4,-47,0,3,2008
158,158,09/06/2008,Kentucky,38,44,297,26,15,147,1,1,Norfolk State,3,29,67,24,9,97,1,0,H, ,35,15,230,2,6,50,0,1,2008
159,159,09/06/2008,Louisiana Tech,0,27,148,33,12,119,1,0,Kansas,29,33,126,38,32,412,0,0,V,-22,-29,-6,22,-5,-20,-293,1,0,2008
160,160,09/06/2008,Louisville,51,43,234,26,17,217,0,2,Tennessee Tech,10,22,33,33,20,143,2,2,H, ,41,21,201,-7,-3,74,-2,0,2008
161,161,09/06/2008,Marshall,14,29,75,46,24,239,3,0,Wisconsin,51,40,158,27,18,329,0,1,V,-21,-37,-11,-83,19,6,-90,3,-1,2008
162,162,09/06/2008,Maryland,14,25,146,29,14,211,3,0,Middle Tennessee,24,41,118,41,29,284,0,1,V,12.5,-10,-16,28,-12,-15,-73,3,-1,2008
163,163,09/06/2008,Memphis,35,37,150,39,29,373,2,0,Rice,42,27,112,44,26,318,2,0,H,3,-7,10,38,-5,3,55,0,0,2008
164,164,09/06/2008,Miami-Florida,3,37,61,22,12,79,0,0,Florida,26,27,89,35,21,256,0,0,V,-23,-23,10,-28,-13,-9,-177,0,0,2008
165,165,09/06/2008,Miami-Ohio,6,32,47,40,23,205,0,1,Michigan,16,35,178,18,10,103,0,0,V,-14.5,-10,-3,-131,22,13,102,0,1,2008
166,166,09/06/2008,Michigan,16,35,178,18,10,103,0,0,Miami-Ohio,6,32,47,40,23,205,0,1,H,14.5,10,3,131,-22,-13,-102,0,-1,2008
167,167,09/06/2008,Michigan State,42,52,238,16,11,180,0,1,Eastern Michigan,10,28,127,31,14,215,0,0,H,21,32,24,111,-15,-3,-35,0,1,2008
168,168,09/06/2008,Middle Tennessee,24,41,118,41,29,284,0,1,Maryland,14,25,146,29,14,211,3,0,H,-12.5,10,16,-28,12,15,73,-3,1,2008
169,169,09/06/2008,Minnesota,42,45,164,25,21,233,0,0,Bowling Green,17,26,128,45,29,261,1,4,V,-5,25,19,36,-20,-8,-28,-1,-4,2008
170,170,09/06/2008,Mississippi,28,29,107,33,20,253,2,1,Wake Forest,30,31,81,43,32,267,0,1,V,-7,-2,-2,26,-10,-12,-14,2,0,2008
171,171,09/06/2008,Mississippi State,34,46,216,27,18,185,0,2,S E Louisiana,10,27,33,20,7,115,0,1,H, ,24,19,183,7,11,70,0,1,2008
172,172,09/06/2008,Missouri,52,36,256,33,26,336,0,0,S E Missouri St,3,28,84,53,26,250,1,1,H, ,49,8,172,-20,0,86,-1,-1,2008
173,173,09/06/2008,Nebraska,35,30,99,27,18,216,1,1,San Jose State,12,34,137,33,19,216,2,0,H,26.5,23,-4,-38,-6,-1,0,-1,1,2008
174,174,09/06/2008,Nevada-Las Vegas,21,35,129,30,19,159,0,0,Utah,42,36,225,25,16,215,1,0,V,-21.5,-21,-1,-96,5,3,-56,-1,0,2008
175,175,09/06/2008,Nevada-Reno,19,47,224,35,24,264,1,1,Texas Tech,35,22,124,46,19,297,2,0,H,-10,-16,25,100,-11,5,-33,-1,1,2008
176,176,09/06/2008,New Mexico,22,38,216,38,22,154,2,2,Texas A+M,28,39,92,24,13,144,0,1,H,-2,-6,-1,124,14,9,10,2,1,2008
177,177,09/06/2008,No Carolina State,34,30,67,36,21,258,2,0,William + Mary,24,33,115,37,19,188,2,2,H, ,10,-3,-48,-1,2,70,0,-2,2008
178,178,09/06/2008,North Texas,26,34,203,45,30,247,0,2,Tulsa,56,35,135,35,27,420,0,0,H,-22,-30,-1,68,10,3,-173,0,2,2008
179,179,09/06/2008,Northern Illinois,26,44,142,33,18,297,1,1,Western Michigan,29,32,198,30,21,186,0,2,V,-6,-3,12,-56,3,-3,111,1,-1,2008
180,180,09/06/2008,Northwestern,24,27,77,33,15,251,0,0,Duke,20,44,178,47,29,294,0,1,V,6.5,4,-17,-101,-14,-14,-43,0,-1,2008
181,181,09/06/2008,Notre Dame,21,34,105,34,21,237,2,2,San Diego State,13,15,71,59,29,274,1,1,H,21.5,8,19,34,-25,-8,-37,1,1,2008
182,182,09/06/2008,Ohio,14,31,145,34,12,109,4,1,Ohio State,26,40,162,28,16,110,0,1,V,-34.5,-12,-9,-17,6,-4,-1,4,0,2008
183,183,09/06/2008,Ohio State,26,40,162,28,16,110,0,1,Ohio,14,31,145,34,12,109,4,1,H,34.5,12,9,17,-6,4,1,-4,0,2008
184,184,09/06/2008,Oklahoma,52,44,197,38,29,395,2,0,Cincinnati,26,29,87,42,22,239,2,0,H,22.5,26,15,110,-4,7,156,0,0,2008
185,185,09/06/2008,Oklahoma State,56,51,379,21,14,320,2,1,Houston,37,22,96,62,35,387,0,1,H,15.5,19,29,283,-41,-21,-67,2,0,2008
186,186,09/06/2008,Oregon,66,53,408,35,24,280,1,1,Utah State,24,31,88,35,23,218,0,0,H,36,42,22,320,0,1,62,1,1,2008
187,187,09/06/2008,Oregon State,14,32,92,41,25,250,2,0,Penn State,45,38,239,27,14,215,0,1,V,-15,-31,-6,-147,14,11,35,2,-1,2008
188,188,09/06/2008,Penn State,45,38,239,27,14,215,0,1,Oregon State,14,32,92,41,25,250,2,0,H,15,31,6,147,-14,-11,-35,-2,1,2008
189,189,09/06/2008,Pittsburgh,27,31,111,34,22,241,1,0,Buffalo,16,32,125,34,21,223,1,0,H,13.5,11,-1,-14,0,1,18,0,0,2008
190,190,09/06/2008,Purdue,42,26,116,28,15,286,0,1,Northern Colorado,10,37,122,42,27,216,0,0,H, ,32,-11,-6,-14,-12,70,0,1,2008
191,191,09/06/2008,Rice,42,27,112,44,26,318,2,0,Memphis,35,37,150,39,29,373,2,0,V,-3,7,-10,-38,5,-3,-55,0,0,2008
192,192,09/06/2008,S-M-U,47,17,61,37,24,370,0,0,Texas State,36,47,233,31,20,232,2,3,H, ,11,-30,-172,6,4,138,-2,-3,2008
193,193,09/06/2008,San Diego State,13,15,71,59,29,274,1,1,Notre Dame,21,34,105,34,21,237,2,2,V,-21.5,-8,-19,-34,25,8,37,-1,-1,2008
194,194,09/06/2008,San Jose State,12,34,137,33,19,216,2,0,Nebraska,35,30,99,27,18,216,1,1,V,-26.5,-23,4,38,6,1,0,1,-1,2008
195,195,09/06/2008,South Florida,31,44,158,41,23,346,2,0,U-C-F,24,28,76,32,17,150,0,0,V,13.5,7,16,82,9,6,196,2,0,2008
196,196,09/06/2008,Southern Miss,13,27,37,50,33,268,2,1,Auburn,27,41,132,34,21,248,1,3,V,-19.5,-14,-14,-95,16,12,20,1,-2,2008
197,197,09/06/2008,Stanford,17,30,113,31,14,120,3,0,Arizona State,41,36,127,36,27,345,1,1,V,-14.5,-24,-6,-14,-5,-13,-225,2,-1,2008
198,198,09/06/2008,Syracuse,28,43,218,20,13,135,1,1,Akron,42,46,218,26,20,260,1,0,H,4.5,-14,-3,0,-6,-7,-125,0,1,2008
199,199,09/06/2008,Temple,9,34,128,28,11,170,2,0,Connecticut,12,55,293,22,10,86,1,1,H,-6.5,-3,-21,-165,6,1,84,1,-1,2008
200,200,09/06/2008,Texas,42,31,122,29,20,282,1,0,UTEP,13,31,145,46,25,267,0,1,V,26.5,29,0,-23,-17,-5,15,1,-1,2008
201,201,09/06/2008,Texas A+M,28,39,92,24,13,144,0,1,New Mexico,22,38,216,38,22,154,2,2,V,2,6,1,-124,-14,-9,-10,-2,-1,2008
202,202,09/06/2008,Texas Christian,67,58,320,24,17,205,0,0,Stephen F Austin,7,17,3,40,21,140,3,1,H, ,60,41,317,-16,-4,65,-3,-1,2008
203,203,09/06/2008,Texas Tech,35,22,124,46,19,297,2,0,Nevada-Reno,19,47,224,35,24,264,1,1,V,10,16,-25,-100,11,-5,33,1,-1,2008
204,204,09/06/2008,Toledo,16,24,74,31,21,170,0,0,Arizona,41,33,153,34,26,299,0,1,V,-23.5,-25,-9,-79,-3,-5,-129,0,-1,2008
205,205,09/06/2008,Tulane,6,32,86,50,29,232,0,0,Alabama,20,26,99,23,11,73,0,1,V,-29.5,-14,6,-13,27,18,159,0,-1,2008
206,206,09/06/2008,Tulsa,56,35,135,35,27,420,0,0,North Texas,26,34,203,45,30,247,0,2,V,22,30,1,-68,-10,-3,173,0,-2,2008
207,207,09/06/2008,U-A-B,34,35,156,48,26,326,0,0,Florida Atlantic,49,25,196,35,22,358,0,1,V,-14,-15,10,-40,13,4,-32,0,-1,2008
208,208,09/06/2008,U-C-F,24,28,76,32,17,150,0,0,South Florida,31,44,158,41,23,346,2,0,H,-13.5,-7,-16,-82,-9,-6,-196,-2,0,2008
209,209,09/06/2008,UL-Monroe,27,26,71,40,23,270,0,0,Arkansas,28,36,183,34,22,323,0,0,V,-14,-1,-10,-112,6,1,-53,0,0,2008
210,210,09/06/2008,UTEP,13,31,145,46,25,267,0,1,Texas,42,31,122,29,20,282,1,0,H,-26.5,-29,0,23,17,5,-15,-1,1,2008
211,211,09/06/2008,Utah,42,36,225,25,16,215,1,0,Nevada-Las Vegas,21,35,129,30,19,159,0,0,H,21.5,21,1,96,-5,-3,56,1,0,2008
212,212,09/06/2008,Utah State,24,31,88,35,23,218,0,0,Oregon,66,53,408,35,24,280,1,1,V,-36,-42,-22,-320,0,-1,-62,-1,-1,2008
213,213,09/06/2008,Virginia,16,38,91,39,21,204,2,0,Richmond,0,26,9,35,17,185,2,1,H, ,16,12,82,4,4,19,0,-1,2008
214,214,09/06/2008,Virginia Tech,24,48,261,13,7,68,1,0,Furman,7,20,34,37,21,213,1,1,H, ,17,28,227,-24,-14,-145,0,-1,2008
215,215,09/06/2008,Wake Forest,30,31,81,43,32,267,0,1,Mississippi,28,29,107,33,20,253,2,1,H,7,2,2,-26,10,12,14,-2,0,2008
216,216,09/06/2008,Washington,27,35,133,32,17,204,0,0,Brigham Young,28,28,137,41,30,338,1,1,H,-8,-1,7,-4,-9,-13,-134,-1,-1,2008
217,217,09/06/2008,Washington State,3,35,57,30,13,110,4,0,California,66,40,391,24,14,114,0,1,H,-13.5,-63,-5,-334,6,-1,-4,4,-1,2008
218,218,09/06/2008,West Virginia,3,36,179,18,11,72,0,2,East Carolina,24,42,143,29,23,243,0,0,V,7.5,-21,-6,36,-11,-12,-171,0,2,2008
219,219,09/06/2008,Western Kentucky,37,60,248,25,14,134,0,0,Eastern Kentucky,13,15,20,40,24,228,0,1,V, ,24,45,228,-15,-10,-94,0,-1,2008
220,220,09/06/2008,Western Michigan,29,32,198,30,21,186,0,2,Northern Illinois,26,44,142,33,18,297,1,1,H,6,3,-12,56,-3,3,-111,-1,1,2008
221,221,09/06/2008,Wisconsin,51,40,158,27,18,329,0,1,Marshall,14,29,75,46,24,239,3,0,H,21,37,11,83,-19,-6,90,-3,1,2008
222,222,09/06/2008,Wyoming,3,33,140,22,8,76,1,4,Air Force,23,63,261,4,3,15,1,0,H,3,-20,-30,-121,18,5,61,0,4,2008
223,223,09/11/2008,North Carolina,44,38,157,23,14,221,0,0,Rutgers,12,29,140,43,25,243,4,0,V,-6,32,9,17,-20,-11,-22,-4,0,2008
224,224,09/11/2008,Rutgers,12,29,140,43,25,243,4,0,North Carolina,44,38,157,23,14,221,0,0,H,6,-32,-9,-17,20,11,22,4,0,2008
225,225,09/12/2008,Baylor,45,42,426,16,7,129,0,0,Washington State,17,39,77,38,23,263,2,3,H,6.5,28,3,349,-22,-16,-134,-2,-3,2008
226,226,09/12/2008,Kansas,34,21,61,51,34,373,1,0,South Florida,37,29,120,45,32,338,0,0,V,-4.5,-3,-8,-59,6,2,35,1,0,2008
227,227,09/12/2008,South Florida,37,29,120,45,32,338,0,0,Kansas,34,21,61,51,34,373,1,0,H,4.5,3,8,59,-6,-2,-35,-1,0,2008
228,228,09/12/2008,UL-Monroe,37,40,244,27,15,211,0,0,Alabama A+M,15,28,67,30,17,266,0,3,H, ,22,12,177,-3,-2,-55,0,-3,2008
229,229,09/12/2008,Washington State,17,39,77,38,23,263,2,3,Baylor,45,42,426,16,7,129,0,0,V,-6.5,-28,-3,-349,22,16,134,2,3,2008
230,230,09/13/2008,Air Force,31,71,380,7,0,0,0,0,Houston,28,28,172,57,34,362,1,1,N,-4,3,43,208,-50,-34,-362,-1,-1,2008
231,231,09/13/2008,Akron,24,28,119,45,22,299,4,1,Ball State,41,44,191,36,24,300,1,1,H,-7,-17,-16,-72,9,-2,-1,3,0,2008
232,232,09/13/2008,Alabama,41,49,281,33,21,276,1,1,Western Kentucky,7,22,42,26,14,116,1,1,H,28,34,27,239,7,7,160,0,0,2008
233,233,09/13/2008,Arizona,28,24,67,50,27,321,2,3,New Mexico,36,47,221,18,14,114,1,0,V,10.5,-8,-23,-154,32,13,207,1,3,2008
234,234,09/13/2008,Arizona State,20,36,131,23,13,242,1,0,Nevada-Las Vegas,23,37,135,36,22,210,0,0,H,23.5,-3,-1,-4,-13,-9,32,1,0,2008
235,235,09/13/2008,Arkansas State,24,35,191,35,17,256,1,1,Southern Miss,27,41,129,31,18,219,0,1,H,2.5,-3,-6,62,4,-1,37,1,0,2008
236,236,09/13/2008,Auburn,3,45,161,26,14,154,0,3,Mississippi State,2,30,38,25,10,78,1,0,V,10,1,15,123,1,4,76,-1,3,2008
237,237,09/13/2008,Ball State,41,44,191,36,24,300,1,1,Akron,24,28,119,45,22,299,4,1,V,7,17,16,72,-9,2,1,-3,0,2008
238,238,09/13/2008,Boise State,20,33,160,23,18,180,0,1,Bowling Green,7,36,103,36,22,204,1,2,H,16.5,13,-3,57,-13,-4,-24,-1,-1,2008
239,239,09/13/2008,Bowling Green,7,36,103,36,22,204,1,2,Boise State,20,33,160,23,18,180,0,1,V,-16.5,-13,3,-57,13,4,24,1,1,2008
240,240,09/13/2008,Brigham Young,59,45,184,40,31,337,1,0,U.C.L.A.,0,16,9,39,23,230,1,3,H,7.5,59,29,175,1,8,107,0,-3,2008
241,241,09/13/2008,Buffalo,30,31,101,42,29,348,1,1,Temple,28,27,104,33,24,285,0,1,H,6.5,2,4,-3,9,5,63,1,0,2008
242,242,09/13/2008,California,27,23,38,60,33,423,1,0,Maryland,35,47,141,20,15,156,0,2,V,14.5,-8,-24,-103,40,18,267,1,-2,2008
243,243,09/13/2008,Central Michigan,31,33,70,42,28,361,0,0,Ohio,28,35,148,33,17,365,0,2,V,3,3,-2,-78,9,11,-4,0,-2,2008
244,244,09/13/2008,Clemson,27,29,166,28,20,262,1,1,No Carolina State,9,39,136,30,15,152,2,0,H,18.5,18,-10,30,-2,5,110,-1,1,2008
245,245,09/13/2008,Connecticut,45,53,382,15,13,124,0,0,Virginia,10,14,31,38,25,188,2,0,H,11,35,39,351,-23,-12,-64,-2,0,2008
246,246,09/13/2008,Duke,41,34,79,36,25,317,0,1,Navy,31,46,207,10,8,150,1,1,H,2,10,-12,-128,26,17,167,-1,0,2008
247,247,09/13/2008,East Carolina,28,30,56,32,22,260,1,3,Tulane,24,37,76,37,21,236,2,0,V,13,4,-7,-20,-5,1,24,-1,3,2008
248,248,09/13/2008,Eastern Michigan,17,47,134,23,13,131,2,3,Toledo,41,36,233,18,8,114,1,2,H,2,-24,11,-99,5,5,17,1,1,2008
249,249,09/13/2008,Florida Atlantic,0,27,82,34,8,143,0,2,Michigan State,17,58,259,15,5,88,1,1,V,-17,-17,-31,-177,19,3,55,-1,1,2008
250,250,09/13/2008,Florida State,46,32,197,36,22,297,0,1,Chattanooga,7,31,29,18,10,135,0,1,H, ,39,1,168,18,12,162,0,0,2008
251,251,09/13/2008,Fresno State,10,33,118,27,15,225,1,1,Wisconsin,13,39,154,26,13,150,0,0,H,-2,-3,-6,-36,1,2,75,1,1,2008
252,252,09/13/2008,Georgia,14,35,106,25,15,146,0,0,South Carolina,7,16,18,40,23,271,1,1,V,7.5,7,19,88,-15,-8,-125,-1,-1,2008
253,253,09/13/2008,Georgia Tech,17,50,278,9,5,109,1,2,Virginia Tech,20,46,199,15,9,48,0,0,V,-6.5,-3,4,79,-6,-4,61,1,2,2008
254,254,09/13/2008,Hawaii,7,20,57,35,16,154,3,0,Oregon State,45,50,217,36,20,268,0,0,V,-13,-38,-30,-160,-1,-4,-114,3,0,2008
255,255,09/13/2008,Houston,28,28,172,57,34,362,1,1,Air Force,31,71,380,7,0,0,0,0,N,4,-3,-43,-208,50,34,362,1,1,2008
256,256,09/13/2008,Idaho,28,42,121,39,25,334,1,1,Western Michigan,51,25,175,31,23,241,0,0,H,-8,-23,17,-54,8,2,93,1,1,2008
257,257,09/13/2008,Illinois,20,44,194,25,13,147,1,0,UL-Lafayette,17,34,87,35,25,200,0,2,H,25.5,3,10,107,-10,-12,-53,1,-2,2008
258,258,09/13/2008,Iowa,17,31,122,19,9,122,2,0,Iowa State,5,27,73,40,24,252,3,0,H,13.5,12,4,49,-21,-15,-130,-1,0,2008
259,259,09/13/2008,Iowa State,5,27,73,40,24,252,3,0,Iowa,17,31,122,19,9,122,2,0,V,-13.5,-12,-4,-49,21,15,130,1,0,2008
260,260,09/13/2008,Kent State,24,44,215,25,13,178,2,1,Delaware State,3,30,99,39,24,247,1,0,H, ,21,14,116,-14,-11,-69,1,1,2008
261,261,09/13/2008,Kentucky,20,35,102,48,28,254,0,1,Middle Tennessee,14,23,31,37,21,352,1,1,H,17.5,6,12,71,11,7,-98,-1,0,2008
262,262,09/13/2008,Louisiana State,41,28,216,36,20,209,1,0,North Texas,3,18,44,43,23,155,1,0,H,41.5,38,10,172,-7,-3,54,0,0,2008
263,263,09/13/2008,Marshall,17,33,179,29,14,224,0,0,Memphis,16,29,94,54,29,368,0,1,H,4,1,4,85,-25,-15,-144,0,-1,2008
264,264,09/13/2008,Maryland,35,47,141,20,15,156,0,2,California,27,23,38,60,33,423,1,0,H,-14.5,8,24,103,-40,-18,-267,-1,2,2008
265,265,09/13/2008,Memphis,16,29,94,54,29,368,0,1,Marshall,17,33,179,29,14,224,0,0,V,-4,-1,-4,-85,25,15,144,0,1,2008
266,266,09/13/2008,Miami-Ohio,38,38,102,30,19,305,1,2,Charleston Southern,27,29,71,40,26,257,2,1,H, ,11,9,31,-10,-7,48,-1,1,2008
267,267,09/13/2008,Michigan,17,42,159,28,19,229,2,4,Notre Dame,35,34,113,21,10,147,2,0,V,2,-18,8,46,7,9,82,0,4,2008
268,268,09/13/2008,Michigan State,17,58,259,15,5,88,1,1,Florida Atlantic,0,27,82,34,8,143,0,2,H,17,17,31,177,-19,-3,-55,1,-1,2008
269,269,09/13/2008,Middle Tennessee,14,23,31,37,21,352,1,1,Kentucky,20,35,102,48,28,254,0,1,V,-17.5,-6,-12,-71,-11,-7,98,1,0,2008
270,270,09/13/2008,Minnesota,35,39,151,24,15,201,0,0,Montana State,23,39,138,39,16,218,3,0,H, ,12,0,13,-15,-1,-17,-3,0,2008
271,271,09/13/2008,Mississippi,34,37,196,25,14,228,2,0,Samford,10,41,74,25,16,124,0,0,H, ,24,-4,122,0,-2,104,2,0,2008
272,272,09/13/2008,Mississippi State,2,30,38,25,10,78,1,0,Auburn,3,45,161,26,14,154,0,3,H,-10,-1,-15,-123,-1,-4,-76,1,-3,2008
273,273,09/13/2008,Missouri,69,29,132,36,27,519,0,0,Nevada-Reno,17,44,182,40,21,180,1,0,H,26.5,52,-15,-50,-4,6,339,-1,0,2008
274,274,09/13/2008,Navy,31,46,207,10,8,150,1,1,Duke,41,34,79,36,25,317,0,1,V,-2,-10,12,128,-26,-17,-167,1,0,2008
275,275,09/13/2008,Nebraska,38,44,330,24,18,223,0,1,New Mexico State,7,30,88,41,21,251,2,0,H,25.5,31,14,242,-17,-3,-28,-2,1,2008
276,276,09/13/2008,Nevada-Las Vegas,23,37,135,36,22,210,0,0,Arizona State,20,36,131,23,13,242,1,0,V,-23.5,3,1,4,13,9,-32,-1,0,2008
277,277,09/13/2008,Nevada-Reno,17,44,182,39,20,180,1,0,Missouri,69,29,132,36,27,519,0,0,V,-26.5,-52,15,50,3,-7,-339,1,0,2008
278,278,09/13/2008,New Mexico,36,47,221,18,14,114,1,0,Arizona,28,24,67,50,27,321,2,4,H,-10.5,8,23,154,-32,-13,-207,-1,-4,2008
279,279,09/13/2008,New Mexico State,7,32,114,39,19,225,2,0,Nebraska,38,44,330,24,18,223,0,1,V,-25.5,-31,-12,-216,15,1,2,2,-1,2008
280,280,09/13/2008,No Carolina State,9,39,136,29,15,152,2,0,Clemson,27,29,166,28,20,262,1,1,V,-18.5,-18,10,-30,1,-5,-110,1,-1,2008
281,281,09/13/2008,North Texas,3,18,44,43,23,155,1,0,Louisiana State,41,28,216,36,20,209,1,0,V,-41.5,-38,-10,-172,7,3,-54,0,0,2008
282,282,09/13/2008,Northwestern,33,34,148,31,22,185,0,0,Southern Illinois,7,32,85,32,19,178,0,0,H, ,26,2,63,-1,3,7,0,0,2008
283,283,09/13/2008,Notre Dame,35,34,113,21,10,147,2,0,Michigan,17,42,159,28,19,229,2,4,H,-2,18,-8,-46,-7,-9,-82,0,-4,2008
284,284,09/13/2008,Ohio,28,35,148,33,17,365,0,2,Central Michigan,31,33,70,42,28,361,0,0,H,-3,-3,2,78,-9,-11,4,0,2,2008
285,285,09/13/2008,Ohio State,3,34,71,30,21,136,2,1,Southern Cal,35,32,164,30,18,184,1,0,V,-11.5,-32,2,-93,0,3,-48,1,1,2008
286,286,09/13/2008,Oklahoma,55,47,274,24,19,317,0,0,Washington,14,34,87,38,23,249,0,3,V,21,41,13,187,-14,-4,68,0,-3,2008
287,287,09/13/2008,Oklahoma State,57,56,450,10,5,122,0,1,Missouri State,13,48,173,18,4,23,0,1,H, ,44,8,277,-8,1,99,0,0,2008
288,288,09/13/2008,Oregon,32,43,306,48,20,197,2,2,Purdue,26,45,201,50,26,207,2,1,V,8,6,-2,105,-2,-6,-10,0,1,2008
289,289,09/13/2008,Oregon State,45,50,217,36,20,268,0,0,Hawaii,7,20,57,35,16,154,3,0,H,13,38,30,160,1,4,114,-3,0,2008
290,290,09/13/2008,Penn State,55,43,216,39,20,344,0,2,Syracuse,13,25,49,35,13,110,1,1,V,28,42,18,167,4,7,234,-1,1,2008
291,291,09/13/2008,Purdue,26,45,201,50,26,207,2,1,Oregon,32,43,306,48,20,197,2,2,H,-8,-6,2,-105,2,6,10,0,-1,2008
292,292,09/13/2008,Rice,21,34,108,40,25,299,1,1,Vanderbilt,38,43,273,16,7,71,0,0,V,-8.5,-17,-9,-165,24,18,228,1,1,2008
293,293,09/13/2008,S-M-U,7,23,61,37,18,213,5,0,Texas Tech,43,27,180,55,37,513,0,1,V,-36,-36,-4,-119,-18,-19,-300,5,-1,2008
294,294,09/13/2008,San Diego State,10,17,6,29,10,140,0,1,San Jose State,35,55,293,27,21,183,1,0,V,-6,-25,-38,-287,2,-11,-43,-1,1,2008
295,295,09/13/2008,San Jose State,35,53,267,29,23,209,1,0,San Diego State,10,17,6,29,10,140,0,1,H,6,25,36,261,0,13,69,1,-1,2008
296,296,09/13/2008,South Carolina,7,16,18,40,23,271,1,1,Georgia,14,35,106,25,15,146,0,0,H,-7.5,-7,-19,-88,15,8,125,1,1,2008
297,297,09/13/2008,Southern Cal,35,32,164,30,18,184,1,0,Ohio State,3,34,71,30,21,136,2,1,H,11.5,32,-2,93,0,-3,48,-1,-1,2008
298,298,09/13/2008,Southern Miss,27,41,129,31,18,219,0,1,Arkansas State,24,35,191,35,17,256,1,1,V,-2.5,3,6,-62,-4,1,-37,-1,0,2008
299,299,09/13/2008,Stanford,14,29,71,21,11,122,1,2,Texas Christian,31,53,233,36,20,145,0,0,V,-14,-17,-24,-162,-15,-9,-23,1,2,2008
300,300,09/13/2008,Syracuse,13,25,49,35,13,110,1,1,Penn State,55,43,216,39,20,344,0,2,H,-28,-42,-18,-167,-4,-7,-234,1,-1,2008
301,301,09/13/2008,Temple,28,27,104,33,24,285,0,1,Buffalo,30,31,101,42,29,348,1,1,V,-6.5,-2,-4,3,-9,-5,-63,-1,0,2008
302,302,09/13/2008,Tennessee,35,41,266,33,20,282,2,0,U-A-B,3,26,108,34,19,167,3,0,H,30.5,32,15,158,-1,1,115,-1,0,2008
303,303,09/13/2008,Texas Christian,31,53,233,36,20,145,0,0,Stanford,14,29,71,21,11,122,1,2,H,14,17,24,162,15,9,23,-1,-2,2008
304,304,09/13/2008,Texas Tech,43,27,180,55,37,513,0,1,S-M-U,7,23,61,36,17,213,5,0,H,36,36,4,119,19,20,300,-5,1,2008
305,305,09/13/2008,Toledo,41,36,233,18,8,114,1,2,Eastern Michigan,17,47,134,23,13,131,2,3,V,-2,24,-11,99,-5,-5,-17,-1,-1,2008
306,306,09/13/2008,Troy,65,50,315,57,37,421,2,2,Alcorn State,0,24,72,37,12,48,6,1,H, ,65,26,243,20,25,373,-4,1,2008
307,307,09/13/2008,Tulane,24,37,76,37,21,236,2,0,East Carolina,28,30,56,32,22,260,1,3,H,-13,-4,7,20,5,-1,-24,1,-3,2008
308,308,09/13/2008,U-A-B,3,26,108,34,19,167,3,0,Tennessee,35,41,266,33,20,282,2,0,V,-30.5,-32,-15,-158,1,-1,-115,1,0,2008
309,309,09/13/2008,U.C.L.A.,0,16,9,39,23,230,1,3,Brigham Young,59,45,184,40,31,337,1,0,V,-7.5,-59,-29,-175,-1,-8,-107,0,3,2008
310,310,09/13/2008,UL-Lafayette,17,34,87,35,25,200,0,2,Illinois,20,44,194,25,13,147,1,0,V,-25.5,-3,-10,-107,10,12,53,-1,2,2008
311,311,09/13/2008,Utah,58,48,233,32,23,213,1,2,Utah State,10,25,27,23,9,89,1,2,V,24,48,23,206,9,14,124,0,0,2008
312,312,09/13/2008,Utah State,10,25,27,23,9,89,1,2,Utah,58,48,233,32,23,213,1,2,H,-24,-48,-23,-206,-9,-14,-124,0,0,2008
313,313,09/13/2008,Vanderbilt,38,43,273,16,7,71,0,0,Rice,21,34,108,40,25,299,1,1,H,8.5,17,9,165,-24,-18,-228,-1,-1,2008
314,314,09/13/2008,Virginia,10,14,31,38,25,188,2,0,Connecticut,45,53,382,15,13,124,0,0,V,-11,-35,-39,-351,23,12,64,2,0,2008
315,315,09/13/2008,Virginia Tech,20,46,199,15,9,48,0,0,Georgia Tech,17,50,278,9,5,109,1,2,H,6.5,3,-4,-79,6,4,-61,-1,-2,2008
316,316,09/13/2008,Washington,14,34,87,38,23,249,0,3,Oklahoma,55,47,274,24,19,317,0,0,H,-21,-41,-13,-187,14,4,-68,0,3,2008
317,317,09/13/2008,Western Kentucky,7,22,42,26,14,116,1,1,Alabama,41,49,281,33,21,276,1,1,V,-28,-34,-27,-239,-7,-7,-160,0,0,2008
318,318,09/13/2008,Western Michigan,51,25,175,31,23,241,0,0,Idaho,28,42,121,39,25,334,1,1,V,8,23,-17,54,-8,-2,-93,-1,-1,2008
319,319,09/13/2008,Wisconsin,13,39,154,26,13,150,0,0,Fresno State,10,33,118,27,15,225,1,1,V,2,3,6,36,-1,-2,-75,-1,-1,2008
320,320,09/13/2008,Wyoming,16,41,176,17,11,90,0,1,North Dakota St,13,26,98,30,16,215,3,1,H, ,3,15,78,-13,-5,-125,-3,0,2008
321,321,09/17/2008,Kansas State,29,12,30,42,22,313,2,1,Louisville,38,55,303,33,22,274,0,0,V,6,-9,-43,-273,9,0,39,2,1,2008
322,322,09/17/2008,Louisville,38,55,303,33,22,274,0,0,Kansas State,29,12,30,42,22,313,2,1,H,-6,9,43,273,-9,0,-39,-2,-1,2008
323,323,09/18/2008,Colorado,17,45,187,33,22,179,1,1,West Virginia,14,52,311,15,10,43,0,1,H,-3,3,-7,-124,18,12,136,1,0,2008
324,324,09/18/2008,West Virginia,14,52,311,15,10,43,0,1,Colorado,17,45,187,33,22,179,1,1,V,3,-3,7,124,-18,-12,-136,-1,0,2008
325,325,09/19/2008,Baylor,28,43,169,25,14,208,0,0,Connecticut,31,46,225,23,13,125,2,0,V,-13,-3,-3,-56,2,1,83,-2,0,2008
326,326,09/19/2008,Connecticut,31,46,225,23,13,125,2,0,Baylor,28,43,169,25,14,208,0,0,H,13,3,3,56,-2,-1,-83,2,0,2008
327,327,09/20/2008,Air Force,23,42,53,13,7,138,2,0,Utah,30,53,197,24,16,243,1,2,H,-9.5,-7,-11,-144,-11,-9,-105,1,-2,2008
328,328,09/20/2008,Akron,22,37,153,25,14,204,0,1,Army,3,48,160,13,7,63,1,4,V,10,19,-11,-7,12,7,141,-1,-3,2008
329,329,09/20/2008,Alabama,49,35,328,15,6,74,1,0,Arkansas,14,31,92,46,24,217,4,0,V,9.5,35,4,236,-31,-18,-143,-3,0,2008
330,330,09/20/2008,Arizona,31,35,111,29,16,222,0,1,U.C.L.A.,10,28,115,31,15,81,0,1,V,3.5,21,7,-4,-2,1,141,0,0,2008
331,331,09/20/2008,Arizona State,10,19,4,36,23,208,0,1,Georgia,27,39,176,28,16,285,0,0,H,-7.5,-17,-20,-172,8,7,-77,0,1,2008
332,332,09/20/2008,Arkansas,14,31,92,46,24,217,4,0,Alabama,49,35,328,15,6,74,1,0,H,-9.5,-35,-4,-236,31,18,143,3,0,2008
333,333,09/20/2008,Arkansas State,31,34,148,31,17,292,0,0,Middle Tennessee,14,25,74,37,26,271,2,0,H,6.5,17,9,74,-6,-9,21,-2,0,2008
334,334,09/20/2008,Army,3,48,160,13,7,63,1,4,Akron,22,37,153,25,14,204,0,1,H,-10,-19,11,7,-12,-7,-141,1,3,2008
335,335,09/20/2008,Auburn,21,36,70,32,17,250,2,0,Louisiana State,26,38,178,29,14,220,1,0,H,-2.5,-5,-2,-108,3,3,30,1,0,2008
336,336,09/20/2008,Ball State,42,42,224,25,16,239,0,2,Indiana,20,48,256,25,11,159,2,0,V,-2,22,-6,-32,0,5,80,-2,2,2008
337,337,09/20/2008,Boise State,37,35,38,37,25,386,1,1,Oregon,32,52,227,32,16,237,3,1,V,-10,5,-17,-189,5,9,149,-2,0,2008
338,338,09/20/2008,Boston College,34,37,168,41,20,237,3,0,U-C-F,7,34,123,32,16,129,4,0,H,10,27,3,45,9,4,108,-1,0,2008
339,339,09/20/2008,Brigham Young,44,34,163,37,20,201,0,0,Wyoming,0,36,137,36,17,136,3,3,H,29,44,-2,26,1,3,65,-3,-3,2008
340,340,09/20/2008,Buffalo,21,35,49,40,22,237,1,1,Missouri,42,29,151,45,36,439,0,3,V,-32.5,-21,6,-102,-5,-14,-202,1,-2,2008
341,341,09/20/2008,Central Michigan,25,38,149,44,25,291,2,0,Purdue,32,29,83,36,27,261,1,1,V,-10,-7,9,66,8,-2,30,1,-1,2008
342,342,09/20/2008,Cincinnati,45,31,152,24,20,241,0,2,Miami-Ohio,20,30,66,44,28,235,1,0,H,12,25,1,86,-20,-8,6,-1,2,2008
343,343,09/20/2008,Clemson,54,46,189,31,22,227,2,0,So Carolina State,0,21,-10,35,22,162,3,1,H, ,54,25,199,-4,0,65,-1,-1,2008
344,344,09/20/2008,Colorado State,28,40,146,34,24,276,0,0,Houston,25,22,93,54,37,380,3,1,H,-6,3,18,53,-20,-13,-104,-3,-1,2008
345,345,09/20/2008,East Carolina,24,30,173,32,19,210,1,1,No Carolina State,30,34,127,39,24,257,1,1,V,7,-6,-4,46,-7,-5,-47,0,0,2008
346,346,09/20/2008,Eastern Michigan,24,39,171,40,26,282,3,0,Maryland,51,34,231,25,16,255,2,0,V,-21.5,-27,5,-60,15,10,27,1,0,2008
347,347,09/20/2008,Florida,30,39,147,15,8,96,0,0,Tennessee,6,31,96,28,18,162,1,2,V,7,24,8,51,-13,-10,-66,-1,-2,2008
348,348,09/20/2008,Florida Atlantic,3,25,101,39,20,175,4,0,Minnesota,37,40,206,24,19,235,1,0,V,-6.5,-34,-15,-105,15,1,-60,3,0,2008
349,349,09/20/2008,Florida Intl,9,34,72,21,11,117,1,0,South Florida,17,49,184,22,14,136,0,1,H,-29.5,-8,-15,-112,-1,-3,-19,1,-1,2008
350,350,09/20/2008,Florida State,3,28,102,36,12,118,5,2,Wake Forest,12,38,59,30,17,217,0,2,H,4,-9,-10,43,6,-5,-99,5,0,2008
351,351,09/20/2008,Fresno State,55,38,189,28,22,231,0,1,Toledo,54,46,297,43,24,301,0,1,V,6,1,-8,-108,-15,-2,-70,0,0,2008
352,352,09/20/2008,Georgia,27,39,176,28,16,285,0,0,Arizona State,10,19,4,36,23,208,0,1,V,7.5,17,20,172,-8,-7,77,0,-1,2008
353,353,09/20/2008,Georgia Tech,38,54,438,9,4,62,0,0,Mississippi State,7,30,108,50,31,299,2,2,H,7,31,24,330,-41,-27,-237,-2,-2,2008
354,354,09/20/2008,Houston,25,22,93,54,37,380,3,1,Colorado State,28,40,146,34,24,276,0,0,V,6,-3,-18,-53,20,13,104,3,1,2008
355,355,09/20/2008,Idaho,17,33,98,39,23,187,1,2,Utah State,42,43,370,23,14,224,1,1,V,-3.5,-25,-10,-272,16,9,-37,0,1,2008
356,356,09/20/2008,Indiana,20,48,256,25,11,159,2,0,Ball State,42,42,224,25,16,239,0,2,H,2,-22,6,32,0,-5,-80,2,-2,2008
357,357,09/20/2008,Iowa,20,41,154,34,19,203,0,1,Pittsburgh,21,37,130,25,11,129,1,1,V,-2,-1,4,24,9,8,74,-1,0,2008
358,358,09/20/2008,Iowa State,31,35,151,28,13,155,0,0,Nevada-Las Vegas,34,44,205,22,16,245,0,1,V,-1.5,-3,-9,-54,6,-3,-90,0,-1,2008
359,359,09/20/2008,Kansas,38,48,161,39,24,375,0,1,Sam Houston State,14,16,45,46,26,340,3,0,H, ,24,32,116,-7,-2,35,-3,1,2008
360,360,09/20/2008,Kent State,27,41,227,28,13,169,1,0,UL-Lafayette,44,52,414,22,15,253,0,2,V,-2,-17,-11,-187,6,-2,-84,1,-2,2008
361,361,09/20/2008,Louisiana State,26,38,178,29,14,220,1,0,Auburn,21,36,70,32,17,250,2,0,V,2.5,5,2,108,-3,-3,-30,-1,0,2008
362,362,09/20/2008,Louisiana Tech,41,50,249,27,15,196,1,2,S E Louisiana,26,21,63,60,33,377,0,2,H, ,15,29,186,-33,-18,-181,1,0,2008
363,363,09/20/2008,Marshall,34,42,201,25,16,228,0,1,Southern Miss,27,31,123,49,27,308,1,0,V,-7.5,7,11,78,-24,-11,-80,-1,1,2008
364,364,09/20/2008,Maryland,51,34,231,25,16,255,2,0,Eastern Michigan,24,39,171,40,26,282,3,0,H,21.5,27,-5,60,-15,-10,-27,-1,0,2008
365,365,09/20/2008,Memphis,31,54,276,31,16,173,0,0,Nicholls State,10,33,117,5,2,47,0,3,H, ,21,21,159,26,14,126,0,-3,2008
366,366,09/20/2008,Miami-Florida,41,28,159,29,20,239,1,0,Texas A+M,23,35,87,32,19,275,1,1,V,2.5,18,-7,72,-3,1,-36,0,-1,2008
367,367,09/20/2008,Miami-Ohio,20,30,66,44,28,235,1,0,Cincinnati,45,31,152,24,20,241,0,2,V,-12,-25,-1,-86,20,8,-6,1,-2,2008
368,368,09/20/2008,Michigan State,23,43,203,26,12,143,0,1,Notre Dame,7,22,16,41,24,242,2,1,H,9,16,21,187,-15,-12,-99,-2,0,2008
369,369,09/20/2008,Middle Tennessee,14,25,44,37,26,271,2,0,Arkansas State,31,34,148,31,17,292,0,0,V,-6.5,-17,-9,-104,6,9,-21,2,0,2008
370,370,09/20/2008,Minnesota,37,40,206,24,19,235,1,0,Florida Atlantic,3,25,101,39,20,175,4,0,H,6.5,34,15,105,-15,-1,60,-3,0,2008
371,371,09/20/2008,Mississippi,17,40,201,25,12,184,4,2,Vanderbilt,23,41,131,12,9,71,0,2,H,7,-6,-1,70,13,3,113,4,0,2008
372,372,09/20/2008,Mississippi State,7,30,108,50,31,299,2,2,Georgia Tech,38,54,438,9,4,62,0,0,V,-7,-31,-24,-330,41,27,237,2,2,2008
373,373,09/20/2008,Missouri,42,29,151,45,36,439,0,3,Buffalo,21,35,49,40,22,237,1,1,H,32.5,21,-6,102,5,14,202,-1,2,2008
374,374,09/20/2008,Navy,23,51,272,8,5,89,0,0,Rutgers,21,33,206,20,13,131,1,1,H,-6.5,2,18,66,-12,-8,-42,-1,-1,2008
375,375,09/20/2008,Nevada-Las Vegas,34,42,209,22,16,245,0,1,Iowa State,31,35,151,28,13,155,0,0,H,1.5,3,7,58,-6,3,90,0,1,2008
376,376,09/20/2008,New Mexico,14,37,126,25,18,190,4,0,Tulsa,56,37,137,39,24,469,2,1,V,-11,-42,0,-11,-14,-6,-279,2,-1,2008
377,377,09/20/2008,New Mexico State,34,25,37,39,29,329,2,2,UTEP,33,48,277,26,11,95,0,3,V,-7.5,1,-23,-240,13,18,234,2,-1,2008
378,378,09/20/2008,No Carolina State,30,34,127,39,24,257,1,1,East Carolina,24,30,173,32,19,210,1,1,H,-7,6,4,-46,7,5,47,0,0,2008
379,379,09/20/2008,North Carolina,17,32,103,26,14,204,2,2,Virginia Tech,20,42,127,22,12,141,2,0,H,4,-3,-10,-24,4,2,63,0,2,2008
380,380,09/20/2008,Northern Illinois,48,37,285,13,8,78,1,2,Indiana State,3,26,31,35,19,123,3,1,H, ,45,11,254,-22,-11,-45,-2,1,2008
381,381,09/20/2008,Northwestern,16,37,147,36,18,133,4,1,Ohio,8,28,4,44,27,228,2,2,H,10.5,8,9,143,-8,-9,-95,2,-1,2008
382,382,09/20/2008,Notre Dame,7,22,16,41,24,242,2,1,Michigan State,23,43,203,26,12,143,0,1,V,-9,-16,-21,-187,15,12,99,2,0,2008
383,383,09/20/2008,Ohio,8,28,4,44,27,228,2,2,Northwestern,16,37,147,36,18,133,4,1,V,-10.5,-8,-9,-143,8,9,95,-2,1,2008
384,384,09/20/2008,Ohio State,28,42,170,17,10,139,1,0,Troy,10,23,97,43,30,218,2,0,H,21,18,19,73,-26,-20,-79,-1,0,2008
385,385,09/20/2008,Oregon,32,52,227,32,16,237,3,1,Boise State,37,35,38,37,25,386,1,1,H,10,-5,17,189,-5,-9,-149,2,0,2008
386,386,09/20/2008,Penn State,45,45,303,31,18,243,1,1,Temple,3,28,16,32,17,122,3,0,H,28.5,42,17,287,-1,1,121,-2,1,2008
387,387,09/20/2008,Pittsburgh,21,37,130,25,11,129,1,1,Iowa,20,39,158,34,19,203,0,1,H,2,1,-2,-28,-9,-8,-74,1,0,2008
388,388,09/20/2008,Purdue,32,29,83,36,27,261,1,1,Central Michigan,25,38,149,44,25,291,2,0,H,10,7,-9,-66,-8,2,-30,-1,1,2008
389,389,09/20/2008,Rice,10,24,17,48,30,301,0,0,Texas,32,44,259,24,20,341,0,2,V,-28.5,-22,-20,-242,24,10,-40,0,-2,2008
390,390,09/20/2008,Rutgers,21,33,206,20,13,131,1,1,Navy,23,51,272,8,5,89,0,0,V,6.5,-2,-18,-66,12,8,42,1,1,2008
391,391,09/20/2008,S-M-U,7,12,-8,39,20,218,2,1,Texas Christian,48,47,271,29,19,227,0,0,H,-24.5,-41,-35,-279,10,1,-9,2,1,2008
392,392,09/20/2008,San Jose State,10,35,54,26,23,165,0,2,Stanford,23,36,204,28,13,159,1,1,V,-7,-13,-1,-150,-2,10,6,-1,1,2008
393,393,09/20/2008,South Carolina,23,42,172,34,23,204,2,1,Wofford,13,43,185,13,8,100,0,0,H, ,10,-1,-13,21,15,104,2,1,2008
394,394,09/20/2008,South Florida,17,49,184,22,14,136,0,1,Florida Intl,9,34,72,21,11,125,1,0,V,29.5,8,15,112,1,3,11,-1,1,2008
395,395,09/20/2008,Southern Miss,27,31,153,49,27,308,1,0,Marshall,34,42,201,25,16,228,0,1,H,7.5,-7,-11,-48,24,11,80,1,-1,2008
396,396,09/20/2008,Stanford,23,36,204,28,13,159,1,1,San Jose State,10,35,54,26,23,165,0,2,H,7,13,1,150,2,-10,-6,1,-1,2008
397,397,09/20/2008,Syracuse,30,42,271,17,14,167,0,1,Northeastern,21,24,90,37,23,293,2,1,H, ,9,18,181,-20,-9,-126,-2,0,2008
398,398,09/20/2008,Temple,3,28,16,32,17,122,3,0,Penn State,45,45,303,31,18,243,1,1,V,-28.5,-42,-17,-287,1,-1,-121,2,-1,2008
399,399,09/20/2008,Tennessee,6,31,96,28,18,162,1,2,Florida,30,39,147,15,8,96,0,0,H,-7,-24,-8,-51,13,10,66,1,2,2008
400,400,09/20/2008,Texas,32,44,259,24,20,341,0,2,Rice,10,24,17,48,30,301,0,0,H,28.5,22,20,242,-24,-10,40,0,2,2008
401,401,09/20/2008,Texas A+M,23,35,87,32,19,275,1,1,Miami-Florida,41,28,159,29,20,239,1,0,H,-2.5,-18,7,-72,3,-1,36,0,1,2008
402,402,09/20/2008,Texas Christian,48,47,271,29,19,227,0,0,S-M-U,7,12,-8,39,20,218,2,1,V,24.5,41,35,279,-10,-1,9,-2,-1,2008
403,403,09/20/2008,Texas Tech,56,25,179,43,31,359,0,1,Massachusetts,14,33,92,26,17,166,1,0,H, ,42,-8,87,17,14,193,-1,1,2008
404,404,09/20/2008,Toledo,54,46,297,43,24,301,0,1,Fresno State,55,38,189,28,22,231,0,1,H,-6,-1,8,108,15,2,70,0,0,2008
405,405,09/20/2008,Troy,10,23,97,43,30,218,2,0,Ohio State,28,42,170,17,10,139,1,0,V,-21,-18,-19,-73,26,20,79,1,0,2008
406,406,09/20/2008,Tulane,24,45,182,34,19,272,1,0,UL-Monroe,10,28,64,18,13,118,1,0,H,5,14,17,118,16,6,154,0,0,2008
407,407,09/20/2008,Tulsa,56,37,137,39,24,469,2,1,New Mexico,14,37,126,25,18,190,4,0,H,11,42,0,11,14,6,279,-2,1,2008
408,408,09/20/2008,U-A-B,45,37,248,22,14,238,0,0,Alabama State,10,25,17,33,25,259,1,1,H, ,35,12,231,-11,-11,-21,-1,-1,2008
409,409,09/20/2008,U-C-F,7,34,123,32,16,129,4,0,Boston College,34,37,168,41,20,237,3,0,V,-10,-27,-3,-45,-9,-4,-108,1,0,2008
410,410,09/20/2008,U.C.L.A.,10,28,115,31,15,81,0,1,Arizona,31,35,111,29,16,222,0,1,H,-3.5,-21,-7,4,2,-1,-141,0,0,2008
411,411,09/20/2008,UL-Lafayette,44,52,414,22,15,253,0,2,Kent State,27,41,227,28,13,169,1,0,H,2,17,11,187,-6,2,84,-1,2,2008
412,412,09/20/2008,UL-Monroe,10,28,64,18,13,118,1,0,Tulane,24,45,182,34,19,272,1,0,V,-5,-14,-17,-118,-16,-6,-154,0,0,2008
413,413,09/20/2008,UTEP,33,48,277,26,11,95,0,3,New Mexico State,34,25,37,39,29,329,2,2,H,7.5,-1,23,240,-13,-18,-234,-2,1,2008
414,414,09/20/2008,Utah,30,55,212,24,16,243,1,2,Air Force,23,42,53,13,7,138,2,0,V,9.5,7,13,159,11,9,105,-1,2,2008
415,415,09/20/2008,Utah State,42,45,356,23,14,224,1,1,Idaho,17,33,99,39,23,187,1,1,H,3.5,25,12,257,-16,-9,37,0,0,2008
416,416,09/20/2008,Vanderbilt,23,41,131,12,9,71,0,2,Mississippi,17,40,201,25,12,184,4,2,V,-7,6,1,-70,-13,-3,-113,-4,0,2008
417,417,09/20/2008,Virginia Tech,20,42,127,22,12,141,2,0,North Carolina,17,32,103,26,14,204,2,2,V,-4,3,10,24,-4,-2,-63,0,-2,2008
418,418,09/20/2008,Wake Forest,12,38,59,30,17,217,0,2,Florida State,3,28,102,36,12,118,5,2,V,-4,9,10,-43,-6,5,99,-5,0,2008
419,419,09/20/2008,Washington State,48,51,277,41,22,361,3,1,Portland State,9,11,8,49,20,238,2,1,H, ,39,40,269,-8,2,123,1,0,2008
420,420,09/20/2008,Western Kentucky,50,38,116,27,17,245,1,0,Murray State,9,20,11,42,26,228,4,0,H, ,41,18,105,-15,-9,17,-3,0,2008
421,421,09/20/2008,Western Michigan,41,39,274,38,31,359,1,0,Tennessee Tech,7,24,100,33,19,151,0,0,H, ,34,15,174,5,12,208,1,0,2008
422,422,09/20/2008,Wyoming,0,36,137,36,17,136,3,3,Brigham Young,44,34,163,37,20,201,0,0,V,-29,-44,2,-26,-1,-3,-65,3,3,2008
423,423,09/25/2008,Oregon State,27,45,176,28,18,167,0,0,Southern Cal,21,22,86,29,18,227,1,1,H,-24.5,6,23,90,-1,0,-60,-1,-1,2008
424,424,09/25/2008,S-M-U,27,13,55,44,21,256,2,0,Tulane,34,42,220,24,19,254,1,1,V,-17.5,-7,-29,-165,20,2,2,1,-1,2008
425,425,09/25/2008,Southern Cal,21,22,86,29,18,227,1,1,Oregon State,27,45,176,28,18,167,0,0,V,24.5,-6,-23,-90,1,0,60,1,1,2008
426,426,09/25/2008,Tulane,34,42,220,24,19,254,1,1,S-M-U,27,13,55,44,21,256,2,0,H,17.5,7,29,165,-20,-2,-2,-1,1,2008
427,427,09/26/2008,Connecticut,26,42,157,20,10,122,0,1,Louisville,21,41,261,30,17,247,2,1,V,-3.5,5,1,-104,-10,-7,-125,-2,0,2008
428,428,09/26/2008,Louisville,21,41,261,30,17,247,2,1,Connecticut,26,42,157,20,10,122,0,1,H,3.5,-5,-1,104,10,7,125,2,0,2008
429,429,09/27/2008,Akron,15,33,104,42,26,254,1,0,Cincinnati,17,31,104,38,24,322,0,2,H,-11,-2,2,0,4,2,-68,1,-2,2008
430,430,09/27/2008,Alabama,41,45,129,16,13,205,0,1,Georgia,30,16,50,43,24,274,1,1,V,-6.5,11,29,79,-27,-11,-69,-1,0,2008
431,431,09/27/2008,Arkansas,10,26,11,28,14,180,1,1,Texas,52,50,208,23,21,213,0,1,V,-27.5,-42,-24,-197,5,-7,-33,1,0,2008
432,432,09/27/2008,Arkansas State,17,40,179,23,11,173,1,1,Memphis,29,41,243,29,12,210,1,0,V,2,-12,-1,-64,-6,-1,-37,0,1,2008
433,433,09/27/2008,Army,17,65,280,5,1,4,0,1,Texas A+M,21,29,133,19,13,157,1,0,V,-27,-4,36,147,-14,-12,-153,-1,1,2008
434,434,09/27/2008,Auburn,14,38,97,29,18,129,1,0,Tennessee,12,33,124,24,8,67,0,1,H,6.5,2,5,-27,5,10,62,1,-1,2008
435,435,09/27/2008,Ball State,41,37,158,35,23,265,0,0,Kent State,20,35,176,24,13,177,1,0,H,21,21,2,-18,11,10,88,-1,0,2008
436,436,09/27/2008,Boston College,42,40,289,9,3,27,0,1,Rhode Island,0,29,53,44,28,214,4,1,H, ,42,11,236,-35,-25,-187,-4,0,2008
437,437,09/27/2008,Bowling Green,45,40,101,36,22,287,0,1,Wyoming,16,37,192,32,16,124,4,1,V,3,29,3,-91,4,6,163,-4,0,2008
438,438,09/27/2008,Buffalo,25,30,66,33,23,270,0,0,Central Michigan,27,39,208,26,21,152,0,1,V,-7,-2,-9,-142,7,2,118,0,-1,2008
439,439,09/27/2008,California,42,30,189,26,15,159,0,2,Colorado State,7,46,125,36,18,226,3,0,H,27.5,35,-16,64,-10,-3,-67,-3,2,2008
440,440,09/27/2008,Central Michigan,27,39,208,26,21,152,0,1,Buffalo,25,30,66,33,23,270,0,0,H,7,2,9,142,-7,-2,-118,0,1,2008
441,441,09/27/2008,Cincinnati,17,31,104,38,24,322,0,2,Akron,15,33,104,42,26,254,1,0,V,11,2,-2,0,-4,-2,68,-1,2,2008
442,442,09/27/2008,Clemson,17,41,221,22,15,151,1,2,Maryland,20,29,123,30,16,172,0,0,H,11,-3,12,98,-8,-1,-21,1,2,2008
443,443,09/27/2008,Colorado,21,37,124,36,17,154,1,1,Florida State,39,46,259,22,10,119,1,1,N,-6,-18,-9,-135,14,7,35,0,0,2008
444,444,09/27/2008,Colorado State,7,46,125,36,18,226,3,0,California,42,30,184,27,16,164,0,2,V,-27.5,-35,16,-59,9,2,62,3,-2,2008
445,445,09/27/2008,Duke,31,37,84,33,19,174,2,0,Virginia,3,33,110,42,19,194,4,2,H,7.5,28,4,-26,-9,0,-20,-2,-2,2008
446,446,09/27/2008,East Carolina,24,36,126,28,15,149,2,1,Houston,41,40,222,44,36,399,1,3,H,10.5,-17,-4,-96,-16,-21,-250,1,-2,2008
447,447,09/27/2008,Eastern Michigan,0,33,119,39,21,140,2,0,Northern Illinois,37,43,235,17,13,104,0,0,H,-5.5,-37,-10,-116,22,8,36,2,0,2008
448,448,09/27/2008,Florida,30,35,124,38,24,319,0,3,Mississippi,31,38,140,21,9,185,1,0,H,23.5,-1,-3,-16,17,15,134,-1,3,2008
449,449,09/27/2008,Florida Intl,35,45,141,13,6,98,0,0,Toledo,16,31,94,46,27,208,1,3,V,-18,19,14,47,-33,-21,-110,-1,-3,2008
450,450,09/27/2008,Florida State,39,46,259,22,10,119,1,1,Colorado,21,37,124,36,17,154,1,1,N,6,18,9,135,-14,-7,-35,0,0,2008
451,451,09/27/2008,Fresno State,36,40,207,31,21,236,1,0,U.C.L.A.,31,38,234,20,11,150,0,1,V,7,5,2,-27,11,10,86,1,-1,2008
452,452,09/27/2008,Georgia,30,16,50,43,24,274,1,1,Alabama,41,45,129,16,13,205,0,1,H,6.5,-11,-29,-79,27,11,69,1,0,2008
453,453,09/27/2008,Hawaii,17,29,131,36,21,225,4,2,San Jose State,20,39,85,28,14,152,0,0,H,3,-3,-10,46,8,7,73,4,2,2008
454,454,09/27/2008,Houston,41,40,217,45,37,404,1,3,East Carolina,24,36,126,28,15,149,2,1,V,-10.5,17,4,91,17,22,255,-1,2,2008
455,455,09/27/2008,Idaho,17,40,182,34,16,169,3,1,San Diego State,45,34,158,40,26,445,1,1,V,-12.5,-28,6,24,-6,-10,-276,2,0,2008
456,456,09/27/2008,Illinois,24,42,189,24,13,183,1,1,Penn State,38,44,241,20,14,181,0,1,V,-15,-14,-2,-52,4,-1,2,1,0,2008
457,457,09/27/2008,Indiana,29,28,189,44,23,284,2,1,Michigan State,42,52,236,26,14,261,0,0,H,-8,-13,-24,-47,18,9,23,2,1,2008
458,458,09/27/2008,Iowa,17,31,169,30,21,238,1,4,Northwestern,22,34,106,45,28,284,1,0,H,-8.5,-5,-3,63,-15,-7,-46,0,4,2008
459,459,09/27/2008,Kansas State,45,45,198,28,21,272,0,1,UL-Lafayette,37,51,335,29,16,174,0,0,H,21.5,8,-6,-137,-1,5,98,0,1,2008
460,460,09/27/2008,Kent State,20,35,176,24,13,177,1,0,Ball State,41,37,158,35,23,265,0,0,V,-21,-21,-2,18,-11,-10,-88,1,0,2008
461,461,09/27/2008,Kentucky,41,38,216,32,21,182,1,0,Western Kentucky,3,37,142,14,6,15,0,1,H,19,38,1,74,18,15,167,1,-1,2008
462,462,09/27/2008,Louisiana State,34,37,166,27,18,261,1,1,Mississippi State,24,31,110,26,17,175,0,0,H,24,10,6,56,1,1,86,1,1,2008
463,463,09/27/2008,Marshall,3,25,39,37,15,119,1,2,West Virginia,27,42,319,28,22,174,1,1,V,-15.5,-24,-17,-280,9,-7,-55,0,1,2008
464,464,09/27/2008,Maryland,20,29,123,30,16,172,0,0,Clemson,17,41,221,22,15,151,1,2,V,-11,3,-12,-98,8,1,21,-1,-2,2008
465,465,09/27/2008,Memphis,29,41,243,29,12,210,1,0,Arkansas State,17,40,179,23,11,173,1,1,H,-2,12,1,64,6,1,37,0,-1,2008
466,466,09/27/2008,Miami-Florida,24,33,135,33,22,174,2,0,North Carolina,28,33,35,24,13,264,0,0,H,7.5,-4,0,100,9,9,-90,2,0,2008
467,467,09/27/2008,Michigan,27,34,172,31,12,96,2,3,Wisconsin,25,44,158,37,20,226,2,2,H,-5,2,-10,14,-6,-8,-130,0,1,2008
468,468,09/27/2008,Michigan State,42,52,236,26,14,261,0,0,Indiana,29,28,189,44,23,284,2,1,V,8,13,24,47,-18,-9,-23,-2,-1,2008
469,469,09/27/2008,Minnesota,21,28,81,36,23,187,1,2,Ohio State,34,37,279,22,13,135,0,1,V,-20.5,-13,-9,-198,14,10,52,1,1,2008
470,470,09/27/2008,Mississippi,31,38,140,21,9,185,1,0,Florida,30,35,124,38,24,319,0,3,V,-23.5,1,3,16,-17,-15,-134,1,-3,2008
471,471,09/27/2008,Mississippi State,24,31,110,26,17,175,0,0,Louisiana State,34,37,166,27,18,261,1,1,V,-24,-10,-6,-56,-1,-1,-86,-1,-1,2008
472,472,09/27/2008,Navy,24,59,292,4,3,51,0,2,Wake Forest,17,31,43,40,26,270,4,2,V,-15.5,7,28,249,-36,-23,-219,-4,0,2008
473,473,09/27/2008,Nebraska,30,25,55,26,17,278,1,1,Virginia Tech,35,55,206,15,9,171,0,0,H,7,-5,-30,-151,11,8,107,1,1,2008
474,474,09/27/2008,Nevada-Las Vegas,27,23,54,38,18,327,1,1,Nevada-Reno,49,58,444,16,11,176,0,1,H,3.5,-22,-35,-390,22,7,151,1,0,2008
475,475,09/27/2008,Nevada-Reno,49,58,444,16,11,176,0,1,Nevada-Las Vegas,27,23,54,38,18,327,1,1,V,-3.5,22,35,390,-22,-7,-151,-1,0,2008
476,476,09/27/2008,New Mexico,35,63,297,16,7,55,1,0,New Mexico State,24,18,48,38,24,382,1,-1,V,3,11,45,249,-22,-17,-327,0,1,2008
477,477,09/27/2008,New Mexico State,24,18,48,38,24,382,1,0,New Mexico,35,63,297,16,7,55,1,0,H,-3,-11,-45,-249,22,17,327,0,0,2008
478,478,09/27/2008,No Carolina State,10,27,26,32,9,239,3,0,South Florida,41,48,245,33,21,275,0,0,H,-10.5,-31,-21,-219,-1,-12,-36,3,0,2008
479,479,09/27/2008,North Carolina,28,33,35,24,13,264,0,0,Miami-Florida,24,33,135,33,22,174,2,0,V,-7.5,4,0,-100,-9,-9,90,-2,0,2008
480,480,09/27/2008,North Texas,20,30,155,45,26,257,3,3,Rice,77,39,174,30,23,328,0,0,V,-15.5,-57,-9,-19,15,3,-71,3,3,2008
481,481,09/27/2008,Northern Illinois,37,43,235,17,13,104,0,0,Eastern Michigan,0,33,119,39,21,140,2,0,V,5.5,37,10,116,-22,-8,-36,-2,0,2008
482,482,09/27/2008,Northwestern,22,34,106,45,28,284,1,0,Iowa,17,31,169,30,21,238,1,4,V,8.5,5,3,-63,15,7,46,0,-4,2008
483,483,09/27/2008,Notre Dame,38,40,201,35,20,275,0,0,Purdue,21,17,103,55,29,359,1,0,H,1.5,17,23,98,-20,-9,-84,-1,0,2008
484,484,09/27/2008,Ohio,51,46,251,24,17,324,0,1,Virginia Military,31,56,339,10,3,97,1,1,H, ,20,-10,-88,14,14,227,-1,0,2008
485,485,09/27/2008,Ohio State,34,37,279,22,13,135,0,1,Minnesota,21,28,81,36,23,187,1,2,H,20.5,13,9,198,-14,-10,-52,-1,-1,2008
486,486,09/27/2008,Oklahoma,35,36,25,34,19,411,0,0,Texas Christian,10,35,102,41,16,212,2,2,H,18.5,25,1,-77,-7,3,199,-2,-2,2008
487,487,09/27/2008,Oklahoma State,55,62,358,21,16,254,0,0,Troy,24,23,144,49,27,272,2,1,H,17.5,31,39,214,-28,-11,-18,-2,-1,2008
488,488,09/27/2008,Oregon,63,53,346,19,9,161,0,0,Washington State,14,32,79,41,22,192,2,2,V,21.5,49,21,267,-22,-13,-31,-2,-2,2008
489,489,09/27/2008,Penn State,38,44,246,20,14,176,0,1,Illinois,24,42,189,24,13,183,1,1,H,15,14,2,57,-4,1,-7,-1,0,2008
490,490,09/27/2008,Pittsburgh,34,46,241,29,17,166,0,0,Syracuse,24,27,126,17,9,137,0,1,V,14,10,19,115,12,8,29,0,-1,2008
491,491,09/27/2008,Purdue,21,17,103,55,29,359,1,0,Notre Dame,38,40,201,35,20,275,0,0,V,-1.5,-17,-23,-98,20,9,84,1,0,2008
492,492,09/27/2008,Rice,77,39,174,30,23,328,0,0,North Texas,20,30,155,45,26,257,3,3,H,15.5,57,9,19,-15,-3,71,-3,-3,2008
493,493,09/27/2008,Rutgers,38,39,93,21,12,204,2,1,Morgan State,0,31,32,21,10,77,2,2,H, ,38,8,61,0,2,127,0,-1,2008
494,494,09/27/2008,San Diego State,45,35,158,40,26,445,1,1,Idaho,17,40,182,34,16,169,3,1,H,12.5,28,-5,-24,6,10,276,-2,0,2008
495,495,09/27/2008,San Jose State,20,39,85,28,14,152,0,0,Hawaii,17,29,131,36,21,225,4,2,V,-3,3,10,-46,-8,-7,-73,-4,-2,2008
496,496,09/27/2008,South Carolina,26,45,158,33,18,195,2,1,U-A-B,13,25,67,28,17,140,2,1,H,25.5,13,20,91,5,1,55,0,0,2008
497,497,09/27/2008,South Florida,41,48,245,33,21,275,0,0,No Carolina State,10,27,26,32,9,239,3,0,V,10.5,31,21,219,1,12,36,-3,0,2008
498,498,09/27/2008,Stanford,35,36,244,24,16,222,0,1,Washington,28,38,140,36,18,237,0,1,V,-3.5,7,-2,104,-12,-2,-15,0,0,2008
499,499,09/27/2008,Syracuse,24,27,126,17,9,137,0,1,Pittsburgh,34,46,241,29,17,166,0,0,H,-14,-10,-19,-115,-12,-8,-29,0,1,2008
500,500,09/27/2008,Temple,3,38,136,22,10,60,0,1,Western Michigan,7,26,41,42,26,247,1,1,H,-5,-4,12,95,-20,-16,-187,-1,0,2008
501,501,09/27/2008,Tennessee,12,33,124,24,8,67,0,1,Auburn,14,38,97,29,18,129,1,0,V,-6.5,-2,-5,27,-5,-10,-62,-1,1,2008
502,502,09/27/2008,Texas,52,50,208,23,21,213,0,1,Arkansas,10,26,11,28,14,180,1,1,H,27.5,42,24,197,-5,7,33,-1,0,2008
503,503,09/27/2008,Texas A+M,21,29,133,19,13,157,1,-1,Army,17,65,280,5,1,4,0,1,H,27,4,-36,-147,14,12,153,1,-2,2008
504,504,09/27/2008,Texas Christian,10,35,102,41,16,212,2,2,Oklahoma,35,36,25,34,19,411,0,0,V,-18.5,-25,-1,77,7,-3,-199,2,2,2008
505,505,09/27/2008,Toledo,16,31,94,46,27,208,1,3,Florida Intl,35,45,141,13,6,98,0,0,H,18,-19,-14,-47,33,21,110,1,3,2008
506,506,09/27/2008,Troy,24,23,144,49,27,272,2,1,Oklahoma State,55,62,358,21,16,254,0,0,V,-17.5,-31,-39,-214,28,11,18,2,1,2008
507,507,09/27/2008,Tulsa,62,42,329,27,20,312,2,0,Central Arkansas,34,35,93,34,24,342,0,0,H, ,28,7,236,-7,-4,-30,2,0,2008
508,508,09/27/2008,U-A-B,13,25,67,28,17,140,2,1,South Carolina,26,45,158,33,18,195,2,1,V,-25.5,-13,-20,-91,-5,-1,-55,0,0,2008
509,509,09/27/2008,U-C-F,13,39,175,34,14,161,2,4,UTEP,58,31,119,35,20,284,1,0,V,4,-45,8,56,-1,-6,-123,1,4,2008
510,510,09/27/2008,U.C.L.A.,31,38,234,20,11,150,0,1,Fresno State,36,40,207,31,21,236,1,0,H,-7,-5,-2,27,-11,-10,-86,-1,1,2008
511,511,09/27/2008,UL-Lafayette,37,51,335,29,16,174,0,0,Kansas State,45,45,198,28,21,272,0,1,V,-21.5,-8,6,137,1,-5,-98,0,-1,2008
512,512,09/27/2008,UTEP,58,31,119,35,20,284,1,0,U-C-F,13,39,175,34,14,161,2,4,H,-4,45,-8,-56,1,6,123,-1,-4,2008
513,513,09/27/2008,Utah,37,39,180,29,23,270,1,0,Weber State,21,23,56,38,24,303,0,2,H, ,16,16,124,-9,-1,-33,1,-2,2008
514,514,09/27/2008,Virginia,3,33,110,42,19,194,4,2,Duke,31,37,84,33,19,174,2,0,V,-7.5,-28,-4,26,9,0,20,2,2,2008
515,515,09/27/2008,Virginia Tech,35,55,206,15,9,171,0,0,Nebraska,30,25,55,26,17,278,1,1,V,-7,5,30,151,-11,-8,-107,-1,-1,2008
516,516,09/27/2008,Wake Forest,17,31,43,40,26,270,4,2,Navy,24,59,292,4,3,51,0,2,H,15.5,-7,-28,-249,36,23,219,4,0,2008
517,517,09/27/2008,Washington,28,38,140,36,18,237,0,1,Stanford,35,36,244,24,16,222,0,1,H,3.5,-7,2,-104,12,2,15,0,0,2008
518,518,09/27/2008,Washington State,14,32,79,41,22,192,2,2,Oregon,63,53,346,19,9,161,0,0,H,-21.5,-49,-21,-267,22,13,31,2,2,2008
519,519,09/27/2008,West Virginia,27,42,319,28,22,174,1,1,Marshall,3,25,39,37,15,119,1,2,H,15.5,24,17,280,-9,7,55,0,-1,2008
520,520,09/27/2008,Western Kentucky,3,37,142,14,6,15,0,1,Kentucky,41,38,216,32,21,182,1,0,V,-19,-38,-1,-74,-18,-15,-167,-1,1,2008
521,521,09/27/2008,Western Michigan,7,26,36,42,26,252,1,1,Temple,3,38,136,22,10,60,0,1,V,5,4,-12,-100,20,16,192,1,0,2008
522,522,09/27/2008,Wisconsin,25,44,158,37,20,226,2,2,Michigan,27,34,172,31,12,96,2,3,V,5,-2,10,-14,6,8,130,0,-1,2008
523,523,09/27/2008,Wyoming,16,36,195,32,16,124,4,1,Bowling Green,45,40,101,36,22,287,0,1,H,-3,-29,-4,94,-4,-6,-163,4,0,2008
524,524,09/30/2008,Florida Atlantic,13,42,155,27,16,208,2,2,Middle Tennessee,14,29,55,36,24,268,0,1,V,-2.5,-1,13,100,-9,-8,-60,2,1,2008
525,525,09/30/2008,Middle Tennessee,14,29,55,36,24,268,0,1,Florida Atlantic,13,42,155,27,16,208,2,2,H,2.5,1,-13,-100,9,8,60,-2,-1,2008
526,526,10/01/2008,Boise State,38,44,132,31,21,332,1,0,Louisiana Tech,3,36,118,30,9,202,1,0,H,24,35,8,14,1,12,130,0,0,2008
527,527,10/01/2008,Louisiana Tech,3,36,118,30,9,202,1,0,Boise State,38,44,132,31,21,332,1,0,V,-24,-35,-8,-14,-1,-12,-130,0,0,2008
528,528,10/02/2008,Memphis,33,36,192,30,19,244,2,0,U-A-B,30,36,220,25,14,235,0,2,V,3,3,0,-28,5,5,9,2,-2,2008
529,529,10/02/2008,Oregon State,28,32,92,31,21,313,0,1,Utah,31,38,136,31,17,201,1,1,V,-12,-3,-6,-44,0,4,112,-1,0,2008
530,530,10/02/2008,Pittsburgh,26,45,146,28,17,228,0,2,South Florida,21,35,116,21,11,129,1,0,V,-13.5,5,10,30,7,6,99,-1,2,2008
531,531,10/02/2008,South Florida,21,35,116,21,11,129,1,0,Pittsburgh,26,45,146,28,17,228,0,2,H,13.5,-5,-10,-30,-7,-6,-99,1,-2,2008
532,532,10/02/2008,U-A-B,30,36,220,25,14,235,0,2,Memphis,33,36,192,30,19,244,2,0,H,-3,-3,0,28,-5,-5,-9,-2,2,2008
533,533,10/02/2008,Utah,31,38,136,31,17,201,1,1,Oregon State,28,32,92,31,21,313,0,1,H,12,3,6,44,0,-4,-112,1,0,2008
534,534,10/03/2008,Brigham Young,34,30,103,37,23,303,2,0,Utah State,14,43,129,27,16,193,1,3,V,28.5,20,-13,-26,10,7,110,1,-3,2008
535,535,10/03/2008,Cincinnati,33,46,203,26,16,158,1,1,Marshall,10,31,90,37,17,178,3,0,V,3.5,23,15,113,-11,-1,-20,-2,1,2008
536,536,10/03/2008,Marshall,10,31,90,37,17,178,3,0,Cincinnati,33,46,203,26,16,158,1,1,H,-3.5,-23,-15,-113,11,1,20,2,-1,2008
537,537,10/03/2008,Utah State,14,43,129,27,16,193,1,3,Brigham Young,34,30,103,37,23,303,2,0,H,-28.5,-20,13,26,-10,-7,-110,-1,3,2008
538,538,10/04/2008,Air Force,27,56,227,21,12,184,0,2,Navy,33,56,206,2,1,38,0,2,H,4,-6,0,21,19,11,146,0,0,2008
539,539,10/04/2008,Akron,30,29,58,39,21,243,3,0,Kent State,27,58,256,31,17,157,0,2,V,3,3,-29,-198,8,4,86,3,-2,2008
540,540,10/04/2008,Alabama,17,49,282,17,7,106,1,2,Kentucky,14,20,35,42,20,241,1,1,H,15.5,3,29,247,-25,-13,-135,0,1,2008
541,541,10/04/2008,Arizona,48,51,256,21,17,193,0,0,Washington,14,28,63,28,12,181,1,1,H,24,34,23,193,-7,5,12,-1,-1,2008
542,542,10/04/2008,Arizona State,14,32,71,35,20,165,2,1,California,24,33,79,28,17,198,1,0,V,-8.5,-10,-1,-8,7,3,-33,1,1,2008
543,543,10/04/2008,Arkansas,7,25,141,38,24,220,1,1,Florida,38,38,278,29,19,236,1,0,H,-27,-31,-13,-137,9,5,-16,0,1,2008
544,544,10/04/2008,Army,44,44,291,5,4,43,0,0,Tulane,13,38,156,42,26,330,3,1,V,-20,31,6,135,-37,-22,-287,-3,-1,2008
545,545,10/04/2008,Auburn,13,44,110,22,10,98,1,0,Vanderbilt,14,32,106,31,16,157,1,0,V,4,-1,12,4,-9,-6,-59,0,0,2008
546,546,10/04/2008,Ball State,31,44,240,30,18,242,0,0,Toledo,0,19,14,31,21,143,1,0,V,7,31,25,226,-1,-3,99,-1,0,2008
547,547,10/04/2008,Baylor,17,41,194,26,11,75,0,0,Oklahoma,49,58,217,34,24,377,1,0,H,-24,-32,-17,-23,-8,-13,-302,-1,0,2008
548,548,10/04/2008,Boston College,38,30,150,51,34,428,1,2,No Carolina State,31,22,35,33,19,218,0,0,V,7.5,7,8,115,18,15,210,1,2,2008
549,549,10/04/2008,Bowling Green,21,29,94,34,27,297,0,0,Eastern Michigan,24,38,147,30,22,263,0,0,H,20.5,-3,-9,-53,4,5,34,0,0,2008
550,550,10/04/2008,California,24,33,79,28,17,198,1,0,Arizona State,14,32,71,35,20,165,2,1,H,8.5,10,1,8,-7,-3,33,-1,-1,2008
551,551,10/04/2008,Colorado,14,28,49,38,17,217,0,2,Texas,38,46,169,30,23,262,2,0,H,-12.5,-24,-18,-120,8,-6,-45,-2,2,2008
552,552,10/04/2008,Colorado State,41,44,216,21,15,294,0,1,Nevada-Las Vegas,28,33,174,26,14,173,1,1,H,1.5,13,11,42,-5,1,121,-1,0,2008
553,553,10/04/2008,Connecticut,12,40,168,44,24,210,3,0,North Carolina,38,33,146,16,9,117,1,0,V,-7.5,-26,7,22,28,15,93,2,0,2008
554,554,10/04/2008,Duke,0,20,35,29,15,97,1,0,Georgia Tech,27,59,224,14,9,230,0,1,V,-13,-27,-39,-189,15,6,-133,1,-1,2008
555,555,10/04/2008,Eastern Michigan,24,38,147,30,22,263,0,0,Bowling Green,21,29,94,34,27,297,0,0,V,-20.5,3,9,53,-4,-5,-34,0,0,2008
556,556,10/04/2008,Florida,38,38,278,29,19,236,1,0,Arkansas,7,25,141,38,24,220,1,1,V,27,31,13,137,-9,-5,16,0,-1,2008
557,557,10/04/2008,Florida Intl,42,39,110,20,12,237,0,0,North Texas,10,33,119,50,35,309,3,1,V,6,32,6,-9,-30,-23,-72,-3,-1,2008
558,558,10/04/2008,Florida State,41,54,281,31,14,159,2,2,Miami-Florida,39,14,51,49,21,205,3,0,V,-1.5,2,40,230,-18,-7,-46,-1,2,2008
559,559,10/04/2008,Fresno State,29,49,318,24,12,204,3,3,Hawaii,32,33,172,25,17,170,0,1,H,21,-3,16,146,-1,-5,34,3,2,2008
560,560,10/04/2008,Georgia Tech,27,59,224,14,9,230,0,1,Duke,0,20,35,29,15,97,1,0,H,13,27,39,189,-15,-6,133,-1,1,2008
561,561,10/04/2008,Hawaii,32,33,172,25,17,170,0,1,Fresno State,29,49,318,24,12,204,3,3,V,-21,3,-16,-146,1,5,-34,-3,-2,2008
562,562,10/04/2008,Idaho,14,28,24,47,22,292,1,0,Nevada-Reno,49,47,264,24,19,243,0,2,H,-24,-35,-19,-240,23,3,49,1,-2,2008
563,563,10/04/2008,Illinois,45,47,191,26,13,310,0,0,Michigan,20,35,69,35,18,250,0,2,V,-2.5,25,12,122,-9,-5,60,0,-2,2008
564,564,10/04/2008,Indiana,7,24,49,24,16,244,1,2,Minnesota,16,44,59,37,22,274,0,2,V,-6.5,-9,-20,-10,-13,-6,-30,1,0,2008
565,565,10/04/2008,Iowa,13,39,151,22,15,158,1,2,Michigan State,16,34,91,24,13,184,1,0,V,-6.5,-3,5,60,-2,2,-26,0,2,2008
566,566,10/04/2008,Iowa State,33,31,97,46,27,268,1,1,Kansas,35,39,117,26,18,319,1,3,H,-11,-2,-8,-20,20,9,-51,0,-2,2008
567,567,10/04/2008,Kansas,35,39,117,26,18,319,1,3,Iowa State,33,31,97,46,27,268,1,1,V,11,2,8,20,-20,-9,51,0,2,2008
568,568,10/04/2008,Kansas State,28,36,113,31,15,183,0,2,Texas Tech,58,30,136,60,42,490,1,0,H,-7,-30,6,-23,-29,-27,-307,-1,2,2008
569,569,10/04/2008,Kent State,27,58,256,31,17,157,0,2,Akron,30,29,58,39,21,243,3,0,H,-3,-3,29,198,-8,-4,-86,-3,2,2008
570,570,10/04/2008,Kentucky,14,20,35,42,20,241,1,1,Alabama,17,49,282,17,7,106,1,2,V,-15.5,-3,-29,-247,25,13,135,0,-1,2008
571,571,10/04/2008,Maryland,0,21,79,34,20,223,1,1,Virginia,31,41,201,34,25,226,0,0,V,13.5,-31,-20,-122,0,-5,-3,1,1,2008
572,572,10/04/2008,Miami-Florida,39,14,51,49,21,205,3,0,Florida State,41,54,281,31,14,159,2,2,H,1.5,-2,-40,-230,18,7,46,1,-2,2008
573,573,10/04/2008,Miami-Ohio,10,39,91,40,22,212,1,3,Temple,28,40,116,23,11,178,1,1,H,7,-18,-1,-25,17,11,34,0,2,2008
574,574,10/04/2008,Michigan,20,35,69,35,18,250,0,2,Illinois,45,47,191,26,13,310,0,0,H,2.5,-25,-12,-122,9,5,-60,0,2,2008
575,575,10/04/2008,Michigan State,16,34,91,24,13,184,1,0,Iowa,13,39,151,22,15,158,1,2,H,6.5,3,-5,-60,2,-2,26,0,-2,2008
576,576,10/04/2008,Minnesota,16,44,59,37,22,274,0,2,Indiana,7,24,49,24,16,244,1,2,H,6.5,9,20,10,13,6,30,-1,0,2008
577,577,10/04/2008,Mississippi,24,33,118,32,21,243,1,2,South Carolina,31,35,78,32,22,327,1,0,H,1.5,-7,-2,40,0,-1,-84,0,2,2008
578,578,10/04/2008,Missouri,52,34,201,24,19,261,0,0,Nebraska,17,35,79,38,26,290,1,1,V,10,35,-1,122,-14,-7,-29,-1,-1,2008
579,579,10/04/2008,Navy,33,56,206,2,1,38,0,2,Air Force,27,56,227,21,12,184,0,2,V,-4,6,0,-21,-19,-11,-146,0,0,2008
580,580,10/04/2008,Nebraska,17,35,79,38,26,290,1,1,Missouri,52,34,201,24,19,261,0,0,H,-10,-35,1,-122,14,7,29,1,1,2008
581,581,10/04/2008,Nevada-Las Vegas,28,33,174,26,14,173,1,1,Colorado State,41,44,216,21,15,294,0,1,V,-1.5,-13,-11,-42,5,-1,-121,1,0,2008
582,582,10/04/2008,Nevada-Reno,49,47,264,24,19,243,0,2,Idaho,14,28,24,47,22,292,1,0,V,24,35,19,240,-23,-3,-49,-1,2,2008
583,583,10/04/2008,New Mexico,24,48,317,21,8,33,0,0,Wyoming,0,44,130,19,9,71,1,2,H,11,24,4,187,2,-1,-38,-1,-2,2008
584,584,10/04/2008,New Mexico State,45,33,220,34,26,351,1,3,Alcorn State,10,24,-13,39,20,208,1,1,H, ,35,9,233,-5,6,143,0,2,2008
585,585,10/04/2008,No Carolina State,31,22,35,33,19,218,0,0,Boston College,38,30,150,51,34,428,1,2,H,-7.5,-7,-8,-115,-18,-15,-210,-1,-2,2008
586,586,10/04/2008,North Carolina,38,33,146,16,9,117,1,0,Connecticut,12,40,168,44,24,210,3,0,H,7.5,26,-7,-22,-28,-15,-93,-2,0,2008
587,587,10/04/2008,North Texas,10,33,119,50,35,309,3,1,Florida Intl,42,39,110,20,12,237,0,0,H,-6,-32,-6,9,30,23,72,3,1,2008
588,588,10/04/2008,Northern Illinois,9,34,72,26,14,118,1,0,Tennessee,13,32,69,18,10,156,0,2,V,-16.5,-4,2,3,8,4,-38,1,-2,2008
589,589,10/04/2008,Notre Dame,28,27,83,40,29,347,0,0,Stanford,21,37,161,28,18,182,3,1,H,6.5,7,-10,-78,12,11,165,-3,-1,2008
590,590,10/04/2008,Ohio,20,37,148,37,19,208,2,1,Western Michigan,41,28,156,38,24,347,1,2,V,-8.5,-21,9,-8,-1,-5,-139,1,-1,2008
591,591,10/04/2008,Ohio State,20,40,183,19,13,144,1,1,Wisconsin,17,39,179,25,13,147,1,1,V,1.5,3,1,4,-6,0,-3,0,0,2008
592,592,10/04/2008,Oklahoma,49,58,217,34,24,377,1,0,Baylor,17,41,194,26,11,75,0,0,V,24,32,17,23,8,13,302,1,0,2008
593,593,10/04/2008,Oklahoma State,56,46,215,14,10,186,0,1,Texas A+M,28,30,184,43,24,218,2,3,H,26,28,16,31,-29,-14,-32,-2,-2,2008
594,594,10/04/2008,Oregon,10,39,60,33,20,179,1,1,Southern Cal,44,39,155,36,24,443,1,1,V,-15.5,-34,0,-95,-3,-4,-264,0,0,2008
595,595,10/04/2008,Penn State,20,40,202,26,18,220,0,0,Purdue,6,33,83,27,16,158,1,0,V,14,14,7,119,-1,2,62,-1,0,2008
596,596,10/04/2008,Purdue,6,33,83,27,16,158,1,0,Penn State,20,40,202,26,18,220,0,0,H,-14,-14,-7,-119,1,-2,-62,1,0,2008
597,597,10/04/2008,Rice,28,35,103,46,25,350,1,3,Tulsa,63,53,386,26,14,191,1,0,V,-16.5,-35,-18,-283,20,11,159,0,3,2008
598,598,10/04/2008,Rutgers,17,26,72,33,15,198,0,0,West Virginia,24,50,175,19,14,158,0,0,V,-14,-7,-24,-103,14,1,40,0,0,2008
599,599,10/04/2008,S-M-U,17,21,25,45,29,351,3,1,U-C-F,31,38,154,17,9,126,0,1,V,-13,-14,-17,-129,28,20,225,3,0,2008
600,600,10/04/2008,San Diego State,7,15,-13,26,10,98,0,1,Texas Christian,41,71,383,19,10,115,0,1,V,-24.5,-34,-56,-396,7,0,-17,0,0,2008
601,601,10/04/2008,South Carolina,31,35,78,32,22,327,1,0,Mississippi,24,33,118,32,21,243,1,2,V,-1.5,7,2,-40,0,1,84,0,-2,2008
602,602,10/04/2008,Southern Cal,44,39,155,36,24,443,1,1,Oregon,10,39,60,33,20,179,1,1,H,15.5,34,0,95,3,4,264,0,0,2008
603,603,10/04/2008,Southern Miss,37,45,277,37,21,264,1,0,UTEP,40,32,116,44,25,266,0,0,H,7.5,-3,13,161,-7,-4,-2,1,0,2008
604,604,10/04/2008,Stanford,21,37,161,28,18,182,3,1,Notre Dame,28,27,83,40,29,347,0,0,V,-6.5,-7,10,78,-12,-11,-165,3,1,2008
605,605,10/04/2008,Temple,28,40,116,23,11,178,1,1,Miami-Ohio,10,39,91,40,22,212,1,3,V,-7,18,1,25,-17,-11,-34,0,-2,2008
606,606,10/04/2008,Tennessee,13,32,69,18,10,156,0,2,Northern Illinois,9,34,72,26,14,118,1,0,H,16.5,4,-2,-3,-8,-4,38,-1,2,2008
607,607,10/04/2008,Texas,38,46,169,30,23,262,2,0,Colorado,14,28,49,38,17,217,0,2,V,12.5,24,18,120,-8,6,45,2,-2,2008
608,608,10/04/2008,Texas A+M,28,30,184,43,24,218,2,3,Oklahoma State,56,46,215,14,10,186,0,1,V,-26,-28,-16,-31,29,14,32,2,2,2008
609,609,10/04/2008,Texas Christian,41,71,383,19,10,115,0,1,San Diego State,7,15,-13,26,10,98,0,1,H,24.5,34,56,396,-7,0,17,0,0,2008
610,610,10/04/2008,Texas Tech,58,30,136,60,42,490,1,0,Kansas State,28,36,113,31,15,183,0,2,V,7,30,-6,23,29,27,307,1,-2,2008
611,611,10/04/2008,Toledo,0,19,14,31,21,143,1,0,Ball State,31,44,240,30,18,242,0,0,H,-7,-31,-25,-226,1,3,-99,1,0,2008
612,612,10/04/2008,Tulane,13,38,156,42,26,330,3,1,Army,44,44,291,5,4,43,0,0,H,20,-31,-6,-135,37,22,287,3,1,2008
613,613,10/04/2008,Tulsa,63,53,386,26,14,191,1,0,Rice,28,35,103,46,25,350,1,3,H,16.5,35,18,283,-20,-11,-159,0,-3,2008
614,614,10/04/2008,U-C-F,31,38,154,17,9,126,0,1,S-M-U,17,21,25,45,29,351,3,1,H,13,14,17,129,-28,-20,-225,-3,0,2008
615,615,10/04/2008,U.C.L.A.,28,37,100,37,23,225,0,0,Washington State,3,25,26,31,15,151,1,0,H,17,25,12,74,6,8,74,-1,0,2008
616,616,10/04/2008,UL-Lafayette,44,37,556,23,15,172,2,1,UL-Monroe,35,40,241,25,12,142,0,0,V,2.5,9,-3,315,-2,3,30,2,1,2008
617,617,10/04/2008,UL-Monroe,35,40,241,25,12,142,0,0,UL-Lafayette,44,37,556,23,15,172,2,1,H,-2.5,-9,3,-315,2,-3,-30,-2,-1,2008
618,618,10/04/2008,UTEP,40,32,116,44,25,266,0,0,Southern Miss,37,45,277,37,21,264,1,0,V,-7.5,3,-13,-161,7,4,2,-1,0,2008
619,619,10/04/2008,Vanderbilt,14,32,106,31,16,157,1,0,Auburn,13,44,110,22,10,98,1,0,H,-4,1,-12,-4,9,6,59,0,0,2008
620,620,10/04/2008,Virginia,31,41,201,34,25,226,0,0,Maryland,0,21,79,34,20,223,1,1,H,-13.5,31,20,122,0,5,3,-1,-1,2008
621,621,10/04/2008,Virginia Tech,27,51,151,18,13,142,0,1,Western Kentucky,13,32,148,20,8,95,1,0,H,28,14,19,3,-2,5,47,-1,1,2008
622,622,10/04/2008,Washington,14,28,63,28,12,181,1,1,Arizona,48,51,256,21,17,193,0,0,V,-24,-34,-23,-193,7,-5,-12,1,1,2008
623,623,10/04/2008,Washington State,3,25,26,31,15,151,1,0,U.C.L.A.,28,37,100,37,23,225,0,0,V,-17,-25,-12,-74,-6,-8,-74,1,0,2008
624,624,10/04/2008,West Virginia,24,50,175,19,14,158,0,0,Rutgers,17,26,72,33,15,198,0,0,H,14,7,24,103,-14,-1,-40,0,0,2008
625,625,10/04/2008,Western Kentucky,13,32,148,20,8,95,1,0,Virginia Tech,27,51,151,18,13,142,0,1,V,-28,-14,-19,-3,2,-5,-47,1,-1,2008
626,626,10/04/2008,Western Michigan,41,28,156,38,24,347,1,2,Ohio,20,37,148,37,19,208,2,1,H,8.5,21,-9,8,1,5,139,-1,1,2008
627,627,10/04/2008,Wisconsin,17,39,179,25,13,147,1,1,Ohio State,20,40,183,19,13,144,1,1,H,-1.5,-3,-1,-4,6,0,3,0,0,2008
628,628,10/04/2008,Wyoming,0,44,130,19,9,71,1,2,New Mexico,24,48,317,21,8,33,0,0,V,-11,-24,-4,-187,-2,1,38,1,2,2008
629,629,10/07/2008,Florida Atlantic,17,31,75,41,21,283,2,1,Troy,30,51,233,24,11,127,1,0,H,-4.5,-13,-20,-158,17,10,156,1,1,2008
630,630,10/07/2008,Troy,30,51,233,24,11,127,1,0,Florida Atlantic,17,31,75,41,21,283,2,1,V,4.5,13,20,158,-17,-10,-156,-1,-1,2008
631,631,10/09/2008,Clemson,7,23,21,35,15,177,1,0,Wake Forest,12,46,156,36,22,186,0,0,V,1.5,-5,-23,-135,-1,-7,-9,1,0,2008
632,632,10/09/2008,Houston,45,31,132,40,26,417,0,1,U-A-B,20,38,118,40,24,234,3,0,H,18,25,-7,14,0,2,183,-3,1,2008
633,633,10/09/2008,U-A-B,20,38,118,40,24,234,3,0,Houston,45,31,132,40,26,417,0,1,V,-18,-25,7,-14,0,-2,-183,3,-1,2008
634,634,10/09/2008,Wake Forest,12,46,156,36,22,186,0,0,Clemson,7,23,21,35,15,177,1,0,H,-1.5,5,23,135,1,7,9,-1,0,2008
635,635,10/10/2008,Louisville,35,30,166,25,13,133,1,0,Memphis,28,30,130,56,34,351,1,2,V,6.5,7,0,36,-31,-21,-218,0,-2,2008
636,636,10/10/2008,Memphis,28,30,130,56,34,351,1,2,Louisville,35,30,166,25,13,133,1,0,H,-6.5,-7,0,-36,31,21,218,0,2,2008
637,637,10/11/2008,Air Force,35,77,401,7,5,72,0,2,San Diego State,10,27,35,38,19,130,2,0,V,10.5,25,50,366,-31,-14,-58,-2,2,2008
638,638,10/11/2008,Akron,33,42,206,34,19,161,1,0,Bowling Green,37,27,175,42,27,244,1,1,H,-1,-4,15,31,-8,-8,-83,0,-1,2008
639,639,10/11/2008,Arizona,23,23,77,34,22,259,0,0,Stanford,24,48,286,24,16,152,2,1,V,7,-1,-25,-209,10,6,107,-2,-1,2008
640,640,10/11/2008,Arizona State,0,36,75,37,15,154,3,1,Southern Cal,28,40,210,29,15,177,3,2,V,-28,-28,-4,-135,8,0,-23,0,-1,2008
641,641,10/11/2008,Arkansas,25,44,188,33,18,228,2,1,Auburn,22,33,56,28,10,137,3,0,V,-17,3,11,132,5,8,91,-1,1,2008
642,642,10/11/2008,Arkansas State,37,44,262,16,7,129,0,0,UL-Monroe,29,26,57,42,23,309,1,2,H,14.5,8,18,205,-26,-16,-180,-1,-2,2008
643,643,10/11/2008,Army,17,59,341,3,0,0,0,2,Eastern Michigan,13,29,117,30,12,138,0,0,H,1,4,30,224,-27,-12,-138,0,2,2008
644,644,10/11/2008,Auburn,22,33,56,28,10,137,3,0,Arkansas,25,44,188,33,18,228,2,1,H,17,-3,-11,-132,-5,-8,-91,1,-1,2008
645,645,10/11/2008,Ball State,24,40,200,22,14,155,1,0,Western Kentucky,7,34,183,31,19,169,1,2,V,16.5,17,6,17,-9,-5,-14,0,-2,2008
646,646,10/11/2008,Baylor,38,50,147,26,22,288,0,0,Iowa State,10,18,81,41,21,176,1,0,H,4.5,28,32,66,-15,1,112,-1,0,2008
647,647,10/11/2008,Boise State,24,34,180,30,21,170,1,1,Southern Miss,7,33,118,34,15,160,1,1,V,10.5,17,1,62,-4,6,10,0,0,2008
648,648,10/11/2008,Bowling Green,37,27,175,42,27,244,1,1,Akron,33,42,206,34,19,161,1,0,V,1,4,-15,-31,8,8,83,0,1,2008
649,649,10/11/2008,Brigham Young,21,28,124,34,22,258,0,0,New Mexico,3,50,130,22,13,155,1,1,H,23.5,18,-22,-6,12,9,103,-1,-1,2008
650,650,10/11/2008,Buffalo,28,38,158,35,18,164,1,0,Western Michigan,34,17,52,63,42,345,1,2,H,1,-6,21,106,-28,-24,-181,0,-2,2008
651,651,10/11/2008,Central Michigan,24,40,55,25,17,242,0,1,Temple,14,34,138,32,15,163,3,1,H,7.5,10,6,-83,-7,2,79,-3,0,2008
652,652,10/11/2008,Cincinnati,13,31,97,29,21,239,0,0,Rutgers,10,29,62,36,20,192,0,0,H,7,3,2,35,-7,1,47,0,0,2008
653,653,10/11/2008,Colorado,14,37,86,30,13,147,2,0,Kansas,30,40,151,34,27,256,0,0,V,-14,-16,-3,-65,-4,-14,-109,2,0,2008
654,654,10/11/2008,Colorado State,7,28,11,35,17,188,2,1,Texas Christian,13,46,151,26,16,166,1,1,H,-15,-6,-18,-140,9,1,22,1,0,2008
655,655,10/11/2008,East Carolina,20,41,89,28,12,196,0,2,Virginia,35,33,202,34,26,228,2,0,V,6.5,-15,8,-113,-6,-14,-32,-2,2,2008
656,656,10/11/2008,Eastern Michigan,13,29,117,30,12,138,0,0,Army,17,59,341,3,0,0,0,2,V,-1,-4,-30,-224,27,12,138,0,-2,2008
657,657,10/11/2008,Florida,51,41,265,21,14,210,0,1,Louisiana State,21,26,80,41,25,241,2,1,H,6,30,15,185,-20,-11,-31,-2,0,2008
658,658,10/11/2008,Florida Intl,31,42,112,29,13,223,1,2,Middle Tennessee,21,41,171,27,14,72,3,0,H,2,10,1,-59,2,-1,151,-2,2,2008
659,659,10/11/2008,Fresno State,45,38,318,23,14,125,0,1,Idaho,32,39,215,39,22,237,0,2,H,34.5,13,-1,103,-16,-8,-112,0,-1,2008
660,660,10/11/2008,Georgia,26,45,148,36,25,310,2,0,Tennessee,14,15,1,30,13,208,0,0,H,12.5,12,30,147,6,12,102,2,0,2008
661,661,10/11/2008,Georgia Tech,10,47,79,11,3,120,1,2,Gardner-Webb,7,44,74,24,14,153,1,0,H, ,3,3,5,-13,-11,-33,0,2,2008
662,662,10/11/2008,Hawaii,24,40,177,26,14,224,1,0,Louisiana Tech,14,37,191,38,15,167,2,2,H,7.5,10,3,-14,-12,-1,57,-1,-2,2008
663,663,10/11/2008,Idaho,32,39,215,39,22,237,0,2,Fresno State,45,38,318,23,14,125,0,1,V,-34.5,-13,1,-103,16,8,112,0,1,2008
664,664,10/11/2008,Illinois,20,33,88,42,26,462,1,2,Minnesota,27,34,116,27,19,196,0,1,H,12,-7,-1,-28,15,7,266,1,1,2008
665,665,10/11/2008,Indiana,9,28,95,36,22,191,1,1,Iowa,45,51,227,22,13,195,0,0,H,-5,-36,-23,-132,14,9,-4,1,1,2008
666,666,10/11/2008,Iowa,45,51,227,22,13,195,0,0,Indiana,9,28,95,36,22,191,1,1,V,5,36,23,132,-14,-9,4,-1,-1,2008
667,667,10/11/2008,Iowa State,10,18,81,41,21,176,1,0,Baylor,38,50,147,26,22,288,0,0,V,-4.5,-28,-32,-66,15,-1,-112,1,0,2008
668,668,10/11/2008,Kansas,30,40,151,34,27,256,0,0,Colorado,14,37,86,30,13,147,2,0,H,14,16,3,65,4,14,109,-2,0,2008
669,669,10/11/2008,Kansas State,44,47,215,26,21,234,0,1,Texas A+M,30,33,125,41,29,419,0,1,V,3.5,14,14,90,-15,-8,-185,0,0,2008
670,670,10/11/2008,Kent State,19,37,192,25,15,200,2,1,Ohio,26,46,176,26,16,203,1,1,H,-1,-7,-9,16,-1,-1,-3,1,0,2008
671,671,10/11/2008,Kentucky,17,22,62,44,24,156,2,0,South Carolina,24,34,74,37,19,274,2,2,H,-3,-7,-12,-12,7,5,-118,0,-2,2008
672,672,10/11/2008,Louisiana State,21,26,80,41,25,241,2,1,Florida,51,41,265,21,14,210,0,1,V,-6,-30,-15,-185,20,11,31,2,0,2008
673,673,10/11/2008,Louisiana Tech,14,37,191,38,15,167,2,2,Hawaii,24,40,177,26,14,224,1,0,V,-7.5,-10,-3,14,12,1,-57,1,2,2008
674,674,10/11/2008,Miami-Florida,20,43,128,25,12,88,3,0,U-C-F,14,26,33,37,11,74,0,1,H,17,6,17,95,-12,1,14,3,-1,2008
675,675,10/11/2008,Miami-Ohio,13,25,110,23,14,115,0,0,Northern Illinois,17,27,184,17,9,77,0,0,V,-11,-4,-2,-74,6,5,38,0,0,2008
676,676,10/11/2008,Michigan,10,39,170,27,15,120,3,0,Toledo,13,22,70,50,33,257,0,1,H,16.5,-3,17,100,-23,-18,-137,3,-1,2008
677,677,10/11/2008,Michigan State,37,43,128,20,14,169,0,0,Northwestern,20,32,176,61,34,283,2,1,V,1.5,17,11,-48,-41,-20,-114,-2,-1,2008
678,678,10/11/2008,Middle Tennessee,21,41,171,27,14,72,3,0,Florida Intl,31,42,112,29,13,223,1,2,V,-2,-10,-1,59,-2,1,-151,2,-2,2008
679,679,10/11/2008,Minnesota,27,34,116,27,19,196,0,1,Illinois,20,33,88,42,26,462,1,2,V,-12,7,1,28,-15,-7,-266,-1,-1,2008
680,680,10/11/2008,Mississippi State,17,50,166,22,12,81,0,0,Vanderbilt,14,26,45,20,8,62,2,0,H,-2,3,24,121,2,4,19,-2,0,2008
681,681,10/11/2008,Missouri,23,18,64,52,39,390,3,0,Oklahoma State,28,43,184,29,20,218,1,2,H,14,-5,-25,-120,23,19,172,2,-2,2008
682,682,10/11/2008,Nebraska,31,34,111,46,38,360,1,0,Texas Tech,37,23,137,25,20,284,0,0,V,-20.5,-6,11,-26,21,18,76,1,0,2008
683,683,10/11/2008,Nevada-Reno,45,42,313,26,15,194,1,2,New Mexico State,48,36,104,47,28,409,1,0,H,19.5,-3,6,209,-21,-13,-215,0,2,2008
684,684,10/11/2008,New Mexico,3,50,130,22,13,155,1,1,Brigham Young,21,28,124,34,22,258,0,0,V,-23.5,-18,22,6,-12,-9,-103,1,1,2008
685,685,10/11/2008,New Mexico State,48,36,104,47,28,409,1,0,Nevada-Reno,45,42,313,26,15,194,1,2,V,-19.5,3,-6,-209,21,13,215,0,-2,2008
686,686,10/11/2008,North Carolina,29,32,121,32,18,201,0,0,Notre Dame,24,30,89,48,31,383,2,3,H,8.5,5,2,32,-16,-13,-182,-2,-3,2008
687,687,10/11/2008,North Texas,30,34,167,45,29,361,1,2,UL-Lafayette,59,47,338,21,15,252,1,1,H,-21.5,-29,-13,-171,24,14,109,0,1,2008
688,688,10/11/2008,Northern Illinois,17,27,184,17,9,77,0,0,Miami-Ohio,13,25,110,23,14,115,0,0,H,11,4,2,74,-6,-5,-38,0,0,2008
689,689,10/11/2008,Northwestern,20,32,176,61,34,283,2,1,Michigan State,37,43,128,20,14,169,0,0,H,-1.5,-17,-11,48,41,20,114,2,1,2008
690,690,10/11/2008,Notre Dame,24,30,89,48,31,383,2,3,North Carolina,29,32,121,32,18,201,0,0,V,-8.5,-5,-2,-32,16,13,182,2,3,2008
691,691,10/11/2008,Ohio,26,46,176,26,16,203,1,1,Kent State,19,37,192,25,15,200,2,1,V,1,7,9,-16,1,1,3,-1,0,2008
692,692,10/11/2008,Ohio State,16,42,125,14,10,97,0,0,Purdue,3,26,70,51,23,228,1,1,H,18.5,13,16,55,-37,-13,-131,-1,-1,2008
693,693,10/11/2008,Oklahoma,35,26,48,41,28,387,2,0,Texas,45,35,161,35,28,277,0,0,N,6.5,-10,-9,-113,6,0,110,2,0,2008
694,694,10/11/2008,Oklahoma State,28,44,187,28,19,215,1,2,Missouri,23,18,64,52,39,390,3,0,V,-14,5,26,123,-24,-20,-175,-2,2,2008
695,695,10/11/2008,Oregon,31,46,323,19,5,42,0,0,U.C.L.A.,24,37,63,43,27,288,1,0,H,19.5,7,9,260,-24,-22,-246,-1,0,2008
696,696,10/11/2008,Oregon State,66,43,323,26,13,225,4,0,Washington State,13,42,53,17,7,79,0,2,H,30,53,1,270,9,6,146,4,-2,2008
697,697,10/11/2008,Penn State,48,35,106,30,18,271,1,0,Wisconsin,7,40,148,27,11,165,2,2,V,6,41,-5,-42,3,7,106,-1,-2,2008
698,698,10/11/2008,Purdue,3,26,70,51,23,228,1,1,Ohio State,16,42,125,14,10,97,0,0,V,-18.5,-13,-16,-55,37,13,131,1,1,2008
699,699,10/11/2008,Rutgers,10,29,62,36,20,192,0,0,Cincinnati,13,31,97,29,21,239,0,0,V,-7,-3,-2,-35,7,-1,-47,0,0,2008
700,700,10/11/2008,S-M-U,31,28,151,34,19,318,1,0,Tulsa,37,50,321,31,17,281,2,1,H,-24.5,-6,-22,-170,3,2,37,-1,-1,2008
701,701,10/11/2008,San Diego State,10,27,35,38,19,130,2,0,Air Force,35,77,401,7,5,72,0,2,H,-10.5,-25,-50,-366,31,14,58,2,-2,2008
702,702,10/11/2008,San Jose State,30,29,87,47,31,314,1,0,Utah State,7,34,71,30,13,119,2,0,H,13.5,23,-5,16,17,18,195,-1,0,2008
703,703,10/11/2008,South Carolina,24,34,74,37,19,274,2,2,Kentucky,17,22,62,44,24,156,2,0,V,3,7,12,12,-7,-5,118,0,2,2008
704,704,10/11/2008,Southern Cal,28,40,210,29,15,177,3,2,Arizona State,0,36,75,37,15,154,3,1,H,28,28,4,135,-8,0,23,0,1,2008
705,705,10/11/2008,Southern Miss,7,33,88,34,15,160,1,1,Boise State,24,34,184,30,21,170,1,1,H,-10.5,-17,-1,-96,4,-6,-10,0,0,2008
706,706,10/11/2008,Stanford,24,48,286,24,16,152,2,1,Arizona,23,23,77,34,22,259,0,0,H,-7,1,25,209,-10,-6,-107,2,1,2008
707,707,10/11/2008,Syracuse,6,35,139,42,25,207,1,0,West Virginia,17,32,216,20,14,52,0,0,V,-24,-11,3,-77,22,11,155,1,0,2008
708,708,10/11/2008,Temple,14,34,138,32,15,163,3,1,Central Michigan,24,40,55,25,17,242,0,1,V,-7.5,-10,-6,83,7,-2,-79,3,0,2008
709,709,10/11/2008,Tennessee,14,15,1,30,13,208,0,0,Georgia,26,45,148,36,25,310,2,0,V,-12.5,-12,-30,-147,-6,-12,-102,-2,0,2008
710,710,10/11/2008,Texas,45,35,161,35,28,277,0,0,Oklahoma,35,26,48,41,28,387,2,0,N,-6.5,10,9,113,-6,0,-110,-2,0,2008
711,711,10/11/2008,Texas A+M,30,33,125,41,29,419,0,1,Kansas State,44,47,215,26,21,234,0,1,H,-3.5,-14,-14,-90,15,8,185,0,0,2008
712,712,10/11/2008,Texas Christian,13,46,151,26,16,166,1,1,Colorado State,7,28,11,35,17,188,2,1,V,15,6,18,140,-9,-1,-22,-1,0,2008
713,713,10/11/2008,Texas Tech,37,23,137,25,20,284,0,0,Nebraska,31,35,114,45,37,357,1,0,H,20.5,6,-12,23,-20,-17,-73,-1,0,2008
714,714,10/11/2008,Toledo,13,22,70,50,33,257,0,1,Michigan,10,39,170,27,15,120,3,0,V,-16.5,3,-17,-100,23,18,137,-3,1,2008
715,715,10/11/2008,Tulane,21,39,318,22,11,94,0,0,UTEP,24,34,156,32,21,296,0,1,V,-4,-3,5,162,-10,-10,-202,0,-1,2008
716,716,10/11/2008,Tulsa,37,50,321,31,17,281,2,1,S-M-U,31,28,151,34,19,318,1,0,V,24.5,6,22,170,-3,-2,-37,1,1,2008
717,717,10/11/2008,U-C-F,14,27,4,37,11,74,0,1,Miami-Florida,20,43,128,25,12,88,3,0,V,-17,-6,-16,-124,12,-1,-14,-3,1,2008
718,718,10/11/2008,U.C.L.A.,24,37,63,43,27,288,1,0,Oregon,31,46,323,19,5,42,0,0,V,-19.5,-7,-9,-260,24,22,246,1,0,2008
719,719,10/11/2008,UL-Lafayette,59,47,338,21,15,252,1,1,North Texas,30,34,167,45,29,361,1,2,V,21.5,29,13,171,-24,-14,-109,0,-1,2008
720,720,10/11/2008,UL-Monroe,29,26,87,42,23,309,1,2,Arkansas State,37,44,262,16,7,129,0,0,V,-14.5,-8,-18,-175,26,16,180,1,2,2008
721,721,10/11/2008,UTEP,24,34,156,32,21,296,0,1,Tulane,21,39,318,22,11,94,0,0,H,4,3,-5,-162,10,10,202,0,1,2008
722,722,10/11/2008,Utah,40,44,123,20,11,119,0,0,Wyoming,7,44,184,23,10,68,3,2,V,23.5,33,0,-61,-3,1,51,-3,-2,2008
723,723,10/11/2008,Utah State,7,34,71,30,13,119,2,0,San Jose State,30,29,87,47,31,314,1,0,V,-13.5,-23,5,-16,-17,-18,-195,1,0,2008
724,724,10/11/2008,Vanderbilt,14,26,45,20,8,62,2,0,Mississippi State,17,50,166,22,12,81,0,0,V,2,-3,-24,-121,-2,-4,-19,2,0,2008
725,725,10/11/2008,Virginia,35,33,202,34,26,228,2,0,East Carolina,20,41,89,28,12,196,0,2,H,-6.5,15,-8,113,6,14,32,2,-2,2008
726,726,10/11/2008,Washington State,13,42,53,17,7,79,0,2,Oregon State,66,43,323,26,13,225,4,0,V,-30,-53,-1,-270,-9,-6,-146,-4,2,2008
727,727,10/11/2008,West Virginia,17,32,216,20,14,52,0,0,Syracuse,6,35,139,42,25,207,1,0,H,24,11,-3,77,-22,-11,-155,-1,0,2008
728,728,10/11/2008,Western Kentucky,7,34,183,31,19,169,1,2,Ball State,24,40,200,22,14,155,1,0,H,-16.5,-17,-6,-17,9,5,14,0,2,2008
729,729,10/11/2008,Western Michigan,34,17,52,63,42,345,1,2,Buffalo,28,38,158,35,18,164,1,0,V,-1,6,-21,-106,28,24,181,0,2,2008
730,730,10/11/2008,Wisconsin,7,40,148,27,11,165,2,2,Penn State,48,35,106,30,18,271,1,0,H,-6,-41,5,42,-3,-7,-106,1,2,2008
731,731,10/11/2008,Wyoming,7,44,184,23,10,68,3,2,Utah,40,44,123,20,11,119,0,0,H,-23.5,-33,0,61,3,-1,-51,3,2,2008
732,732,10/16/2008,Brigham Young,7,28,23,42,22,274,2,2,Texas Christian,32,52,249,19,12,161,0,1,V,-1.5,-25,-24,-226,23,10,113,2,1,2008
733,733,10/16/2008,Florida State,26,45,138,35,23,254,0,0,No Carolina State,17,22,157,25,13,181,0,0,V,11.5,9,23,-19,10,10,73,0,0,2008
734,734,10/16/2008,No Carolina State,17,22,157,25,13,181,0,0,Florida State,26,45,138,35,23,254,0,0,H,-11.5,-9,-23,19,-10,-10,-73,0,0,2008
735,735,10/16/2008,Texas Christian,32,51,240,19,12,170,0,1,Brigham Young,7,28,23,42,22,274,2,2,H,1.5,25,23,217,-23,-10,-104,-2,-1,2008
736,736,10/17/2008,Boise State,27,31,111,34,25,256,0,2,Hawaii,7,35,56,38,20,232,5,0,H,23.5,20,-4,55,-4,5,24,-5,2,2008
737,737,10/17/2008,Hawaii,7,35,56,38,20,232,5,0,Boise State,27,31,111,34,25,256,0,2,V,-23.5,-20,4,-55,4,-5,-24,5,-2,2008
738,738,10/18/2008,Air Force,29,68,346,7,6,162,0,0,Nevada-Las Vegas,28,35,153,30,19,251,0,0,V,4,1,33,193,-23,-13,-89,0,0,2008
739,739,10/18/2008,Akron,42,42,339,19,11,208,0,1,Eastern Michigan,35,41,182,34,22,258,1,1,V,4.5,7,1,157,-15,-11,-50,-1,0,2008
740,740,10/18/2008,Alabama,24,34,107,25,16,219,1,1,Mississippi,20,34,158,33,17,201,2,1,H,11.5,4,0,-51,-8,-1,18,-1,0,2008
741,741,10/18/2008,Arizona,42,41,179,27,16,225,1,1,California,27,23,110,56,25,315,2,0,H,-3,15,18,69,-29,-9,-90,-1,1,2008
742,742,10/18/2008,Arkansas,20,51,236,29,11,94,2,2,Kentucky,21,28,88,35,19,284,2,2,V,-7,-1,23,148,-6,-8,-190,0,0,2008
743,743,10/18/2008,Arkansas State,23,28,100,40,21,235,1,1,UL-Lafayette,28,51,189,17,10,124,2,0,V,-3,-5,-23,-89,23,11,111,-1,1,2008
744,744,10/18/2008,Army,24,54,320,6,4,52,0,1,Buffalo,27,30,41,35,25,279,0,0,V,-11,-3,24,279,-29,-21,-227,0,1,2008
745,745,10/18/2008,Baylor,6,31,42,27,15,162,0,1,Oklahoma State,34,58,219,20,13,238,0,1,V,-17,-28,-27,-177,7,2,-76,0,0,2008
746,746,10/18/2008,Boston College,28,37,82,32,16,218,3,2,Virginia Tech,23,38,150,27,12,90,1,0,H,3,5,-1,-68,5,4,128,2,2,2008
747,747,10/18/2008,Bowling Green,20,26,80,34,21,224,1,0,Miami-Ohio,27,43,218,24,11,129,0,0,H,9.5,-7,-17,-138,10,10,95,1,0,2008
748,748,10/18/2008,Buffalo,27,30,41,35,25,279,0,0,Army,24,54,320,6,4,52,0,1,H,11,3,-24,-279,29,21,227,0,-1,2008
749,749,10/18/2008,California,27,23,110,56,25,315,2,0,Arizona,42,41,179,27,16,225,1,1,V,3,-15,-18,-69,29,9,90,1,-1,2008
750,750,10/18/2008,Central Michigan,38,41,176,29,21,348,1,0,Western Michigan,28,23,49,53,38,471,0,0,H,-2,10,18,127,-24,-17,-123,1,0,2008
751,751,10/18/2008,Clemson,17,24,51,32,19,198,4,2,Georgia Tech,21,52,207,12,5,91,0,2,H,-2.5,-4,-28,-156,20,14,107,4,0,2008
752,752,10/18/2008,Colorado,14,56,247,26,13,106,1,1,Kansas State,13,23,112,41,20,237,0,2,H,3,1,33,135,-15,-7,-131,1,-1,2008
753,753,10/18/2008,Colorado State,16,31,110,38,22,188,1,0,Utah,49,37,327,27,19,222,1,0,V,-21,-33,-6,-217,11,3,-34,0,0,2008
754,754,10/18/2008,Connecticut,10,36,117,20,14,236,0,0,Rutgers,12,34,76,35,19,218,0,0,V,-3,-2,2,41,-15,-5,18,0,0,2008
755,755,10/18/2008,Duke,31,44,142,34,16,191,0,1,Miami-Florida,49,29,154,36,23,266,3,0,H,-3,-18,15,-12,-2,-7,-75,-3,1,2008
756,756,10/18/2008,East Carolina,30,37,180,24,12,201,0,2,Memphis,10,34,102,23,14,82,1,0,H,8.5,20,3,78,1,-2,119,-1,2,2008
757,757,10/18/2008,Eastern Michigan,35,41,182,34,22,258,1,1,Akron,42,42,339,19,11,208,0,1,H,-4.5,-7,-1,-157,15,11,50,1,0,2008
758,758,10/18/2008,Florida Atlantic,24,44,225,23,15,174,0,1,Western Kentucky,20,41,240,17,9,77,1,0,V,3,4,3,-15,6,6,97,-1,1,2008
759,759,10/18/2008,Florida Intl,23,36,83,34,22,266,1,2,Troy,33,40,137,29,19,255,0,0,V,-12,-10,-4,-54,5,3,11,1,2,2008
760,760,10/18/2008,Georgia,24,40,231,23,13,194,2,0,Vanderbilt,14,26,114,32,16,131,2,0,H,16.5,10,14,117,-9,-3,63,0,0,2008
761,761,10/18/2008,Georgia Tech,21,52,207,12,5,91,0,2,Clemson,17,24,51,32,19,198,4,2,V,2.5,4,28,156,-20,-14,-107,-4,0,2008
762,762,10/18/2008,Houston,44,38,131,37,28,404,1,1,S-M-U,38,23,48,40,29,365,2,1,V,15,6,15,83,-3,-1,39,-1,0,2008
763,763,10/18/2008,Idaho,14,19,15,40,22,224,2,1,Louisiana Tech,46,59,364,22,13,192,0,0,V,-20,-32,-40,-349,18,9,32,2,1,2008
764,764,10/18/2008,Illinois,55,44,292,22,16,271,0,1,Indiana,13,44,141,29,12,172,0,2,H,17.5,42,0,151,-7,4,99,0,-1,2008
765,765,10/18/2008,Indiana,13,44,141,29,12,172,0,2,Illinois,55,44,292,22,16,271,0,1,V,-17.5,-42,0,-151,7,-4,-99,0,1,2008
766,766,10/18/2008,Iowa,38,34,254,20,12,121,0,0,Wisconsin,16,34,158,41,21,251,3,0,H,5,22,0,96,-21,-9,-130,-3,0,2008
767,767,10/18/2008,Iowa State,7,25,105,29,16,113,0,2,Nebraska,35,41,220,37,27,328,0,3,H,-7.5,-28,-16,-115,-8,-11,-215,0,-1,2008
768,768,10/18/2008,Kansas,31,30,134,42,25,357,2,0,Oklahoma,45,43,206,54,36,468,0,0,V,-19.5,-14,-13,-72,-12,-11,-111,2,0,2008
769,769,10/18/2008,Kansas State,13,23,112,41,20,237,0,2,Colorado,14,57,247,25,13,106,1,1,V,-3,-1,-34,-135,16,7,131,-1,1,2008
770,770,10/18/2008,Kentucky,21,28,88,35,19,284,2,2,Arkansas,20,51,236,29,11,94,2,2,H,7,1,-23,-148,6,8,190,0,0,2008
771,771,10/18/2008,Louisiana State,24,46,164,29,18,199,1,0,South Carolina,17,31,39,26,14,215,1,2,V,2,7,15,125,3,4,-16,0,-2,2008
772,772,10/18/2008,Louisiana Tech,46,59,364,22,13,192,0,0,Idaho,14,19,15,40,22,224,2,1,H,20,32,40,349,-18,-9,-32,-2,-1,2008
773,773,10/18/2008,Louisville,42,45,247,23,14,144,2,0,Middle Tennessee,23,30,105,38,20,201,0,0,H,14.5,19,15,142,-15,-6,-57,2,0,2008
774,774,10/18/2008,Marshall,21,30,82,28,17,285,1,1,U-A-B,23,47,215,28,15,217,2,1,V,2.5,-2,-17,-133,0,2,68,-1,0,2008
775,775,10/18/2008,Maryland,26,33,140,42,29,330,0,2,Wake Forest,0,33,73,32,15,146,0,0,H,-1,26,0,67,10,14,184,0,2,2008
776,776,10/18/2008,Memphis,10,34,102,23,14,82,1,0,East Carolina,30,37,180,24,12,201,0,2,V,-8.5,-20,-3,-78,-1,2,-119,1,-2,2008
777,777,10/18/2008,Miami-Florida,49,29,154,36,23,266,3,0,Duke,31,44,142,34,16,191,0,1,V,3,18,-15,12,2,7,75,3,-1,2008
778,778,10/18/2008,Miami-Ohio,27,48,253,36,16,163,0,0,Bowling Green,20,36,111,38,23,258,1,0,V,-9.5,7,12,142,-2,-7,-95,-1,0,2008
779,779,10/18/2008,Michigan,17,46,202,22,12,89,0,1,Penn State,46,38,231,33,19,251,0,1,V,-24.5,-29,8,-29,-11,-7,-162,0,0,2008
780,780,10/18/2008,Michigan State,7,21,52,39,23,188,2,3,Ohio State,45,52,216,11,7,116,0,0,H,-3,-38,-31,-164,28,16,72,2,3,2008
781,781,10/18/2008,Middle Tennessee,23,30,105,38,20,201,0,0,Louisville,42,45,247,23,14,144,2,0,V,-14.5,-19,-15,-142,15,6,57,-2,0,2008
782,782,10/18/2008,Mississippi,20,34,158,33,17,201,2,1,Alabama,24,34,107,25,16,219,1,1,V,-11.5,-4,0,51,8,1,-18,1,0,2008
783,783,10/18/2008,Mississippi State,3,30,69,30,13,120,3,0,Tennessee,34,39,139,21,10,136,0,0,V,-9,-31,-9,-70,9,3,-16,3,0,2008
784,784,10/18/2008,Missouri,31,19,30,41,31,318,1,0,Texas,56,40,203,33,30,388,0,0,V,-4.5,-25,-21,-173,8,1,-70,1,0,2008
785,785,10/18/2008,Navy,21,47,194,8,4,57,1,1,Pittsburgh,42,42,244,23,15,255,2,1,H,-3,-21,5,-50,-15,-11,-198,-1,0,2008
786,786,10/18/2008,Nebraska,35,41,220,37,27,328,0,3,Iowa State,7,25,105,29,16,113,0,2,V,7.5,28,16,115,8,11,215,0,1,2008
787,787,10/18/2008,Nevada-Las Vegas,28,35,153,30,19,251,0,0,Air Force,29,68,346,7,6,162,0,0,H,-4,-1,-33,-193,23,13,89,0,0,2008
788,788,10/18/2008,Nevada-Reno,44,42,284,28,14,239,2,2,Utah State,17,37,71,39,19,262,1,1,H,23.5,27,5,213,-11,-5,-23,1,1,2008
789,789,10/18/2008,New Mexico,70,64,428,15,10,137,0,1,San Diego State,7,22,66,39,19,161,1,2,H,17,63,42,362,-24,-9,-24,-1,-1,2008
790,790,10/18/2008,New Mexico State,14,29,35,45,28,249,3,1,San Jose State,31,37,151,18,8,50,3,0,H,-1,-17,-8,-116,27,20,199,0,1,2008
791,791,10/18/2008,North Carolina,13,48,166,26,16,166,2,1,Virginia,16,27,58,38,24,217,0,0,V,4,-3,21,108,-12,-8,-51,2,1,2008
792,792,10/18/2008,North Texas,23,30,101,62,37,362,0,1,UL-Monroe,35,33,244,22,13,217,0,0,V,-16,-12,-3,-143,40,24,145,0,1,2008
793,793,10/18/2008,Northern Illinois,38,55,251,20,14,207,0,0,Toledo,7,27,115,36,22,183,1,2,H,8.5,31,28,136,-16,-8,24,-1,-2,2008
794,794,10/18/2008,Northwestern,48,43,191,34,21,260,1,2,Purdue,26,25,158,51,31,308,3,2,H,4,22,18,33,-17,-10,-48,-2,0,2008
795,795,10/18/2008,Ohio State,45,52,216,11,7,116,0,0,Michigan State,7,21,52,39,23,188,2,3,V,3,38,31,164,-28,-16,-72,-2,-3,2008
796,796,10/18/2008,Oklahoma,45,44,206,53,36,468,0,0,Kansas,31,30,134,42,25,357,2,0,H,19.5,14,14,72,11,11,111,-2,0,2008
797,797,10/18/2008,Oklahoma State,34,58,219,20,13,238,0,1,Baylor,6,31,42,27,15,162,0,1,H,17,28,27,177,-7,-2,76,0,0,2008
798,798,10/18/2008,Oregon State,34,35,230,22,18,191,0,0,Washington,13,28,101,32,17,276,3,1,V,16,21,7,129,-10,1,-85,-3,-1,2008
799,799,10/18/2008,Penn State,46,38,231,33,19,251,0,1,Michigan,17,46,202,22,12,89,0,0,H,24.5,29,-8,29,11,7,162,0,1,2008
800,800,10/18/2008,Pittsburgh,42,42,244,23,15,255,2,1,Navy,21,47,194,8,4,57,1,1,V,3,21,-5,50,15,11,198,1,0,2008
801,801,10/18/2008,Purdue,26,25,158,51,31,308,3,2,Northwestern,48,43,191,34,21,260,1,2,V,-4,-22,-18,-33,17,10,48,2,0,2008
802,802,10/18/2008,Rice,45,32,142,44,30,444,1,0,Southern Miss,40,33,112,62,32,461,0,2,H,1.5,5,-1,30,-18,-2,-17,1,-2,2008
803,803,10/18/2008,Rutgers,12,34,76,35,19,218,0,0,Connecticut,10,36,117,20,14,236,0,0,H,3,2,-2,-41,15,5,-18,0,0,2008
804,804,10/18/2008,S-M-U,38,23,48,40,29,365,2,1,Houston,44,38,131,37,28,404,1,1,H,-15,-6,-15,-83,3,1,-39,1,0,2008
805,805,10/18/2008,San Diego State,7,22,66,39,19,161,1,2,New Mexico,70,63,419,15,10,146,0,1,V,-17,-63,-41,-353,24,9,15,1,1,2008
806,806,10/18/2008,San Jose State,31,37,151,18,8,50,3,0,New Mexico State,14,29,35,45,28,249,3,1,V,1,17,8,116,-27,-20,-199,0,-1,2008
807,807,10/18/2008,South Carolina,17,31,39,26,14,215,1,2,Louisiana State,24,46,164,29,18,199,1,0,H,-2,-7,-15,-125,-3,-4,16,0,2,2008
808,808,10/18/2008,South Florida,45,46,239,26,19,248,0,1,Syracuse,13,27,101,27,11,129,0,1,H,24,32,19,138,-1,8,119,0,0,2008
809,809,10/18/2008,Southern Cal,69,49,362,21,16,263,0,0,Washington State,0,37,88,9,6,28,1,2,V,43,69,12,274,12,10,235,-1,-2,2008
810,810,10/18/2008,Southern Miss,40,33,112,62,32,461,0,2,Rice,45,32,142,44,30,444,1,0,V,-1.5,-5,1,-30,18,2,17,-1,2,2008
811,811,10/18/2008,Stanford,20,44,250,13,5,51,1,2,U.C.L.A.,23,37,86,41,23,285,1,1,V,2.5,-3,7,164,-28,-18,-234,0,1,2008
812,812,10/18/2008,Syracuse,13,27,101,27,11,129,0,1,South Florida,45,46,239,26,19,248,0,1,V,-24,-32,-19,-138,1,-8,-119,0,0,2008
813,813,10/18/2008,Tennessee,34,39,139,21,10,136,0,0,Mississippi State,3,30,69,30,13,120,3,0,H,9,31,9,70,-9,-3,16,-3,0,2008
814,814,10/18/2008,Texas,56,40,203,33,30,388,0,0,Missouri,31,19,30,41,31,318,1,0,H,4.5,25,21,173,-8,-1,70,-1,0,2008
815,815,10/18/2008,Texas A+M,25,23,20,40,27,286,0,1,Texas Tech,43,23,111,56,44,450,2,1,H,-21,-18,0,-91,-16,-17,-164,-2,0,2008
816,816,10/18/2008,Texas Tech,43,23,111,56,44,450,2,1,Texas A+M,25,23,20,40,27,286,0,1,V,21,18,0,91,16,17,164,2,0,2008
817,817,10/18/2008,Toledo,7,22,80,24,17,149,1,2,Northern Illinois,38,45,220,16,12,173,0,0,V,-8.5,-31,-23,-140,8,5,-24,1,2,2008
818,818,10/18/2008,Troy,33,40,137,29,19,255,0,0,Florida Intl,23,36,83,34,22,266,1,2,H,12,10,4,54,-5,-3,-11,-1,-2,2008
819,819,10/18/2008,Tulsa,77,54,321,30,23,470,1,0,UTEP,35,21,32,37,21,306,0,0,H,20.5,42,33,289,-7,2,164,1,0,2008
820,820,10/18/2008,U-A-B,23,47,215,28,15,217,2,1,Marshall,21,30,82,28,17,285,1,1,H,-2.5,2,17,133,0,-2,-68,1,0,2008
821,821,10/18/2008,U.C.L.A.,23,37,86,41,23,285,1,1,Stanford,20,44,250,13,5,51,1,2,H,-2.5,3,-7,-164,28,18,234,0,-1,2008
822,822,10/18/2008,UL-Lafayette,28,51,189,17,10,124,2,0,Arkansas State,23,28,100,40,21,235,1,1,H,3,5,23,89,-23,-11,-111,1,-1,2008
823,823,10/18/2008,UL-Monroe,35,33,244,22,13,217,0,0,North Texas,23,30,101,62,37,362,0,1,H,16,12,3,143,-40,-24,-145,0,-1,2008
824,824,10/18/2008,UTEP,35,21,32,37,21,306,0,0,Tulsa,77,54,321,30,23,470,1,0,V,-20.5,-42,-33,-289,7,-2,-164,-1,0,2008
825,825,10/18/2008,Utah,49,37,327,27,19,222,1,0,Colorado State,16,31,110,38,22,188,1,0,H,21,33,6,217,-11,-3,34,0,0,2008
826,826,10/18/2008,Utah State,17,37,71,39,19,262,1,1,Nevada-Reno,44,42,284,28,14,239,2,2,V,-23.5,-27,-5,-213,11,5,23,-1,-1,2008
827,827,10/18/2008,Vanderbilt,14,26,114,32,16,131,2,0,Georgia,24,40,231,23,13,194,2,0,V,-16.5,-10,-14,-117,9,3,-63,0,0,2008
828,828,10/18/2008,Virginia,16,27,58,38,24,217,0,0,North Carolina,13,48,166,26,16,166,2,1,H,-4,3,-21,-108,12,8,51,-2,-1,2008
829,829,10/18/2008,Virginia Tech,23,38,150,27,12,90,1,0,Boston College,28,37,82,32,16,218,3,2,V,-3,-5,1,68,-5,-4,-128,-2,-2,2008
830,830,10/18/2008,Wake Forest,0,33,73,32,15,146,0,0,Maryland,26,33,140,42,29,330,0,2,V,1,-26,0,-67,-10,-14,-184,0,-2,2008
831,831,10/18/2008,Washington,13,28,101,32,17,276,3,1,Oregon State,34,35,230,22,18,191,0,0,H,-16,-21,-7,-129,10,-1,85,3,1,2008
832,832,10/18/2008,Washington State,0,37,88,9,6,28,1,2,Southern Cal,69,49,362,21,16,263,0,0,H,-43,-69,-12,-274,-12,-10,-235,1,2,2008
833,833,10/18/2008,Western Kentucky,20,41,240,17,9,77,1,0,Florida Atlantic,24,44,225,23,15,174,0,1,H,-3,-4,-3,15,-6,-6,-97,1,-1,2008
834,834,10/18/2008,Western Michigan,28,23,49,53,38,471,0,0,Central Michigan,38,41,176,29,21,348,1,0,V,2,-10,-18,-127,24,17,123,-1,0,2008
835,835,10/18/2008,Wisconsin,16,34,158,41,21,251,3,-1,Iowa,38,34,254,20,12,121,0,0,V,-5,-22,0,-96,21,9,130,3,-1,2008
836,836,10/21/2008,Ohio,10,29,47,40,23,220,0,2,Temple,14,37,64,22,9,79,0,0,V,-4,-4,-8,-17,18,14,141,0,2,2008
837,837,10/21/2008,Temple,14,37,64,22,9,79,0,0,Ohio,10,29,47,40,23,220,0,2,H,4,4,8,17,-18,-14,-141,0,-2,2008
838,838,10/23/2008,Air Force,23,69,227,3,1,1,1,2,New Mexico,10,47,212,18,9,91,1,3,H,5,13,22,15,-15,-8,-90,0,-1,2008
839,839,10/23/2008,Auburn,17,45,149,21,13,111,1,0,West Virginia,34,35,271,21,13,174,2,0,V,-3.5,-17,10,-122,0,0,-63,-1,0,2008
840,840,10/23/2008,New Mexico,10,47,212,18,9,91,1,3,Air Force,23,69,227,3,1,1,1,2,V,-5,-13,-22,-15,15,8,90,0,1,2008
841,841,10/23/2008,West Virginia,34,35,271,21,13,174,2,0,Auburn,17,45,149,21,13,111,1,0,H,3.5,17,-10,122,0,0,63,1,0,2008
842,842,10/24/2008,Boise State,33,48,149,41,26,244,1,1,San Jose State,16,21,109,31,17,98,1,1,V,7,17,27,40,10,9,146,0,0,2008
843,843,10/24/2008,San Jose State,16,21,109,31,17,98,1,1,Boise State,33,48,149,41,26,244,1,1,H,-7,-17,-27,-40,-10,-9,-146,0,0,2008
844,844,10/25/2008,Alabama,29,43,178,24,17,188,0,1,Tennessee,9,21,36,28,16,137,0,0,V,5.5,20,22,142,-4,1,51,0,1,2008
845,845,10/25/2008,Arizona,10,30,100,31,14,88,1,0,Southern Cal,17,41,151,36,21,216,1,1,H,-14.5,-7,-11,-51,-5,-7,-128,0,-1,2008
846,846,10/25/2008,Arizona State,20,32,107,45,24,226,2,1,Oregon,54,43,304,30,21,233,1,2,H,-3,-34,-11,-197,15,3,-7,1,-1,2008
847,847,10/25/2008,Arkansas,21,25,104,38,20,282,1,0,Mississippi,23,45,160,27,14,209,1,0,H,-6.5,-2,-20,-56,11,6,73,0,0,2008
848,848,10/25/2008,Army,14,56,203,9,3,32,1,3,Louisiana Tech,7,38,68,19,8,84,0,1,H,1,7,18,135,-10,-5,-52,1,2,2008
849,849,10/25/2008,Ball State,38,24,163,32,18,245,1,0,Eastern Michigan,16,29,67,50,28,309,2,0,H,27,22,-5,96,-18,-10,-64,-1,0,2008
850,850,10/25/2008,Baylor,20,33,216,20,9,134,0,0,Nebraska,32,37,161,46,32,336,0,1,V,-14,-12,-4,55,-26,-23,-202,0,-1,2008
851,851,10/25/2008,Boston College,24,21,40,42,28,204,3,0,North Carolina,45,36,114,30,19,238,0,1,V,-3,-21,-15,-74,12,9,-34,3,-1,2008
852,852,10/25/2008,Bowling Green,13,22,76,21,15,92,0,1,Northern Illinois,16,57,233,12,5,45,2,0,V,-7,-3,-35,-157,9,10,47,-2,1,2008
853,853,10/25/2008,Brigham Young,42,34,209,32,24,245,0,0,Nevada-Las Vegas,35,31,112,44,28,351,1,0,H,23.5,7,3,97,-12,-4,-106,-1,0,2008
854,854,10/25/2008,California,41,42,232,22,11,153,0,0,U.C.L.A.,20,22,16,41,19,237,4,0,H,19,21,20,216,-19,-8,-84,-4,0,2008
855,855,10/25/2008,Central Michigan,24,45,146,37,27,256,0,0,Toledo,23,32,149,26,16,216,0,0,V,3.5,1,13,-3,11,11,40,0,0,2008
856,856,10/25/2008,Cincinnati,16,19,30,47,19,259,3,3,Connecticut,40,36,153,42,18,196,0,0,V,3,-24,-17,-123,5,1,63,3,3,2008
857,857,10/25/2008,Colorado,0,35,41,34,21,158,0,1,Missouri,58,33,189,40,31,302,1,0,V,-24,-58,2,-148,-6,-10,-144,-1,1,2008
858,858,10/25/2008,Colorado State,38,33,211,34,25,296,0,0,San Diego State,34,34,226,33,24,166,1,0,V,7.5,4,-1,-15,1,1,130,-1,0,2008
859,859,10/25/2008,Connecticut,40,36,153,42,18,196,0,0,Cincinnati,16,19,30,47,19,259,3,3,H,-3,24,17,123,-5,-1,-63,-3,-3,2008
860,860,10/25/2008,Duke,10,36,28,36,21,222,0,1,Vanderbilt,7,32,81,31,14,210,2,1,V,-10,3,4,-53,5,7,12,-2,0,2008
861,861,10/25/2008,Eastern Michigan,16,29,67,50,28,309,2,0,Ball State,38,24,163,32,18,245,1,0,V,-27,-22,5,-96,18,10,64,1,0,2008
862,862,10/25/2008,Florida,63,41,214,18,13,232,1,0,Kentucky,5,33,141,36,17,127,1,0,H,25,58,8,73,-18,-4,105,0,0,2008
863,863,10/25/2008,Florida Atlantic,29,30,151,39,28,267,2,1,UL-Monroe,28,36,155,29,22,216,1,1,V,2.5,1,-6,-4,10,6,51,1,0,2008
864,864,10/25/2008,Florida State,30,38,89,19,11,159,0,0,Virginia Tech,20,34,82,22,12,161,0,2,H,6.5,10,4,7,-3,-1,-2,0,-2,2008
865,865,10/25/2008,Fresno State,30,33,154,36,25,257,0,0,Utah State,28,39,206,24,15,193,0,0,V,15,2,-6,-52,12,10,64,0,0,2008
866,866,10/25/2008,Georgia,52,36,194,26,17,249,0,0,Louisiana State,38,41,188,30,16,309,3,0,V,1,14,-5,6,-4,1,-60,-3,0,2008
867,867,10/25/2008,Georgia Tech,17,41,156,15,7,103,1,2,Virginia,24,36,126,39,29,270,2,1,H,14.5,-7,5,30,-24,-22,-167,-1,1,2008
868,868,10/25/2008,Hawaii,38,28,42,36,23,289,2,0,Nevada-Reno,31,40,308,28,14,173,0,2,H,-3.5,7,-12,-266,8,9,116,2,-2,2008
869,869,10/25/2008,Idaho,20,48,271,18,7,59,2,1,New Mexico State,14,26,35,47,37,324,2,2,H,-12,6,22,236,-29,-30,-265,0,-1,2008
870,870,10/25/2008,Illinois,17,30,88,32,17,221,3,0,Wisconsin,27,45,163,22,12,174,0,1,V,2.5,-10,-15,-75,10,5,47,3,-1,2008
871,871,10/25/2008,Indiana,21,36,72,35,22,247,0,0,Northwestern,19,47,152,35,22,164,2,3,H,-7.5,2,-11,-80,0,0,83,-2,-3,2008
872,872,10/25/2008,Iowa State,35,39,173,46,28,401,0,2,Texas A+M,49,35,128,39,31,381,0,1,H,3,-14,4,45,7,-3,20,0,1,2008
873,873,10/25/2008,Kansas,21,33,161,26,16,154,3,2,Texas Tech,63,29,138,48,38,418,0,1,H,-2,-42,4,23,-22,-22,-264,3,1,2008
874,874,10/25/2008,Kansas State,35,32,64,52,30,486,3,2,Oklahoma,58,45,273,32,13,255,0,1,H,-18.5,-23,-13,-209,20,17,231,3,1,2008
875,875,10/25/2008,Kent State,54,54,305,20,12,163,0,0,Miami-Ohio,21,33,147,31,18,171,2,4,V,-4,33,21,158,-11,-6,-8,-2,-4,2008
876,876,10/25/2008,Kentucky,5,33,141,36,17,127,1,0,Florida,63,41,214,18,13,232,1,0,V,-25,-58,-8,-73,18,4,-105,0,0,2008
877,877,10/25/2008,Louisiana State,38,41,188,30,16,309,3,0,Georgia,52,36,194,26,17,249,0,0,H,-1,-14,5,-6,4,-1,60,3,0,2008
878,878,10/25/2008,Louisiana Tech,7,38,68,19,8,84,0,1,Army,14,56,203,9,3,32,1,3,V,-1,-7,-18,-135,10,5,52,-1,-2,2008
879,879,10/25/2008,Louisville,24,41,111,21,12,212,1,0,South Florida,20,24,8,40,30,344,2,0,H,-5.5,4,17,103,-19,-18,-132,-1,0,2008
880,880,10/25/2008,Maryland,27,36,203,20,9,126,0,1,No Carolina State,24,42,155,29,18,187,0,1,H,12,3,-6,48,-9,-9,-61,0,0,2008
881,881,10/25/2008,Memphis,36,51,285,28,18,231,1,1,Southern Miss,30,28,230,40,21,186,1,0,H,-3.5,6,23,55,-12,-3,45,0,1,2008
882,882,10/25/2008,Miami-Florida,16,33,102,28,15,194,0,0,Wake Forest,10,52,195,8,3,57,0,1,H,2.5,6,-19,-93,20,12,137,0,-1,2008
883,883,10/25/2008,Miami-Ohio,21,33,147,31,18,171,2,4,Kent State,54,54,305,20,12,163,0,0,H,4,-33,-21,-158,11,6,8,2,4,2008
884,884,10/25/2008,Michigan,21,31,84,27,13,168,3,1,Michigan State,35,48,167,30,18,306,0,3,H,-3.5,-14,-17,-83,-3,-5,-138,3,-2,2008
885,885,10/25/2008,Michigan State,35,48,167,30,18,306,0,3,Michigan,21,31,84,27,13,168,3,1,V,3.5,14,17,83,3,5,138,-3,2,2008
886,886,10/25/2008,Middle Tennessee,22,29,80,43,25,268,0,0,Mississippi State,31,39,169,25,17,197,0,0,V,-13,-9,-10,-89,18,8,71,0,0,2008
887,887,10/25/2008,Minnesota,17,34,109,34,21,212,1,0,Purdue,6,40,117,30,16,109,2,2,V,1,11,-6,-8,4,5,103,-1,-2,2008
888,888,10/25/2008,Mississippi,23,45,160,27,14,209,1,0,Arkansas,21,25,104,38,20,282,1,0,V,6.5,2,20,56,-11,-6,-73,0,0,2008
889,889,10/25/2008,Mississippi State,31,39,169,25,17,197,0,0,Middle Tennessee,22,29,80,43,25,268,0,0,H,13,9,10,89,-18,-8,-71,0,0,2008
890,890,10/25/2008,Missouri,58,33,189,40,31,302,1,0,Colorado,0,35,41,34,21,158,0,1,H,24,58,-2,148,6,10,144,1,-1,2008
891,891,10/25/2008,Navy,34,77,404,0,0,0,0,1,S-M-U,7,11,-13,28,16,157,1,0,H,14,27,66,417,-28,-16,-157,-1,1,2008
892,892,10/25/2008,Nebraska,32,37,161,46,32,336,0,1,Baylor,20,33,216,20,9,134,0,0,H,14,12,4,-55,26,23,202,0,1,2008
893,893,10/25/2008,Nevada-Las Vegas,35,31,112,44,28,351,1,0,Brigham Young,42,34,209,32,24,245,0,0,V,-23.5,-7,-3,-97,12,4,106,1,0,2008
894,894,10/25/2008,Nevada-Reno,31,40,308,28,14,173,0,2,Hawaii,38,28,42,36,23,289,2,0,V,3.5,-7,12,266,-8,-9,-116,-2,2,2008
895,895,10/25/2008,New Mexico State,14,26,35,47,37,324,2,2,Idaho,20,48,271,18,7,59,2,1,V,12,-6,-22,-236,29,30,265,0,1,2008
896,896,10/25/2008,No Carolina State,24,42,155,29,18,187,0,1,Maryland,27,36,203,20,9,126,0,1,V,-12,-3,6,-48,9,9,61,0,0,2008
897,897,10/25/2008,North Carolina,45,36,114,30,19,238,0,1,Boston College,24,21,40,42,28,204,3,0,H,3,21,15,74,-12,-9,34,-3,1,2008
898,898,10/25/2008,North Texas,17,33,92,52,31,246,3,1,Troy,45,28,108,51,41,439,0,0,H,-24,-28,5,-16,1,-10,-193,3,1,2008
899,899,10/25/2008,Northern Illinois,16,57,233,12,5,45,2,0,Bowling Green,13,22,76,21,15,92,0,1,H,7,3,35,157,-9,-10,-47,2,-1,2008
900,900,10/25/2008,Northwestern,19,47,152,35,22,154,2,3,Indiana,21,36,72,35,22,247,0,0,V,7.5,-2,11,80,0,0,-93,2,3,2008
901,901,10/25/2008,Notre Dame,33,49,252,28,15,207,1,0,Washington,7,23,26,25,11,98,0,0,V,9.5,26,26,226,3,4,109,1,0,2008
902,902,10/25/2008,Ohio State,6,31,61,28,16,226,1,1,Penn State,13,37,160,20,12,121,0,0,H,-2,-7,-6,-99,8,4,105,1,1,2008
903,903,10/25/2008,Oklahoma,58,45,273,32,13,255,0,1,Kansas State,35,32,64,52,30,486,3,2,V,18.5,23,13,209,-20,-17,-231,-3,-1,2008
904,904,10/25/2008,Oklahoma State,24,37,217,27,17,199,0,1,Texas,28,32,113,45,38,391,1,1,V,-11.5,-4,5,104,-18,-21,-192,-1,0,2008
905,905,10/25/2008,Oregon,54,43,304,30,21,233,1,2,Arizona State,20,32,107,45,24,226,2,1,V,3,34,11,197,-15,-3,7,-1,1,2008
906,906,10/25/2008,Penn State,13,37,160,20,12,121,0,0,Ohio State,6,31,61,28,16,226,1,1,V,2,7,6,99,-8,-4,-105,-1,-1,2008
907,907,10/25/2008,Pittsburgh,34,34,138,34,22,348,1,1,Rutgers,54,30,71,24,15,371,1,0,H,9.5,-20,4,67,10,7,-23,0,1,2008
908,908,10/25/2008,Purdue,6,40,117,30,16,109,2,2,Minnesota,17,34,109,34,21,202,1,0,H,-1,-11,6,8,-4,-5,-93,1,2,2008
909,909,10/25/2008,Rice,42,34,230,25,20,168,1,0,Tulane,17,27,34,43,24,340,2,1,V,-2,25,7,196,-18,-4,-172,-1,-1,2008
910,910,10/25/2008,Rutgers,54,30,71,24,15,371,1,0,Pittsburgh,34,34,138,34,22,348,1,1,V,-9.5,20,-4,-67,-10,-7,23,0,-1,2008
911,911,10/25/2008,S-M-U,7,11,-13,28,16,157,1,0,Navy,34,77,404,0,0,0,0,1,V,-14,-27,-66,-417,28,16,157,1,-1,2008
912,912,10/25/2008,San Diego State,34,34,226,33,24,166,1,0,Colorado State,38,33,211,34,25,296,0,0,H,-7.5,-4,1,15,-1,-1,-130,1,0,2008
913,913,10/25/2008,South Florida,20,24,8,40,30,344,2,0,Louisville,24,41,111,21,12,212,1,0,V,5.5,-4,-17,-103,19,18,132,1,0,2008
914,914,10/25/2008,Southern Cal,17,41,151,36,21,216,1,1,Arizona,10,30,100,31,14,88,1,0,V,14.5,7,11,51,5,7,128,0,1,2008
915,915,10/25/2008,Southern Miss,30,28,230,40,21,186,1,0,Memphis,36,51,285,28,18,231,1,1,V,3.5,-6,-23,-55,12,3,-45,0,-1,2008
916,916,10/25/2008,Tennessee,9,21,36,28,16,137,0,0,Alabama,29,43,178,24,17,188,0,1,H,-5.5,-20,-22,-142,4,-1,-51,0,-1,2008
917,917,10/25/2008,Texas,28,32,113,45,38,391,1,1,Oklahoma State,24,37,217,27,17,199,0,1,H,11.5,4,-5,-104,18,21,192,1,0,2008
918,918,10/25/2008,Texas A+M,49,35,128,39,31,381,0,1,Iowa State,35,39,173,46,28,401,0,2,V,-3,14,-4,-45,-7,3,-20,0,-1,2008
919,919,10/25/2008,Texas Christian,54,39,110,22,16,334,0,0,Wyoming,7,43,113,15,9,108,1,1,H,32.5,47,-4,-3,7,7,226,-1,-1,2008
920,920,10/25/2008,Texas Tech,63,29,138,48,38,418,0,1,Kansas,21,33,161,26,16,154,3,2,V,2,42,-4,-23,22,22,264,-3,-1,2008
921,921,10/25/2008,Toledo,23,32,149,26,16,216,0,0,Central Michigan,24,45,146,37,27,256,0,0,H,-3.5,-1,-13,3,-11,-11,-40,0,0,2008
922,922,10/25/2008,Troy,45,28,108,51,41,439,0,0,North Texas,17,33,92,52,31,246,3,1,V,24,28,-5,16,-1,10,193,-3,-1,2008
923,923,10/25/2008,Tulane,17,27,34,43,24,340,2,1,Rice,42,34,230,25,20,168,1,0,H,2,-25,-7,-196,18,4,172,1,1,2008
924,924,10/25/2008,U.C.L.A.,20,22,16,41,19,237,4,0,California,41,42,232,22,11,153,0,0,V,-19,-21,-20,-216,19,8,84,4,0,2008
925,925,10/25/2008,UL-Monroe,28,36,155,29,22,216,1,1,Florida Atlantic,29,30,151,39,28,267,2,1,H,-2.5,-1,6,4,-10,-6,-51,-1,0,2008
926,926,10/25/2008,Utah State,28,39,206,24,15,193,0,0,Fresno State,30,33,154,36,25,257,0,0,H,-15,-2,6,52,-12,-10,-64,0,0,2008
927,927,10/25/2008,Vanderbilt,7,32,81,31,14,210,2,1,Duke,10,36,28,36,21,222,0,1,H,10,-3,-4,53,-5,-7,-12,2,0,2008
928,928,10/25/2008,Virginia,24,36,126,39,29,270,2,1,Georgia Tech,17,41,156,15,7,103,1,2,V,-14.5,7,-5,-30,24,22,167,1,-1,2008
929,929,10/25/2008,Virginia Tech,20,34,82,22,12,161,0,2,Florida State,30,38,89,19,11,159,0,0,V,-6.5,-10,-4,-7,3,1,2,0,2,2008
930,930,10/25/2008,Wake Forest,10,52,195,8,3,57,0,1,Miami-Florida,16,33,102,28,15,194,0,0,V,-2.5,-6,19,93,-20,-12,-137,0,1,2008
931,931,10/25/2008,Washington,7,23,26,25,11,98,0,0,Notre Dame,33,49,252,28,15,207,1,0,H,-9.5,-26,-26,-226,-3,-4,-109,-1,0,2008
932,932,10/25/2008,Wisconsin,27,45,163,22,12,174,0,1,Illinois,17,30,88,32,17,221,3,0,H,-2.5,10,15,75,-10,-5,-47,-3,1,2008
933,933,10/25/2008,Wyoming,7,43,113,15,9,108,1,1,Texas Christian,54,39,110,22,16,334,0,0,V,-32.5,-47,4,3,-7,-7,-226,1,1,2008
934,934,10/26/2008,Tulsa,49,39,172,28,17,264,1,1,U-C-F,19,48,64,17,9,125,0,2,H,23.5,30,-9,108,11,8,139,1,-1,2008
935,935,10/26/2008,U-C-F,19,48,64,17,9,125,0,2,Tulsa,49,39,172,28,17,264,1,1,V,-23.5,-30,9,-108,-11,-8,-139,-1,1,2008
936,936,10/28/2008,Buffalo,32,46,277,23,14,116,0,1,Ohio,19,29,127,29,20,290,1,4,V,-2.5,13,17,150,-6,-6,-174,-1,-3,2008
937,937,10/28/2008,Houston,23,30,106,42,22,317,2,1,Marshall,37,54,249,25,15,157,0,0,V,7.5,-14,-24,-143,17,7,160,2,1,2008
938,938,10/28/2008,Marshall,37,54,249,25,15,157,0,0,Houston,23,30,106,42,22,317,2,1,H,-7.5,14,24,143,-17,-7,-160,-2,-1,2008
939,939,10/28/2008,Ohio,19,29,127,29,20,290,1,4,Buffalo,32,46,277,23,14,116,0,1,H,2.5,-13,-17,-150,6,6,174,1,3,2008
940,940,10/30/2008,Cincinnati,24,37,115,28,20,281,1,2,South Florida,10,39,182,31,13,174,3,0,H,-2,14,-2,-67,-3,7,107,-2,2,2008
941,941,10/30/2008,South Florida,10,39,182,31,13,174,3,0,Cincinnati,24,37,115,28,20,281,1,2,V,2,-14,2,67,3,-7,-107,2,-2,2008
942,942,11/01/2008,Air Force,16,49,142,8,3,32,1,0,Army,7,48,143,26,8,107,2,1,V,7,9,1,-1,-18,-5,-75,-1,-1,2008
943,943,11/01/2008,Alabama,35,36,205,28,15,152,1,0,Arkansas State,0,37,91,17,8,67,1,0,H,24,35,-1,114,11,7,85,0,0,2008
944,944,11/01/2008,Arizona State,25,32,78,28,15,217,0,0,Oregon State,27,38,109,34,23,261,1,0,V,-15.5,-2,-6,-31,-6,-8,-44,-1,0,2008
945,945,11/01/2008,Arkansas,30,31,50,38,25,385,1,0,Tulsa,23,47,184,33,18,344,2,1,H,-7,7,-16,-134,5,7,41,-1,-1,2008
946,946,11/01/2008,Arkansas State,0,37,91,17,8,67,1,0,Alabama,35,36,205,28,15,152,1,0,V,-24,-35,1,-114,-11,-7,-85,0,0,2008
947,947,11/01/2008,Army,7,48,143,26,8,107,2,1,Air Force,16,49,142,8,3,32,1,0,H,-7,-9,-1,1,18,5,75,1,1,2008
948,948,11/01/2008,Auburn,7,25,75,43,27,319,3,0,Mississippi,17,41,233,30,15,140,0,0,V,-6.5,-10,-16,-158,13,12,179,3,0,2008
949,949,11/01/2008,Baylor,28,44,155,35,26,283,1,1,Missouri,31,34,153,39,31,337,2,1,H,-21.5,-3,10,2,-4,-5,-54,-1,0,2008
950,950,11/01/2008,Boise State,49,33,216,29,19,279,1,2,New Mexico State,0,39,38,31,18,112,1,1,V,21.5,49,-6,178,-2,1,167,0,1,2008
951,951,11/01/2008,Boston College,21,30,120,39,18,116,0,2,Clemson,27,31,87,33,21,252,3,1,H,3,-6,-1,33,6,-3,-136,-3,1,2008
952,952,11/01/2008,Bowling Green,45,46,261,24,17,201,2,0,Kent State,30,42,259,32,16,219,2,0,H,6,15,4,2,-8,1,-18,0,0,2008
953,953,11/01/2008,Brigham Young,45,35,162,35,28,389,1,2,Colorado State,42,29,131,36,19,270,0,1,V,14.5,3,6,31,-1,9,119,1,1,2008
954,954,11/01/2008,California,26,40,132,39,20,216,1,4,Oregon,16,50,206,32,11,84,2,1,H,2.5,10,-10,-74,7,9,132,-1,3,2008
955,955,11/01/2008,Central Michigan,37,31,37,53,35,485,1,0,Indiana,34,43,272,25,13,213,1,1,V,-1.5,3,-12,-235,28,22,272,0,-1,2008
956,956,11/01/2008,Clemson,27,31,87,33,21,252,3,1,Boston College,21,30,120,39,18,116,0,2,V,-3,6,1,-33,-6,3,136,3,-1,2008
957,957,11/01/2008,Colorado,17,43,194,34,18,198,3,0,Texas A+M,24,33,94,31,15,214,0,1,V,-4,-7,10,100,3,3,-16,3,-1,2008
958,958,11/01/2008,Colorado State,42,29,131,36,19,270,0,1,Brigham Young,45,35,162,35,28,389,1,2,H,-14.5,-3,-6,-31,1,-9,-119,-1,-1,2008
959,959,11/01/2008,Connecticut,13,25,119,37,17,166,3,2,West Virginia,35,51,216,18,11,121,0,0,H,-3,-22,-26,-97,19,6,45,3,2,2008
960,960,11/01/2008,Duke,30,37,145,27,19,231,2,2,Wake Forest,33,43,112,31,18,232,0,1,V,-7.5,-3,-6,33,-4,1,-1,2,1,2008
961,961,11/01/2008,Eastern Michigan,10,37,133,37,21,272,2,0,Western Michigan,31,35,163,36,24,339,0,3,V,-18.5,-21,2,-30,1,-3,-67,2,-3,2008
962,962,11/01/2008,Florida,49,38,185,17,13,188,0,0,Georgia,10,29,106,37,20,292,3,1,N,7.5,39,9,79,-20,-7,-104,-3,-1,2008
963,963,11/01/2008,Florida Intl,20,31,117,24,12,153,1,2,UL-Lafayette,49,57,228,19,13,216,0,0,V,-10.5,-29,-26,-111,5,-1,-63,1,2,2008
964,964,11/01/2008,Florida State,28,36,196,29,17,188,1,2,Georgia Tech,31,45,288,6,4,55,1,1,V,-2,-3,-9,-92,23,13,133,0,1,2008
965,965,11/01/2008,Fresno State,35,26,63,38,23,296,1,1,Louisiana Tech,38,42,280,21,12,117,1,1,V,5,-3,-16,-217,17,11,179,0,0,2008
966,966,11/01/2008,Georgia,10,29,106,37,20,292,3,1,Florida,49,38,185,17,13,188,0,0,N,-7.5,-39,-9,-79,20,7,104,3,1,2008
967,967,11/01/2008,Georgia Tech,31,45,288,6,4,55,1,1,Florida State,28,36,196,29,17,188,1,2,H,2,3,9,92,-23,-13,-133,0,-1,2008
968,968,11/01/2008,Hawaii,14,27,141,37,19,233,0,2,Utah State,30,40,145,20,14,223,1,1,V,6,-16,-13,-4,17,5,10,-1,1,2008
969,969,11/01/2008,Idaho,24,33,220,21,10,138,1,1,San Jose State,30,39,106,31,23,295,1,0,H,-16.5,-6,-6,114,-10,-13,-157,0,1,2008
970,970,11/01/2008,Illinois,27,28,60,37,22,272,2,1,Iowa,24,40,138,29,11,191,2,1,H,2.5,3,-12,-78,8,11,81,0,0,2008
971,971,11/01/2008,Indiana,34,43,272,25,13,213,1,1,Central Michigan,37,31,37,53,35,485,1,0,H,1.5,-3,12,235,-28,-22,-272,0,1,2008
972,972,11/01/2008,Iowa,24,40,138,29,11,191,2,1,Illinois,27,28,60,37,22,272,2,1,V,-2.5,-3,12,78,-8,-11,-81,0,0,2008
973,973,11/01/2008,Iowa State,17,38,122,35,20,240,2,1,Oklahoma State,59,36,263,29,20,419,1,1,V,-29.5,-42,2,-141,6,0,-179,1,0,2008
974,974,11/01/2008,Kansas,52,41,280,25,15,189,1,0,Kansas State,21,32,91,41,26,264,3,2,H,7.5,31,9,189,-16,-11,-75,-2,-2,2008
975,975,11/01/2008,Kansas State,21,32,91,41,26,264,3,2,Kansas,52,41,280,25,15,189,1,0,V,-7.5,-31,-9,-189,16,11,75,2,2,2008
976,976,11/01/2008,Kent State,30,42,259,32,16,219,2,0,Bowling Green,45,46,261,24,17,201,2,0,V,-6,-15,-4,-2,8,-1,18,0,0,2008
977,977,11/01/2008,Kentucky,14,36,128,30,16,146,1,1,Mississippi State,13,27,43,42,26,261,1,0,V,-2.5,1,9,85,-12,-10,-115,0,1,2008
978,978,11/01/2008,Louisiana State,35,46,231,20,8,99,1,0,Tulane,10,30,72,24,12,91,0,1,H,28.5,25,16,159,-4,-4,8,1,-1,2008
979,979,11/01/2008,Louisiana Tech,38,42,280,21,12,117,1,1,Fresno State,35,26,63,38,23,296,1,1,H,-5,3,16,217,-17,-11,-179,0,0,2008
980,980,11/01/2008,Louisville,21,34,137,36,23,214,1,1,Syracuse,28,38,207,22,11,178,0,1,V,12,-7,-4,-70,14,12,36,1,0,2008
981,981,11/01/2008,Miami-Florida,24,40,197,33,18,251,1,2,Virginia,17,24,78,41,27,240,0,2,V,-1,7,16,119,-8,-9,11,1,0,2008
982,982,11/01/2008,Michigan,42,37,177,21,9,123,0,1,Purdue,48,46,256,34,21,266,0,1,V,-2.5,-6,-9,-79,-13,-12,-143,0,0,2008
983,983,11/01/2008,Michigan State,25,29,25,45,20,287,0,1,Wisconsin,24,47,281,29,14,149,0,1,H,5.5,1,-18,-256,16,6,138,0,0,2008
984,984,11/01/2008,Minnesota,17,25,68,52,32,327,1,1,Northwestern,24,41,220,16,12,143,2,0,H,7.5,-7,-16,-152,36,20,184,-1,1,2008
985,985,11/01/2008,Mississippi,17,41,233,30,15,140,0,0,Auburn,7,25,75,43,27,319,3,0,H,6.5,10,16,158,-13,-12,-179,-3,0,2008
986,986,11/01/2008,Mississippi State,13,27,43,42,26,261,1,0,Kentucky,14,36,128,30,16,146,1,1,H,2.5,-1,-9,-85,12,10,115,0,-1,2008
987,987,11/01/2008,Missouri,31,34,153,39,31,337,2,1,Baylor,28,44,155,35,26,283,1,1,V,21.5,3,-10,-2,4,5,54,1,0,2008
988,988,11/01/2008,Navy,33,57,293,12,8,106,1,0,Temple,27,37,69,28,21,340,0,2,H,8,6,20,224,-16,-13,-234,1,-2,2008
989,989,11/01/2008,Nebraska,28,35,204,28,16,214,2,2,Oklahoma,62,40,193,30,21,315,1,0,V,-21,-34,-5,11,-2,-5,-101,1,2,2008
990,990,11/01/2008,Nevada-Las Vegas,14,33,108,22,8,67,1,2,Texas Christian,44,52,259,29,16,151,0,2,H,-15,-30,-19,-151,-7,-8,-84,1,0,2008
991,991,11/01/2008,New Mexico,10,37,119,26,16,165,0,0,Utah,13,35,193,33,23,195,1,1,H,-7,-3,2,-74,-7,-7,-30,-1,-1,2008
992,992,11/01/2008,New Mexico State,0,39,38,31,18,112,1,1,Boise State,49,33,216,29,19,279,1,2,H,-21.5,-49,6,-178,2,-1,-167,0,-1,2008
993,993,11/01/2008,North Texas,51,29,173,37,23,214,1,1,Western Kentucky,40,42,314,27,13,190,3,1,V,-18.5,11,-13,-141,10,10,24,-2,0,2008
994,994,11/01/2008,Northwestern,24,41,220,16,12,143,2,0,Minnesota,17,25,68,52,32,327,1,1,V,-7.5,7,16,152,-36,-20,-184,1,-1,2008
995,995,11/01/2008,Notre Dame,33,39,115,44,23,271,0,0,Pittsburgh,36,47,178,30,15,168,3,0,H,5,-3,-8,-63,14,8,103,-3,0,2008
996,996,11/01/2008,Oklahoma,62,40,193,30,21,315,1,0,Nebraska,28,35,204,28,16,214,2,2,H,21,34,5,-11,2,5,101,-1,-2,2008
997,997,11/01/2008,Oklahoma State,59,36,263,29,20,419,1,1,Iowa State,17,38,122,35,20,240,2,1,H,29.5,42,-2,141,-6,0,179,-1,0,2008
998,998,11/01/2008,Oregon,16,50,206,32,11,84,2,1,California,26,40,132,39,20,216,1,4,V,-2.5,-10,10,74,-7,-9,-132,1,-3,2008
999,999,11/01/2008,Oregon State,27,38,109,34,23,261,1,0,Arizona State,25,32,78,28,15,217,0,0,H,15.5,2,6,31,6,8,44,1,0,2008
1000,1000,11/01/2008,Pittsburgh,36,47,178,30,15,168,3,0,Notre Dame,33,39,115,44,23,271,0,0,V,-5,3,8,63,-14,-8,-103,3,0,2008
1001,1001,11/01/2008,Purdue,48,46,256,34,21,266,0,1,Michigan,42,37,177,21,9,123,0,1,H,2.5,6,9,79,13,12,143,0,0,2008
1002,1002,11/01/2008,Rice,49,41,167,43,29,376,0,0,UTEP,44,23,149,38,20,318,1,0,V,2.5,5,18,18,5,9,58,-1,0,2008
1003,1003,11/01/2008,San Diego State,10,19,17,52,28,311,0,1,Wyoming,35,59,378,10,6,166,0,0,V,-5.5,-25,-40,-361,42,22,145,0,1,2008
1004,1004,11/01/2008,San Jose State,30,39,106,31,23,295,1,0,Idaho,24,33,220,21,10,138,1,1,V,16.5,6,6,-114,10,13,157,0,-1,2008
1005,1005,11/01/2008,South Carolina,27,44,101,20,10,154,1,0,Tennessee,6,28,34,32,15,173,1,2,H,5.5,21,16,67,-12,-5,-19,0,-2,2008
1006,1006,11/01/2008,Southern Cal,56,46,297,20,16,188,0,0,Washington,0,30,71,33,14,113,3,0,H,46,56,16,226,-13,2,75,-3,0,2008
1007,1007,11/01/2008,Southern Miss,70,62,463,8,7,147,0,0,U-A-B,14,27,96,23,16,127,4,2,H,8.5,56,35,367,-15,-9,20,-4,-2,2008
1008,1008,11/01/2008,Stanford,58,55,344,13,7,112,0,0,Washington State,0,28,73,32,18,152,2,3,H,30,58,27,271,-19,-11,-40,-2,-3,2008
1009,1009,11/01/2008,Syracuse,28,38,207,22,11,178,0,1,Louisville,21,34,137,36,23,214,1,1,H,-12,7,4,70,-14,-12,-36,-1,0,2008
1010,1010,11/01/2008,Temple,27,37,69,28,21,340,0,2,Navy,33,57,293,12,8,106,1,0,V,-8,-6,-20,-224,16,13,234,-1,2,2008
1011,1011,11/01/2008,Tennessee,6,28,34,32,15,173,1,2,South Carolina,27,44,101,20,10,154,1,0,V,-5.5,-21,-16,-67,12,5,19,0,2,2008
1012,1012,11/01/2008,Texas,33,28,80,34,20,294,1,1,Texas Tech,39,28,105,53,36,474,0,1,V,3.5,-6,0,-25,-19,-16,-180,1,0,2008
1013,1013,11/01/2008,Texas A+M,24,33,94,31,15,214,0,1,Colorado,17,43,194,34,18,198,3,0,H,4,7,-10,-100,-3,-3,16,-3,1,2008
1014,1014,11/01/2008,Texas Christian,44,52,259,29,16,151,0,2,Nevada-Las Vegas,14,33,108,22,8,67,1,2,V,15,30,19,151,7,8,84,-1,0,2008
1015,1015,11/01/2008,Texas Tech,39,28,105,53,36,474,0,1,Texas,33,28,80,34,20,294,1,1,H,-3.5,6,0,25,19,16,180,-1,0,2008
1016,1016,11/01/2008,Troy,30,28,165,36,23,221,1,1,UL-Monroe,31,47,161,32,20,169,1,0,V,10,-1,-19,4,4,3,52,0,1,2008
1017,1017,11/01/2008,Tulane,10,30,72,24,12,91,0,1,Louisiana State,35,46,231,20,8,99,1,0,V,-28.5,-25,-16,-159,4,4,-8,-1,1,2008
1018,1018,11/01/2008,Tulsa,23,47,184,33,18,344,2,2,Arkansas,30,31,49,37,24,384,1,1,V,7,-7,16,135,-4,-6,-40,1,1,2008
1019,1019,11/01/2008,U-A-B,14,27,96,23,16,127,4,2,Southern Miss,70,62,463,8,7,147,0,0,V,-8.5,-56,-35,-367,15,9,-20,4,2,2008
1020,1020,11/01/2008,UL-Lafayette,49,57,228,19,13,216,0,0,Florida Intl,20,31,117,24,12,153,1,2,H,10.5,29,26,111,-5,1,63,-1,-2,2008
1021,1021,11/01/2008,UL-Monroe,31,47,161,32,20,169,1,0,Troy,30,28,165,36,23,221,1,1,H,-10,1,19,-4,-4,-3,-52,0,-1,2008
1022,1022,11/01/2008,UTEP,44,23,149,38,20,318,1,0,Rice,49,41,167,43,29,376,0,0,H,-2.5,-5,-18,-18,-5,-9,-58,1,0,2008
1023,1023,11/01/2008,Utah,13,35,193,33,23,195,1,1,New Mexico,10,37,119,26,16,165,0,0,V,7,3,-2,74,7,7,30,1,1,2008
1024,1024,11/01/2008,Utah State,30,40,145,20,14,223,1,0,Hawaii,14,27,141,37,19,233,0,2,H,-6,16,13,4,-17,-5,-10,1,-2,2008
1025,1025,11/01/2008,Virginia,17,24,78,41,27,240,0,2,Miami-Florida,24,40,197,33,18,251,1,2,H,1,-7,-16,-119,8,9,-11,-1,0,2008
1026,1026,11/01/2008,Wake Forest,33,43,112,31,18,232,0,1,Duke,30,37,145,27,19,231,2,2,H,7.5,3,6,-33,4,-1,1,-2,-1,2008
1027,1027,11/01/2008,Washington,0,30,71,33,14,113,3,0,Southern Cal,56,46,297,20,16,188,0,0,V,-46,-56,-16,-226,13,-2,-75,3,0,2008
1028,1028,11/01/2008,Washington State,0,28,73,32,18,152,2,3,Stanford,58,55,344,13,7,112,0,0,V,-30,-58,-27,-271,19,11,40,2,3,2008
1029,1029,11/01/2008,West Virginia,35,51,216,18,11,121,0,0,Connecticut,13,25,119,37,17,166,3,2,V,3,22,26,97,-19,-6,-45,-3,-2,2008
1030,1030,11/01/2008,Western Kentucky,40,42,314,27,13,190,3,1,North Texas,51,29,173,37,23,214,1,1,H,18.5,-11,13,141,-10,-10,-24,2,0,2008
1031,1031,11/01/2008,Western Michigan,31,35,163,36,24,339,0,3,Eastern Michigan,10,37,133,37,21,272,2,0,H,18.5,21,-2,30,-1,3,67,-2,3,2008
1032,1032,11/01/2008,Wisconsin,24,47,281,29,14,149,0,1,Michigan State,25,29,25,45,20,287,0,1,V,-5.5,-1,18,256,-16,-6,-138,0,0,2008
1033,1033,11/01/2008,Wyoming,35,59,378,10,6,166,0,0,San Diego State,10,19,17,52,28,311,0,1,H,5.5,25,40,361,-42,-22,-145,0,-1,2008
1034,1034,11/02/2008,East Carolina,13,44,134,34,13,149,1,1,U-C-F,10,37,82,21,9,142,1,2,V,5,3,7,52,13,4,7,0,-1,2008
1035,1035,11/02/2008,U-C-F,10,37,81,20,8,141,1,3,East Carolina,13,44,134,34,13,149,1,2,H,-5,-3,-7,-53,-14,-5,-8,0,1,2008
1036,1036,11/04/2008,Buffalo,37,34,216,31,19,260,0,0,Miami-Ohio,17,29,142,44,25,241,0,1,H,8,20,5,74,-13,-6,19,0,-1,2008
1037,1037,11/04/2008,Miami-Ohio,17,29,142,44,25,241,0,2,Buffalo,37,34,216,31,19,260,0,0,V,-8,-20,-5,-74,13,6,-19,0,2,2008
1038,1038,11/05/2008,Akron,47,44,232,23,16,226,1,0,Toledo,30,25,93,35,23,277,1,0,H,6.5,17,19,139,-12,-7,-51,0,0,2008
1039,1039,11/05/2008,Ball State,45,40,219,23,19,310,0,0,Northern Illinois,14,29,160,22,14,115,1,1,H,8,31,11,59,1,5,195,-1,-1,2008
1040,1040,11/05/2008,Northern Illinois,14,29,160,22,14,115,1,1,Ball State,45,40,219,23,19,310,0,0,V,-8,-31,-11,-59,-1,-5,-195,1,1,2008
1041,1041,11/05/2008,Toledo,30,25,93,35,23,277,1,0,Akron,47,44,232,23,16,226,1,0,V,-6.5,-17,-19,-139,12,7,51,0,0,2008
1042,1042,11/06/2008,Maryland,13,18,-12,31,19,240,0,1,Virginia Tech,23,51,273,21,14,127,0,1,V,-3,-10,-33,-285,10,5,113,0,0,2008
1043,1043,11/06/2008,Texas Christian,10,39,165,37,16,251,2,0,Utah,13,25,45,41,24,230,0,0,V,2,-3,14,120,-4,-8,21,2,0,2008
1044,1044,11/06/2008,Utah,13,25,45,41,24,230,0,0,Texas Christian,10,39,165,37,16,251,2,0,H,-2,3,-14,-120,4,8,-21,-2,0,2008
1045,1045,11/06/2008,Virginia Tech,23,51,273,21,14,127,0,1,Maryland,13,18,-12,31,19,240,0,1,H,3,10,33,285,-10,-5,-113,0,0,2008
1046,1046,11/07/2008,Fresno State,28,16,106,43,23,260,2,2,Nevada-Reno,41,61,472,17,7,128,0,0,H,-2.5,-13,-45,-366,26,16,132,2,2,2008
1047,1047,11/07/2008,Nevada-Reno,41,61,472,17,7,128,0,0,Fresno State,28,16,106,43,23,260,2,2,V,2.5,13,45,366,-26,-16,-132,-2,-2,2008
1048,1048,11/08/2008,Air Force,38,51,284,8,6,171,0,0,Colorado State,17,30,103,36,19,251,2,0,H,10,21,21,181,-28,-13,-80,-2,0,2008
1049,1049,11/08/2008,Alabama,27,37,138,31,15,215,1,2,Louisiana State,21,46,201,34,13,181,4,0,V,3.5,6,-9,-63,-3,2,34,-3,2,2008
1050,1050,11/08/2008,Arizona,59,57,317,15,11,214,1,1,Washington State,28,29,94,20,10,114,3,1,V,41,31,28,223,-5,1,100,-2,0,2008
1051,1051,11/08/2008,Arizona State,39,40,182,31,22,218,0,1,Washington,19,28,52,42,15,227,2,1,V,14,20,12,130,-11,7,-9,-2,0,2008
1052,1052,11/08/2008,Arkansas,21,31,54,34,20,255,3,0,South Carolina,34,34,132,30,13,219,1,0,V,-13,-13,-3,-78,4,7,36,2,0,2008
1053,1053,11/08/2008,Arkansas State,21,49,222,26,13,149,1,0,Florida Intl,22,22,48,34,16,359,0,0,V,2.5,-1,27,174,-8,-3,-210,1,0,2008
1054,1054,11/08/2008,Army,31,65,461,15,6,31,0,3,Rice,38,29,133,28,21,384,0,2,V,-9.5,-7,36,328,-13,-15,-353,0,1,2008
1055,1055,11/08/2008,Auburn,37,50,290,25,16,162,0,3,Tennessee-Martin,20,15,38,46,27,285,2,1,H, ,17,35,252,-21,-11,-123,-2,2,2008
1056,1056,11/08/2008,Baylor,21,29,201,20,6,71,1,0,Texas,45,47,194,37,26,300,2,0,V,-26,-24,-18,7,-17,-20,-229,-1,0,2008
1057,1057,11/08/2008,Boise State,49,36,105,42,32,458,1,2,Utah State,14,21,44,41,22,261,3,3,H,35,35,15,61,1,10,197,-2,-1,2008
1058,1058,11/08/2008,Boston College,17,41,167,22,9,79,0,0,Notre Dame,0,21,66,46,26,226,4,1,H,3.5,17,20,101,-24,-17,-147,-4,-1,2008
1059,1059,11/08/2008,Bowling Green,28,34,93,30,23,229,0,0,Ohio,3,28,40,30,13,188,2,0,V,2.5,25,6,53,0,10,41,-2,0,2008
1060,1060,11/08/2008,Brigham Young,41,37,104,30,25,317,0,1,San Diego State,12,28,120,37,21,160,1,3,H,36,29,9,-16,-7,4,157,-1,-2,2008
1061,1061,11/08/2008,California,3,26,27,31,15,138,1,0,Southern Cal,17,36,173,30,18,238,0,1,V,-22.5,-14,-10,-146,1,-3,-100,1,-1,2008
1062,1062,11/08/2008,Cincinnati,26,33,82,30,16,178,0,0,West Virginia,23,42,98,38,20,219,1,1,V,-6.5,3,-9,-16,-8,-4,-41,-1,-1,2008
1063,1063,11/08/2008,Clemson,27,36,79,35,20,237,1,1,Florida State,41,36,266,27,16,153,1,1,V,-3.5,-14,0,-187,8,4,84,0,0,2008
1064,1064,11/08/2008,Colorado,28,32,148,41,24,274,1,0,Iowa State,24,44,188,29,16,215,0,0,H,10.5,4,-12,-40,12,8,59,1,0,2008
1065,1065,11/08/2008,Colorado State,17,30,103,36,19,251,2,0,Air Force,38,51,284,8,6,171,0,0,V,-10,-21,-21,-181,28,13,80,2,0,2008
1066,1066,11/08/2008,Duke,17,28,94,52,37,317,0,0,No Carolina State,27,34,159,25,13,218,0,0,H,3.5,-10,-6,-65,27,24,99,0,0,2008
1067,1067,11/08/2008,East Carolina,19,38,100,37,26,287,0,1,Marshall,16,36,155,30,13,137,2,0,H,8,3,2,-55,7,13,150,-2,1,2008
1068,1068,11/08/2008,Florida,42,38,231,21,15,191,1,1,Vanderbilt,14,39,150,22,12,114,1,0,V,24,28,-1,81,-1,3,77,0,1,2008
1069,1069,11/08/2008,Florida Atlantic,46,41,256,28,17,251,2,1,North Texas,13,36,123,25,14,132,2,2,H,22.5,33,5,133,3,3,119,0,-1,2008
1070,1070,11/08/2008,Florida Intl,22,22,48,34,16,359,0,0,Arkansas State,21,49,222,26,13,149,1,0,H,-2.5,1,-27,-174,8,3,210,-1,0,2008
1071,1071,11/08/2008,Florida State,41,36,266,27,16,153,1,1,Clemson,27,36,79,35,20,237,1,1,H,3.5,14,0,187,-8,-4,-84,0,0,2008
1072,1072,11/08/2008,Georgia,42,30,144,27,17,376,0,2,Kentucky,38,56,226,20,12,105,1,1,V,13.5,4,-26,-82,7,5,271,-1,1,2008
1073,1073,11/08/2008,Georgia Tech,7,54,326,23,10,97,1,2,North Carolina,28,42,186,19,8,128,0,0,V,-4.5,-21,12,140,4,2,-31,1,2,2008
1074,1074,11/08/2008,Hawaii,42,37,144,35,27,303,0,3,New Mexico State,30,21,6,38,24,394,2,1,V,3.5,12,16,138,-3,3,-91,-2,2,2008
1075,1075,11/08/2008,Houston,42,37,299,43,30,394,1,2,Tulane,14,27,61,44,20,207,0,0,H,16.5,28,10,238,-1,10,187,1,2,2008
1076,1076,11/08/2008,Illinois,17,30,115,45,20,328,2,0,Western Michigan,23,28,64,40,28,301,0,1,N,7,-6,2,51,5,-8,27,2,-1,2008
1077,1077,11/08/2008,Indiana,20,38,133,34,13,141,0,1,Wisconsin,55,61,441,20,11,160,1,3,H,-10,-35,-23,-308,14,2,-19,-1,-2,2008
1078,1078,11/08/2008,Iowa,24,32,101,25,15,171,1,1,Penn State,23,46,180,24,10,109,1,1,H,-8,1,-14,-79,1,5,62,0,0,2008
1079,1079,11/08/2008,Iowa State,24,44,188,29,16,215,0,0,Colorado,28,32,148,41,24,274,1,0,V,-10.5,-4,12,40,-12,-8,-59,-1,0,2008
1080,1080,11/08/2008,Kansas,35,39,118,30,15,304,1,0,Nebraska,45,35,167,38,29,328,1,2,V,-1.5,-10,4,-49,-8,-14,-24,0,-2,2008
1081,1081,11/08/2008,Kansas State,24,33,194,42,22,169,1,1,Missouri,41,39,221,40,26,290,2,0,V,-27,-17,-6,-27,2,-4,-121,-1,1,2008
1082,1082,11/08/2008,Kentucky,38,56,226,20,12,105,1,1,Georgia,42,30,144,27,17,376,0,2,H,-13.5,-4,26,82,-7,-5,-271,1,-1,2008
1083,1083,11/08/2008,Louisiana State,21,46,201,34,13,181,4,0,Alabama,27,37,138,31,15,215,1,2,H,-3.5,-6,9,63,3,-2,-34,3,-2,2008
1084,1084,11/08/2008,Louisiana Tech,21,47,217,16,7,97,0,0,San Jose State,0,28,30,28,11,118,2,0,V,-7,21,19,187,-12,-4,-21,-2,0,2008
1085,1085,11/08/2008,Louisville,7,30,96,38,19,203,2,3,Pittsburgh,41,34,90,28,16,230,0,0,V,-6.5,-34,-4,6,10,3,-27,2,3,2008
1086,1086,11/08/2008,Marshall,16,36,155,30,13,137,2,0,East Carolina,19,38,100,37,26,287,0,1,V,-8,-3,-2,55,-7,-13,-150,2,-1,2008
1087,1087,11/08/2008,Memphis,31,55,306,19,9,130,1,0,S-M-U,26,16,38,38,24,311,0,0,V,-1.5,5,39,268,-19,-15,-181,1,0,2008
1088,1088,11/08/2008,Michigan,29,42,232,30,18,203,0,1,Minnesota,6,28,83,24,13,105,1,0,V,-7.5,23,14,149,6,5,98,-1,1,2008
1089,1089,11/08/2008,Michigan State,21,42,146,22,10,154,2,2,Purdue,7,40,108,30,13,83,1,0,H,10,14,2,38,-8,-3,71,1,2,2008
1090,1090,11/08/2008,Middle Tennessee,24,35,90,26,16,278,0,1,UL-Monroe,21,43,236,31,19,212,1,0,H,4.5,3,-8,-146,-5,-3,66,-1,1,2008
1091,1091,11/08/2008,Minnesota,6,28,83,24,13,105,1,0,Michigan,29,42,232,30,18,203,0,1,H,7.5,-23,-14,-149,-6,-5,-98,1,-1,2008
1092,1092,11/08/2008,Missouri,41,39,221,40,26,290,2,0,Kansas State,24,33,194,42,22,169,1,1,H,27,17,6,27,-2,4,121,1,-1,2008
1093,1093,11/08/2008,Nebraska,45,35,167,38,29,328,1,2,Kansas,35,39,118,30,15,304,1,0,H,1.5,10,-4,49,8,14,24,0,2,2008
1094,1094,11/08/2008,Nevada-Las Vegas,27,32,55,34,17,203,0,1,New Mexico,20,48,232,27,12,148,2,0,H,-5.5,7,-16,-177,7,5,55,-2,1,2008
1095,1095,11/08/2008,New Mexico,20,48,232,27,12,148,2,0,Nevada-Las Vegas,27,32,55,34,17,203,0,1,V,5.5,-7,16,177,-7,-5,-55,2,-1,2008
1096,1096,11/08/2008,New Mexico State,30,21,6,38,24,394,2,1,Hawaii,42,37,144,35,27,303,0,3,H,-3.5,-12,-16,-138,3,-3,91,2,-2,2008
1097,1097,11/08/2008,No Carolina State,27,34,159,25,13,218,0,0,Duke,17,28,94,52,37,317,0,0,V,-3.5,10,6,65,-27,-24,-99,0,0,2008
1098,1098,11/08/2008,North Carolina,28,42,186,19,8,128,0,0,Georgia Tech,7,54,326,23,10,97,1,2,H,4.5,21,-12,-140,-4,-2,31,-1,-2,2008
1099,1099,11/08/2008,North Texas,13,37,122,24,14,133,2,2,Florida Atlantic,46,41,256,28,17,251,2,1,V,-22.5,-33,-4,-134,-4,-3,-118,0,1,2008
1100,1100,11/08/2008,Northwestern,10,43,117,27,18,177,1,2,Ohio State,45,45,244,16,9,197,0,0,H,-12.5,-35,-2,-127,11,9,-20,1,2,2008
1101,1101,11/08/2008,Notre Dame,0,21,66,46,26,226,4,1,Boston College,17,41,167,22,9,79,0,0,V,-3.5,-17,-20,-101,24,17,147,4,1,2008
1102,1102,11/08/2008,Ohio,3,28,40,30,13,188,2,-1,Bowling Green,28,34,93,30,23,229,0,0,H,-2.5,-25,-6,-53,0,-10,-41,2,-1,2008
1103,1103,11/08/2008,Ohio State,45,45,244,16,9,197,0,0,Northwestern,10,43,117,27,18,177,1,2,V,12.5,35,2,127,-11,-9,20,-1,-2,2008
1104,1104,11/08/2008,Oklahoma,66,38,328,36,23,325,0,0,Texas A+M,28,29,26,51,22,252,2,2,V,27.5,38,9,302,-15,1,73,-2,-2,2008
1105,1105,11/08/2008,Oklahoma State,20,34,186,29,16,182,1,1,Texas Tech,56,25,113,55,45,516,0,2,V,-3.5,-36,9,73,-26,-29,-334,1,-1,2008
1106,1106,11/08/2008,Oregon,35,41,307,21,11,144,0,4,Stanford,28,49,187,22,15,138,0,1,H,14,7,-8,120,-1,-4,6,0,3,2008
1107,1107,11/08/2008,Oregon State,34,48,201,22,16,222,1,1,U.C.L.A.,6,27,48,43,20,189,3,1,V,7.5,28,21,153,-21,-4,33,-2,0,2008
1108,1108,11/08/2008,Penn State,23,46,180,24,10,109,1,1,Iowa,24,32,101,25,15,171,1,1,V,8,-1,14,79,-1,-5,-62,0,0,2008
1109,1109,11/08/2008,Pittsburgh,41,34,90,28,16,230,0,0,Louisville,7,30,96,38,19,203,2,3,H,6.5,34,4,-6,-10,-3,27,-2,-3,2008
1110,1110,11/08/2008,Purdue,7,40,108,30,13,83,1,0,Michigan State,21,42,146,22,10,154,2,2,V,-10,-14,-2,-38,8,3,-71,-1,-2,2008
1111,1111,11/08/2008,Rice,38,29,133,28,21,384,0,2,Army,31,65,461,15,6,31,0,3,H,9.5,7,-36,-328,13,15,353,0,-1,2008
1112,1112,11/08/2008,Rutgers,35,38,207,36,26,276,2,1,Syracuse,17,26,133,19,5,35,0,1,H,14,18,12,74,17,21,241,2,0,2008
1113,1113,11/08/2008,S-M-U,26,16,38,38,24,311,0,0,Memphis,31,55,306,19,9,130,1,0,H,1.5,-5,-39,-268,19,15,181,-1,0,2008
1114,1114,11/08/2008,San Diego State,12,28,120,37,21,160,1,3,Brigham Young,41,37,104,30,25,317,0,1,V,-36,-29,-9,16,7,-4,-157,1,2,2008
1115,1115,11/08/2008,San Jose State,0,28,30,28,11,118,2,0,Louisiana Tech,21,47,217,16,7,97,0,0,H,7,-21,-19,-187,12,4,21,2,0,2008
1116,1116,11/08/2008,South Carolina,34,34,132,30,13,219,1,0,Arkansas,21,31,54,34,20,255,3,0,H,13,13,3,78,-4,-7,-36,-2,0,2008
1117,1117,11/08/2008,Southern Cal,17,36,173,30,18,238,0,1,California,3,26,27,31,15,138,1,0,H,22.5,14,10,146,-1,3,100,-1,1,2008
1118,1118,11/08/2008,Southern Miss,17,54,150,34,21,188,0,0,U-C-F,6,16,64,33,13,144,2,0,V,3,11,38,86,1,8,44,-2,0,2008
1119,1119,11/08/2008,Stanford,28,49,187,22,15,138,0,1,Oregon,35,41,307,21,11,144,0,4,V,-14,-7,8,-120,1,4,-6,0,-3,2008
1120,1120,11/08/2008,Syracuse,17,26,133,19,5,35,0,1,Rutgers,35,38,207,36,26,276,2,1,V,-14,-18,-12,-74,-17,-21,-241,-2,0,2008
1121,1121,11/08/2008,Tennessee,7,31,101,36,14,118,2,0,Wyoming,13,48,167,17,9,99,0,1,H,27,-6,-17,-66,19,5,19,2,-1,2008
1122,1122,11/08/2008,Texas,45,47,194,37,26,300,2,0,Baylor,21,29,201,20,6,71,1,0,H,26,24,18,-7,17,20,229,1,0,2008
1123,1123,11/08/2008,Texas A+M,28,29,26,51,22,252,2,2,Oklahoma,66,38,328,36,23,325,0,0,H,-27.5,-38,-9,-302,15,-1,-73,2,2,2008
1124,1124,11/08/2008,Texas Tech,56,25,113,55,45,516,0,2,Oklahoma State,20,34,186,29,16,182,1,1,H,3.5,36,-9,-73,26,29,334,-1,1,2008
1125,1125,11/08/2008,Troy,17,32,132,47,30,297,1,1,Western Kentucky,7,35,121,33,15,95,1,0,H,17,10,-3,11,14,15,202,0,1,2008
1126,1126,11/08/2008,Tulane,14,27,61,44,20,207,0,0,Houston,42,37,299,43,30,394,1,2,V,-16.5,-28,-10,-238,1,-10,-187,-1,-2,2008
1127,1127,11/08/2008,U-C-F,6,16,64,33,13,144,2,0,Southern Miss,17,54,150,34,21,188,0,0,H,-3,-11,-38,-86,-1,-8,-44,2,0,2008
1128,1128,11/08/2008,U.C.L.A.,6,27,48,43,20,189,3,1,Oregon State,34,48,201,22,16,222,1,1,H,-7.5,-28,-21,-153,21,4,-33,2,0,2008
1129,1129,11/08/2008,UL-Lafayette,24,35,199,25,14,185,3,1,UTEP,37,33,114,33,24,294,1,1,H,10,-13,2,85,-8,-10,-109,2,0,2008
1130,1130,11/08/2008,UL-Monroe,21,43,236,31,19,212,1,0,Middle Tennessee,24,35,90,26,16,278,0,1,V,-4.5,-3,8,146,5,3,-66,1,-1,2008
1131,1131,11/08/2008,UTEP,37,33,114,33,24,294,1,1,UL-Lafayette,24,35,199,25,14,185,3,1,V,-10,13,-2,-85,8,10,109,-2,0,2008
1132,1132,11/08/2008,Utah State,14,21,44,41,22,261,3,3,Boise State,49,36,105,42,32,458,1,2,V,-35,-35,-15,-61,-1,-10,-197,2,1,2008
1133,1133,11/08/2008,Vanderbilt,14,39,150,22,12,114,1,0,Florida,42,38,231,21,15,191,1,1,H,-24,-28,1,-81,1,-3,-77,0,-1,2008
1134,1134,11/08/2008,Virginia,17,17,28,45,23,279,3,1,Wake Forest,28,49,143,20,14,130,0,1,V,-3.5,-11,-32,-115,25,9,149,3,0,2008
1135,1135,11/08/2008,Wake Forest,28,49,143,20,14,130,0,1,Virginia,17,17,28,45,23,279,3,1,H,3.5,11,32,115,-25,-9,-149,-3,0,2008
1136,1136,11/08/2008,Washington,19,28,52,42,15,227,2,1,Arizona State,39,40,182,31,22,218,0,1,H,-14,-20,-12,-130,11,-7,9,2,0,2008
1137,1137,11/08/2008,Washington State,28,29,94,20,10,114,3,1,Arizona,59,57,317,15,11,214,1,1,H,-41,-31,-28,-223,5,-1,-100,2,0,2008
1138,1138,11/08/2008,West Virginia,23,42,98,38,20,219,1,1,Cincinnati,26,33,82,30,16,178,0,0,H,6.5,-3,9,16,8,4,41,1,1,2008
1139,1139,11/08/2008,Western Kentucky,7,35,121,33,15,95,1,0,Troy,17,33,131,46,30,298,1,1,V,-17,-10,2,-10,-13,-15,-203,0,-1,2008
1140,1140,11/08/2008,Western Michigan,23,28,64,40,28,301,0,1,Illinois,17,30,115,45,20,328,2,0,N,-7,6,-2,-51,-5,8,-27,-2,1,2008
1141,1141,11/08/2008,Wisconsin,55,61,441,20,11,160,1,3,Indiana,20,38,133,34,13,141,0,1,V,10,35,23,308,-14,-2,19,1,2,2008
1142,1142,11/08/2008,Wyoming,13,48,167,17,9,99,0,1,Tennessee,7,31,101,36,14,118,2,0,V,-27,6,17,66,-19,-5,-19,-2,1,2008
1143,1143,11/11/2008,Ball State,31,38,195,24,17,289,1,1,Miami-Ohio,16,26,76,42,25,254,0,1,V,17.5,15,12,119,-18,-8,35,1,0,2008
1144,1144,11/11/2008,Miami-Ohio,16,26,76,42,25,254,0,1,Ball State,31,38,195,24,17,289,1,1,H,-17.5,-15,-12,-119,18,8,-35,-1,0,2008
1145,1145,11/12/2008,Central Michigan,33,49,241,26,19,189,0,1,Northern Illinois,30,35,80,38,18,288,2,0,V,-4,3,14,161,-12,1,-99,-2,1,2008
1146,1146,11/12/2008,Kent State,41,59,329,26,18,232,1,2,Temple,38,30,72,29,17,282,1,3,H,-1,3,29,257,-3,1,-50,0,-1,2008
1147,1147,11/12/2008,Northern Illinois,30,35,80,38,18,288,2,0,Central Michigan,33,49,241,26,19,189,0,1,H,4,-3,-14,-161,12,-1,99,2,-1,2008
1148,1148,11/12/2008,Temple,38,30,72,29,17,282,1,3,Kent State,41,59,329,26,18,232,1,2,V,1,-3,-29,-257,3,-1,50,0,1,2008
1149,1149,11/13/2008,Akron,40,34,179,38,20,295,0,2,Buffalo,43,57,224,39,27,252,0,0,H,2.5,-3,-23,-45,-1,-7,43,0,2,2008
1150,1150,11/13/2008,Buffalo,43,57,224,39,27,252,0,0,Akron,40,34,179,38,20,295,0,2,V,-2.5,3,23,45,1,7,-43,0,-2,2008
1151,1151,11/13/2008,Miami-Florida,16,42,123,18,8,124,0,1,Virginia Tech,14,38,77,20,12,173,0,0,H,4,2,4,46,-2,-4,-49,0,1,2008
1152,1152,11/13/2008,Nevada-Las Vegas,22,50,166,31,17,157,0,0,Wyoming,14,32,141,21,12,143,2,1,H,6,8,18,25,10,5,14,-2,-1,2008
1153,1153,11/13/2008,Virginia Tech,14,38,77,20,12,173,0,0,Miami-Florida,16,42,123,18,8,124,0,1,V,-4,-2,-4,-46,2,4,49,0,-1,2008
1154,1154,11/13/2008,Wyoming,14,33,151,21,12,143,2,1,Nevada-Las Vegas,22,50,166,31,17,157,0,0,V,-6,-8,-17,-15,-10,-5,-14,2,1,2008
1155,1155,11/14/2008,Cincinnati,28,31,131,36,20,274,1,1,Louisville,20,37,120,35,19,204,1,1,V,4,8,-6,11,1,1,70,0,0,2008
1156,1156,11/14/2008,Louisville,20,37,120,35,19,204,1,1,Cincinnati,28,31,131,36,20,274,1,1,H,-4,-8,6,-11,-1,-1,-70,0,0,2008
1157,1157,11/15/2008,Air Force,24,51,323,20,12,98,1,1,Brigham Young,38,36,126,37,28,354,1,1,H,-3.5,-14,15,197,-17,-16,-256,0,0,2008
1158,1158,11/15/2008,Alabama,32,48,198,19,12,166,0,0,Mississippi State,7,22,35,28,11,132,0,1,H,22,25,26,163,-9,1,34,0,-1,2008
1159,1159,11/15/2008,Arizona,45,52,199,46,29,328,2,1,Oregon,55,30,206,27,21,298,0,1,V,-6,-10,22,-7,19,8,30,2,0,2008
1160,1160,11/15/2008,Arizona State,31,36,141,31,20,257,0,0,Washington State,0,24,7,30,18,123,1,1,H,35.5,31,12,134,1,2,134,-1,-1,2008
1161,1161,11/15/2008,Auburn,13,36,132,31,16,179,0,1,Georgia,17,33,136,24,15,215,0,1,H,-9,-4,3,-4,7,1,-36,0,0,2008
1162,1162,11/15/2008,Baylor,41,52,269,23,13,241,0,0,Texas A+M,21,21,64,30,19,244,4,1,H,8,20,31,205,-7,-6,-3,-4,-1,2008
1163,1163,11/15/2008,Boise State,45,38,315,34,23,210,0,1,Idaho,10,37,104,29,15,225,2,1,V,36.5,35,1,211,5,8,-15,-2,0,2008
1164,1164,11/15/2008,Boston College,27,47,176,27,14,181,1,2,Florida State,17,24,73,32,16,212,3,0,V,-6,10,23,103,-5,-2,-31,-2,2,2008
1165,1165,11/15/2008,Brigham Young,38,36,126,37,28,354,1,1,Air Force,24,51,323,20,12,98,1,1,V,3.5,14,-15,-197,17,16,256,0,0,2008
1166,1166,11/15/2008,California,21,30,85,27,12,147,1,1,Oregon State,34,42,194,28,14,145,1,0,V,-3.5,-13,-12,-109,-1,-2,2,0,1,2008
1167,1167,11/15/2008,Clemson,31,41,140,38,27,326,0,0,Duke,7,29,83,27,13,85,2,0,H,10,24,12,57,11,14,241,-2,0,2008
1168,1168,11/15/2008,Colorado,17,35,133,38,19,171,0,1,Oklahoma State,30,40,226,23,15,217,1,0,H,-18,-13,-5,-93,15,4,-46,-1,1,2008
1169,1169,11/15/2008,Colorado State,20,43,152,27,16,237,2,0,New Mexico,6,30,155,39,23,204,0,0,H,-3,14,13,-3,-12,-7,33,2,0,2008
1170,1170,11/15/2008,Connecticut,39,44,259,15,7,70,0,0,Syracuse,14,36,96,23,6,51,3,0,V,9,25,8,163,-8,1,19,-3,0,2008
1171,1171,11/15/2008,Duke,7,29,83,27,13,85,2,0,Clemson,31,41,140,38,27,326,0,0,V,-10,-24,-12,-57,-11,-14,-241,2,0,2008
1172,1172,11/15/2008,East Carolina,3,21,66,34,20,189,2,0,Southern Miss,21,40,145,30,18,239,0,1,V,-3,-18,-19,-79,4,2,-50,2,-1,2008
1173,1173,11/15/2008,Florida,56,41,346,22,13,173,0,2,South Carolina,6,25,53,37,19,120,3,1,H,21,50,16,293,-15,-6,53,-3,1,2008
1174,1174,11/15/2008,Florida Atlantic,40,33,216,28,18,307,0,1,UL-Lafayette,29,46,222,34,25,210,3,1,H,1,11,-13,-6,-6,-7,97,-3,0,2008
1175,1175,11/15/2008,Florida State,17,24,73,32,16,212,3,0,Boston College,27,47,176,27,14,181,1,2,H,6,-10,-23,-103,5,2,31,2,-2,2008
1176,1176,11/15/2008,Fresno State,24,50,189,20,14,146,0,1,New Mexico State,17,15,-9,38,27,192,0,1,H,17,7,35,198,-18,-13,-46,0,0,2008
1177,1177,11/15/2008,Georgia,17,33,136,24,15,215,0,1,Auburn,13,36,124,31,16,179,0,1,V,9,4,-3,12,-7,-1,36,0,0,2008
1178,1178,11/15/2008,Houston,70,35,180,42,29,461,0,1,Tulsa,30,46,192,35,21,309,3,2,H,-4,40,-11,-12,7,8,152,-3,-1,2008
1179,1179,11/15/2008,Idaho,10,37,104,29,15,225,2,1,Boise State,45,38,315,34,23,210,0,1,H,-36.5,-35,-1,-211,-5,-8,15,2,0,2008
1180,1180,11/15/2008,Illinois,20,35,214,34,20,241,1,1,Ohio State,30,52,305,10,6,49,0,1,H,-8.5,-10,-17,-91,24,14,192,1,0,2008
1181,1181,11/15/2008,Indiana,7,30,123,23,9,57,1,0,Penn State,34,38,184,39,22,258,1,2,V,-35.5,-27,-8,-61,-16,-13,-201,0,-2,2008
1182,1182,11/15/2008,Iowa,22,38,248,15,8,72,0,2,Purdue,17,32,86,52,37,251,1,1,H,17,5,6,162,-37,-29,-179,-1,1,2008
1183,1183,11/15/2008,Iowa State,20,23,118,54,36,326,2,0,Missouri,52,25,151,40,32,328,1,1,H,-26.5,-32,-2,-33,14,4,-2,1,-1,2008
1184,1184,11/15/2008,Kansas,7,24,47,50,25,258,0,2,Texas,35,37,166,34,24,255,0,1,H,-14,-28,-13,-119,16,1,3,0,1,2008
1185,1185,11/15/2008,Kansas State,28,32,59,26,12,188,0,1,Nebraska,56,53,340,25,16,270,1,1,H,-6,-28,-21,-281,1,-4,-82,-1,0,2008
1186,1186,11/15/2008,Kentucky,24,24,97,26,11,144,2,0,Vanderbilt,31,43,213,27,15,155,0,1,H,3.5,-7,-19,-116,-1,-4,-11,2,-1,2008
1187,1187,11/15/2008,Louisiana State,40,39,119,41,21,221,1,0,Troy,31,17,64,72,34,316,1,2,H,16.5,9,22,55,-31,-13,-95,0,-2,2008
1188,1188,11/15/2008,Louisiana Tech,45,52,200,18,12,145,2,1,Utah State,38,39,164,18,12,204,3,0,H,15,7,13,36,0,0,-59,-1,1,2008
1189,1189,11/15/2008,Marshall,14,29,145,29,7,84,2,2,U-C-F,30,65,213,17,4,29,0,1,H,7,-16,-36,-68,12,3,55,2,1,2008
1190,1190,11/15/2008,Maryland,17,53,195,32,16,141,0,1,North Carolina,15,26,75,25,11,210,1,1,H,-3,2,27,120,7,5,-69,-1,0,2008
1191,1191,11/15/2008,Michigan,14,46,181,36,12,83,1,1,Northwestern,21,37,59,29,17,198,2,0,H,3.5,-7,9,122,7,-5,-115,-1,1,2008
1192,1192,11/15/2008,Middle Tennessee,21,41,101,30,19,212,1,1,Western Kentucky,10,33,68,30,18,213,1,1,V,1,11,8,33,0,1,-1,0,0,2008
1193,1193,11/15/2008,Minnesota,32,29,99,30,15,202,1,2,Wisconsin,35,45,116,31,18,242,0,3,V,-14,-3,-16,-17,-1,-3,-40,1,-1,2008
1194,1194,11/15/2008,Mississippi,59,53,350,12,6,170,0,0,UL-Monroe,0,34,72,18,7,59,2,0,H,24,59,19,278,-6,-1,111,-2,0,2008
1195,1195,11/15/2008,Mississippi State,7,22,35,28,11,132,0,1,Alabama,32,48,198,19,12,166,0,0,V,-22,-25,-26,-163,9,-1,-34,0,1,2008
1196,1196,11/15/2008,Missouri,52,25,151,40,32,328,1,1,Iowa State,20,23,118,54,36,326,2,0,V,26.5,32,2,33,-14,-4,2,-1,1,2008
1197,1197,11/15/2008,Navy,21,45,178,14,3,64,0,1,Notre Dame,27,51,230,19,15,110,2,3,H,-4.5,-6,-6,-52,-5,-12,-46,-2,-2,2008
1198,1198,11/15/2008,Nebraska,56,53,340,25,16,270,1,1,Kansas State,28,32,59,26,12,188,0,1,V,6,28,21,281,-1,4,82,1,0,2008
1199,1199,11/15/2008,Nevada-Reno,41,49,333,31,15,192,0,0,San Jose State,17,16,-23,41,20,301,0,1,H,14.5,24,33,356,-10,-5,-109,0,-1,2008
1200,1200,11/15/2008,New Mexico,6,29,145,39,23,204,0,0,Colorado State,20,43,152,27,16,237,2,0,V,3,-14,-14,-7,12,7,-33,-2,0,2008
1201,1201,11/15/2008,New Mexico State,17,15,-9,38,27,192,0,1,Fresno State,24,50,189,20,14,146,0,1,V,-17,-7,-35,-198,18,13,46,0,0,2008
1202,1202,11/15/2008,No Carolina State,21,39,149,33,16,152,0,1,Wake Forest,17,30,98,34,22,240,1,0,H,-3.5,4,9,51,-1,-6,-88,-1,1,2008
1203,1203,11/15/2008,North Carolina,15,26,75,25,11,210,1,1,Maryland,17,53,195,32,16,141,0,1,V,3,-2,-27,-120,-7,-5,69,1,0,2008
1204,1204,11/15/2008,Northwestern,21,37,59,29,17,198,2,0,Michigan,14,46,181,36,12,83,1,1,V,-3.5,7,-9,-122,-7,5,115,1,-1,2008
1205,1205,11/15/2008,Notre Dame,27,51,230,19,15,110,2,3,Navy,21,45,178,14,3,64,0,1,V,4.5,6,6,52,5,12,46,2,2,2008
1206,1206,11/15/2008,Ohio State,30,52,305,10,6,49,0,1,Illinois,20,35,214,34,20,241,1,1,V,8.5,10,17,91,-24,-14,-192,-1,0,2008
1207,1207,11/15/2008,Oklahoma State,30,40,226,23,15,217,1,0,Colorado,17,35,133,38,19,171,0,1,V,18,13,5,93,-15,-4,46,1,-1,2008
1208,1208,11/15/2008,Oregon,55,30,206,27,21,298,0,1,Arizona,45,52,199,46,29,328,2,1,H,6,10,-22,7,-19,-8,-30,-2,0,2008
1209,1209,11/15/2008,Oregon State,34,42,194,28,14,145,1,0,California,21,30,85,27,12,147,1,1,H,3.5,13,12,109,1,2,-2,0,-1,2008
1210,1210,11/15/2008,Penn State,34,38,184,39,22,258,1,2,Indiana,7,30,123,23,9,57,1,0,H,35.5,27,8,61,16,13,201,0,2,2008
1211,1211,11/15/2008,Purdue,17,32,86,52,37,251,1,1,Iowa,22,38,248,15,8,72,0,2,V,-17,-5,-6,-162,37,29,179,1,-1,2008
1212,1212,11/15/2008,Rutgers,49,35,127,30,19,294,2,0,South Florida,16,28,76,48,31,328,3,3,V,-8,33,7,51,-18,-12,-34,-1,-3,2008
1213,1213,11/15/2008,S-M-U,10,20,64,36,13,137,4,2,UTEP,36,44,134,34,21,410,0,0,V,-14,-26,-24,-70,2,-8,-273,4,2,2008
1214,1214,11/15/2008,San Diego State,14,19,73,41,23,247,2,1,Utah,63,40,198,40,28,322,1,0,H,-30,-49,-21,-125,1,-5,-75,1,1,2008
1215,1215,11/15/2008,San Jose State,17,16,-23,41,20,301,0,1,Nevada-Reno,41,49,333,31,15,192,0,0,V,-14.5,-24,-33,-356,10,5,109,0,1,2008
1216,1216,11/15/2008,South Carolina,6,25,53,37,19,120,3,1,Florida,56,41,346,22,13,173,0,2,V,-21,-50,-16,-293,15,6,-53,3,-1,2008
1217,1217,11/15/2008,South Florida,16,28,76,48,31,328,3,3,Rutgers,49,35,127,30,19,294,2,0,H,8,-33,-7,-51,18,12,34,1,3,2008
1218,1218,11/15/2008,Southern Cal,45,43,282,18,11,136,0,1,Stanford,23,41,202,27,14,165,1,0,V,24,22,2,80,-9,-3,-29,-1,1,2008
1219,1219,11/15/2008,Southern Miss,21,40,145,30,18,239,0,1,East Carolina,3,21,66,34,20,189,2,0,H,3,18,19,79,-4,-2,50,-2,1,2008
1220,1220,11/15/2008,Stanford,23,41,202,27,14,165,1,0,Southern Cal,45,43,282,18,11,136,0,1,H,-24,-22,-2,-80,9,3,29,1,-1,2008
1221,1221,11/15/2008,Syracuse,14,36,96,23,6,51,3,0,Connecticut,39,44,259,15,7,70,0,0,H,-9,-25,-8,-163,8,-1,-19,3,0,2008
1222,1222,11/15/2008,Texas,35,37,166,34,24,255,0,1,Kansas,7,24,47,50,25,258,0,2,V,14,28,13,119,-16,-1,-3,0,-1,2008
1223,1223,11/15/2008,Texas A+M,21,21,64,30,19,244,4,1,Baylor,41,52,269,23,13,241,0,0,V,-8,-20,-31,-205,7,6,3,4,1,2008
1224,1224,11/15/2008,Toledo,17,35,145,31,18,213,1,1,Western Michigan,27,33,146,36,22,225,1,1,V,-14.5,-10,2,-1,-5,-4,-12,0,0,2008
1225,1225,11/15/2008,Troy,31,17,64,72,34,316,1,2,Louisiana State,40,39,119,41,21,221,1,0,V,-16.5,-9,-22,-55,31,13,95,0,2,2008
1226,1226,11/15/2008,Tulane,24,26,98,34,17,263,4,0,U-A-B,41,46,272,21,15,154,0,1,H,4,-17,-20,-174,13,2,109,4,-1,2008
1227,1227,11/15/2008,Tulsa,30,46,192,35,21,309,3,2,Houston,70,35,180,42,29,461,0,1,V,4,-40,11,12,-7,-8,-152,3,1,2008
1228,1228,11/15/2008,U-A-B,41,46,272,21,15,154,0,1,Tulane,24,26,98,34,17,263,4,0,V,-4,17,20,174,-13,-2,-109,-4,1,2008
1229,1229,11/15/2008,U-C-F,30,65,213,17,4,29,0,1,Marshall,14,29,145,29,7,84,2,2,V,-7,16,36,68,-12,-3,-55,-2,-1,2008
1230,1230,11/15/2008,U.C.L.A.,27,50,157,22,13,135,3,0,Washington,7,30,96,24,7,39,3,2,V,7,20,20,61,-2,6,96,0,-2,2008
1231,1231,11/15/2008,UL-Lafayette,29,47,228,33,24,204,3,1,Florida Atlantic,40,33,216,28,18,307,0,1,V,-1,-11,14,12,5,6,-103,3,0,2008
1232,1232,11/15/2008,UL-Monroe,0,34,72,18,7,59,2,0,Mississippi,59,53,350,12,6,170,0,0,V,-24,-59,-19,-278,6,1,-111,2,0,2008
1233,1233,11/15/2008,UTEP,36,44,134,34,21,410,0,0,S-M-U,10,20,64,36,13,137,4,2,H,14,26,24,70,-2,8,273,-4,-2,2008
1234,1234,11/15/2008,Utah,63,40,198,40,28,322,1,0,San Diego State,14,19,73,41,23,247,2,1,V,30,49,21,125,-1,5,75,-1,-1,2008
1235,1235,11/15/2008,Utah State,38,39,164,18,12,204,3,0,Louisiana Tech,45,52,200,18,12,145,2,1,V,-15,-7,-13,-36,0,0,59,1,-1,2008
1236,1236,11/15/2008,Vanderbilt,31,43,213,27,15,155,0,1,Kentucky,24,24,97,26,11,144,2,0,V,-3.5,7,19,116,1,4,11,-2,1,2008
1237,1237,11/15/2008,Wake Forest,17,30,98,34,22,240,1,0,No Carolina State,21,39,149,33,16,152,0,1,V,3.5,-4,-9,-51,1,6,88,1,-1,2008
1238,1238,11/15/2008,Washington,7,30,96,24,7,39,3,2,U.C.L.A.,27,50,157,22,13,135,3,0,H,-7,-20,-20,-61,2,-6,-96,0,2,2008
1239,1239,11/15/2008,Washington State,0,24,7,30,18,123,1,1,Arizona State,31,36,141,31,20,257,0,0,V,-35.5,-31,-12,-134,-1,-2,-134,1,1,2008
1240,1240,11/15/2008,Western Kentucky,10,33,68,30,18,213,1,1,Middle Tennessee,21,41,101,30,19,212,1,1,H,-1,-11,-8,-33,0,-1,1,0,0,2008
1241,1241,11/15/2008,Western Michigan,27,33,146,36,22,225,1,1,Toledo,17,35,145,31,18,213,1,1,H,14.5,10,-2,1,5,4,12,0,0,2008
1242,1242,11/15/2008,Wisconsin,35,45,116,31,18,242,0,3,Minnesota,32,29,99,30,15,202,1,2,H,14,3,16,17,1,3,40,-1,1,2008
1243,1243,11/18/2008,Kent State,14,34,127,21,11,126,0,3,Northern Illinois,42,45,224,19,12,173,0,0,H,-3,-28,-11,-97,2,-1,-47,0,3,2008
1244,1244,11/18/2008,Northern Illinois,42,45,224,19,12,173,0,0,Kent State,14,34,127,21,11,126,0,3,V,3,28,11,97,-2,1,47,0,-3,2008
1245,1245,11/19/2008,Ball State,31,39,232,22,12,175,0,0,Central Michigan,24,40,121,45,30,345,1,0,V,6,7,-1,111,-23,-18,-170,-1,0,2008
1246,1246,11/19/2008,Central Michigan,24,40,121,45,30,345,1,0,Ball State,31,39,232,22,12,175,0,0,H,-6,-7,1,-111,23,18,170,1,0,2008
1247,1247,11/20/2008,Georgia Tech,41,56,472,7,4,46,0,1,Miami-Florida,23,25,105,38,23,283,2,0,H,3,18,31,367,-31,-19,-237,-2,1,2008
1248,1248,11/20/2008,Miami-Florida,23,25,105,38,23,283,2,0,Georgia Tech,41,56,472,7,4,46,0,1,V,-3,-18,-31,-367,31,19,237,2,-1,2008
1249,1249,11/21/2008,Bowling Green,34,47,139,33,24,240,1,1,Buffalo,40,25,74,41,29,297,1,0,H,4.5,-6,22,65,-8,-5,-57,0,1,2008
1250,1250,11/21/2008,Buffalo,40,25,74,41,29,297,1,0,Bowling Green,34,47,139,33,24,240,1,1,V,-4.5,6,-22,-65,8,5,57,0,-1,2008
1251,1251,11/21/2008,Fresno State,24,43,171,18,5,71,1,2,San Jose State,10,31,-5,37,21,205,0,1,V,3,14,12,176,-19,-16,-134,1,1,2008
1252,1252,11/21/2008,Miami-Ohio,14,23,75,46,29,196,2,2,Toledo,42,46,377,26,14,139,0,1,V,-3.5,-28,-23,-302,20,15,57,2,1,2008
1253,1253,11/21/2008,San Jose State,10,31,-5,37,21,205,0,1,Fresno State,24,43,171,18,5,71,1,2,H,-3,-14,-12,-176,19,16,134,-1,-1,2008
1254,1254,11/21/2008,Toledo,42,46,377,26,14,139,0,1,Miami-Ohio,14,23,75,46,29,196,2,2,H,3.5,28,23,302,-20,-15,-57,-2,-1,2008
1255,1255,11/22/2008,Air Force,10,37,150,10,3,11,0,0,Texas Christian,44,52,183,27,21,321,0,0,V,-20,-34,-15,-33,-17,-18,-310,0,0,2008
1256,1256,11/22/2008,Akron,42,47,139,37,21,235,0,0,Ohio,49,23,91,28,20,222,0,2,V,2,-7,24,48,9,1,13,0,-2,2008
1257,1257,11/22/2008,Arizona,17,41,139,22,16,158,0,0,Oregon State,19,33,166,32,20,224,0,0,H,2.5,-2,8,-27,-10,-4,-66,0,0,2008
1258,1258,11/22/2008,Arkansas,28,26,109,44,25,333,1,0,Mississippi State,31,35,226,40,23,219,0,1,V,2.5,-3,-9,-117,4,2,114,1,-1,2008
1259,1259,11/22/2008,Arkansas State,28,42,203,28,20,279,1,0,Florida Atlantic,14,23,63,38,16,196,1,1,H,3.5,14,19,140,-10,4,83,0,-1,2008
1260,1260,11/22/2008,Army,3,47,217,4,2,2,0,2,Rutgers,30,30,162,34,23,359,0,2,V,-17.5,-27,17,55,-30,-21,-357,0,0,2008
1261,1261,11/22/2008,Boise State,41,26,70,48,29,414,3,1,Nevada-Reno,34,35,144,51,19,241,0,0,V,7,7,-9,-74,-3,10,173,3,1,2008
1262,1262,11/22/2008,Boston College,24,44,97,27,16,137,0,3,Wake Forest,21,28,65,28,14,126,2,0,V,2.5,3,16,32,-1,2,11,-2,3,2008
1263,1263,11/22/2008,Brigham Young,24,30,214,41,21,205,5,1,Utah,48,35,108,37,31,307,0,0,V,-7,-24,-5,106,4,-10,-102,5,1,2008
1264,1264,11/22/2008,California,37,38,287,11,7,101,1,0,Stanford,16,37,123,39,23,312,3,1,H,8,21,1,164,-28,-16,-211,-2,-1,2008
1265,1265,11/22/2008,Cincinnati,28,38,87,32,26,309,0,1,Pittsburgh,21,26,35,29,18,229,1,1,H,6,7,12,52,3,8,80,-1,0,2008
1266,1266,11/22/2008,Clemson,13,39,56,29,19,136,0,1,Virginia,3,24,30,39,24,160,3,1,V,2.5,10,15,26,-10,-5,-24,-3,0,2008
1267,1267,11/22/2008,Colorado State,31,38,186,29,16,236,2,1,Wyoming,20,45,209,43,22,220,0,3,V,-1,11,-7,-23,-14,-6,16,2,-2,2008
1268,1268,11/22/2008,Duke,3,40,116,9,2,20,4,0,Virginia Tech,14,47,187,25,14,147,3,2,V,-15,-11,-7,-71,-16,-12,-127,1,-2,2008
1269,1269,11/22/2008,East Carolina,17,39,56,27,20,239,2,3,U-A-B,13,35,142,25,11,116,1,0,V,6.5,4,4,-86,2,9,123,1,3,2008
1270,1270,11/22/2008,Eastern Michigan,52,19,68,76,50,484,0,0,Temple,55,34,67,37,21,370,0,1,V,-12,-3,-15,1,39,29,114,0,-1,2008
1271,1271,11/22/2008,Florida,70,37,394,22,17,311,0,0,The Citadel,19,38,103,37,17,214,3,0,H, ,51,-1,291,-15,0,97,-3,0,2008
1272,1272,11/22/2008,Florida Atlantic,14,23,63,38,16,196,1,1,Arkansas State,28,42,203,28,20,279,1,0,V,-3.5,-14,-19,-140,10,-4,-83,0,1,2008
1273,1273,11/22/2008,Florida Intl,27,32,124,31,18,239,0,1,UL-Monroe,31,41,173,25,14,156,2,0,H,7,-4,-9,-49,6,4,83,-2,1,2008
1274,1274,11/22/2008,Florida State,37,42,172,26,20,160,0,0,Maryland,3,29,103,31,16,149,2,2,V,1.5,34,13,69,-5,4,11,-2,-2,2008
1275,1275,11/22/2008,Hawaii,49,28,70,29,17,286,0,1,Idaho,17,40,49,33,20,170,3,1,H,23.5,32,-12,21,-4,-3,116,-3,0,2008
1276,1276,11/22/2008,Houston,42,32,220,51,41,480,0,1,UTEP,37,33,102,45,27,362,0,0,H,17,5,-1,118,6,14,118,0,1,2008
1277,1277,11/22/2008,Idaho,17,40,49,33,20,170,3,1,Hawaii,49,28,70,29,17,286,0,1,V,-23.5,-32,12,-21,4,3,-116,3,0,2008
1278,1278,11/22/2008,Illinois,10,39,123,37,20,212,1,1,Northwestern,27,34,109,33,22,230,1,0,V,3,-17,5,14,4,-2,-18,0,1,2008
1279,1279,11/22/2008,Indiana,10,32,122,25,13,92,2,1,Purdue,62,33,117,58,41,479,0,0,V,-11.5,-52,-1,5,-33,-28,-387,2,1,2008
1280,1280,11/22/2008,Iowa,55,46,222,31,16,261,0,0,Minnesota,0,21,7,30,14,127,2,1,V,6,55,25,215,1,2,134,-2,-1,2008
1281,1281,11/22/2008,Iowa State,30,36,164,50,32,462,2,1,Kansas State,38,37,190,31,17,279,0,0,V,-10.5,-8,-1,-26,19,15,183,2,1,2008
1282,1282,11/22/2008,Kansas State,38,37,172,31,17,279,0,0,Iowa State,30,36,164,50,32,462,2,1,H,10.5,8,1,8,-19,-15,-183,-2,-1,2008
1283,1283,11/22/2008,Louisiana State,13,29,37,32,14,178,2,0,Mississippi,31,45,102,26,17,307,0,1,H,3,-18,-16,-65,6,-3,-129,2,-1,2008
1284,1284,11/22/2008,Louisiana Tech,35,35,226,20,12,132,0,0,New Mexico State,31,25,30,59,45,486,0,1,V,7,4,10,196,-39,-33,-354,0,-1,2008
1285,1285,11/22/2008,Louisville,21,38,198,47,27,276,3,2,West Virginia,35,41,376,11,6,122,0,1,H,-7.5,-14,-3,-178,36,21,154,3,1,2008
1286,1286,11/22/2008,Marshall,10,46,185,24,13,83,1,1,Rice,35,35,141,41,25,315,1,1,V,-8.5,-25,11,44,-17,-12,-232,0,0,2008
1287,1287,11/22/2008,Maryland,3,29,103,31,16,149,2,2,Florida State,37,42,172,26,20,160,0,0,H,-1.5,-34,-13,-69,5,-4,-11,2,2,2008
1288,1288,11/22/2008,Memphis,21,37,122,37,15,183,1,1,U-C-F,28,40,73,19,8,121,0,1,H,6,-7,-3,49,18,7,62,1,0,2008
1289,1289,11/22/2008,Michigan,7,41,111,25,8,87,0,2,Ohio State,42,43,232,16,8,184,1,0,V,-20.5,-35,-2,-121,9,0,-97,-1,2,2008
1290,1290,11/22/2008,Michigan State,18,24,35,49,32,287,2,0,Penn State,49,35,138,31,19,419,0,0,V,-16,-31,-11,-103,18,13,-132,2,0,2008
1291,1291,11/22/2008,Middle Tennessee,52,28,237,36,20,252,2,1,North Texas,13,36,143,39,25,221,0,3,H,18.5,39,-8,94,-3,-5,31,2,-2,2008
1292,1292,11/22/2008,Minnesota,0,21,7,30,14,127,2,1,Iowa,55,46,222,31,16,261,0,0,H,-6,-55,-25,-215,-1,-2,-134,2,1,2008
1293,1293,11/22/2008,Mississippi,31,45,102,26,17,307,0,1,Louisiana State,13,29,37,32,14,178,2,0,V,-3,18,16,65,-6,3,129,-2,1,2008
1294,1294,11/22/2008,Mississippi State,31,35,226,40,23,219,0,1,Arkansas,28,26,109,44,25,333,1,0,H,-2.5,3,9,117,-4,-2,-114,-1,1,2008
1295,1295,11/22/2008,Nevada-Las Vegas,21,23,33,40,26,316,2,1,San Diego State,42,30,92,50,35,387,0,0,V,10,-21,-7,-59,-10,-9,-71,2,1,2008
1296,1296,11/22/2008,Nevada-Reno,34,35,144,51,19,241,0,0,Boise State,41,26,70,48,29,414,3,1,H,-7,-7,9,74,3,-10,-173,-3,-1,2008
1297,1297,11/22/2008,New Mexico State,31,25,30,59,45,486,0,1,Louisiana Tech,35,35,226,20,12,132,0,0,H,-7,-4,-10,-196,39,33,354,0,1,2008
1298,1298,11/22/2008,No Carolina State,41,45,187,28,17,279,0,0,North Carolina,10,26,56,28,14,147,3,3,V,-11,31,19,131,0,3,132,-3,-3,2008
1299,1299,11/22/2008,North Carolina,10,26,56,28,14,147,3,3,No Carolina State,41,45,187,28,17,279,0,0,H,11,-31,-19,-131,0,-3,-132,3,3,2008
1300,1300,11/22/2008,North Texas,13,36,143,39,25,221,0,3,Middle Tennessee,52,28,237,36,20,252,2,1,V,-18.5,-39,8,-94,3,5,-31,-2,2,2008
1301,1301,11/22/2008,Northwestern,27,34,109,33,22,230,1,0,Illinois,10,39,123,37,20,212,1,1,H,-3,17,-5,-14,-4,2,18,0,-1,2008
1302,1302,11/22/2008,Notre Dame,23,28,41,41,22,291,0,0,Syracuse,24,36,170,26,14,147,0,2,H,19.5,-1,-8,-129,15,8,144,0,-2,2008
1303,1303,11/22/2008,Ohio,49,23,91,28,20,222,0,2,Akron,42,47,139,37,21,235,0,0,H,-2,7,-24,-48,-9,-1,-13,0,2,2008
1304,1304,11/22/2008,Ohio State,42,43,232,16,8,184,1,0,Michigan,7,41,111,25,8,87,0,2,H,20.5,35,2,121,-9,0,97,1,-2,2008
1305,1305,11/22/2008,Oklahoma,65,55,299,23,17,326,0,1,Texas Tech,21,22,45,55,33,361,1,2,H,7,44,33,254,-32,-16,-35,-1,-1,2008
1306,1306,11/22/2008,Oregon State,19,33,166,32,20,224,0,0,Arizona,17,41,139,22,16,158,0,0,V,-2.5,2,-8,27,10,4,66,0,0,2008
1307,1307,11/22/2008,Penn State,49,35,138,31,19,419,0,0,Michigan State,18,24,35,49,32,287,2,0,H,16,31,11,103,-18,-13,132,-2,0,2008
1308,1308,11/22/2008,Pittsburgh,21,26,35,29,18,229,1,1,Cincinnati,28,38,87,32,26,309,0,1,V,-6,-7,-12,-52,-3,-8,-80,1,0,2008
1309,1309,11/22/2008,Purdue,62,33,117,58,41,479,0,0,Indiana,10,32,122,25,13,92,2,1,H,11.5,52,1,-5,33,28,387,-2,-1,2008
1310,1310,11/22/2008,Rice,35,35,141,41,25,315,1,1,Marshall,10,46,185,24,13,83,1,1,H,8.5,25,-11,-44,17,12,232,0,0,2008
1311,1311,11/22/2008,Rutgers,30,30,162,34,23,359,0,2,Army,3,47,217,4,2,2,0,2,H,17.5,27,-17,-55,30,21,357,0,0,2008
1312,1312,11/22/2008,San Diego State,42,30,92,50,35,387,0,0,Nevada-Las Vegas,21,23,33,40,26,316,2,1,H,-10,21,7,59,10,9,71,-2,-1,2008
1313,1313,11/22/2008,Stanford,16,37,123,39,23,312,3,1,California,37,38,287,11,7,101,1,0,V,-8,-21,-1,-164,28,16,211,2,1,2008
1314,1314,11/22/2008,Syracuse,24,36,170,26,14,147,0,2,Notre Dame,23,28,41,41,22,291,0,0,V,-19.5,1,8,129,-15,-8,-144,0,2,2008
1315,1315,11/22/2008,Temple,55,34,67,37,21,370,0,1,Eastern Michigan,52,19,68,76,50,484,0,0,H,12,3,15,-1,-39,-29,-114,0,1,2008
1316,1316,11/22/2008,Tennessee,20,51,222,9,4,21,2,1,Vanderbilt,10,28,25,44,19,188,2,1,V,-3,10,23,197,-35,-15,-167,0,0,2008
1317,1317,11/22/2008,Texas Christian,44,52,183,27,21,321,0,0,Air Force,10,37,150,10,3,11,0,0,H,20,34,15,33,17,18,310,0,0,2008
1318,1318,11/22/2008,Texas Tech,21,22,45,55,33,361,1,2,Oklahoma,65,55,299,23,17,326,0,1,V,-7,-44,-33,-254,32,16,35,1,1,2008
1319,1319,11/22/2008,Troy,48,55,391,20,9,68,0,1,UL-Lafayette,3,35,183,15,7,72,2,0,H,10,45,20,208,5,2,-4,-2,1,2008
1320,1320,11/22/2008,Tulane,7,35,73,31,16,159,0,2,Tulsa,56,59,489,13,9,104,2,0,V,-28.5,-49,-24,-416,18,7,55,-2,2,2008
1321,1321,11/22/2008,Tulsa,56,59,489,13,9,104,2,0,Tulane,7,35,73,31,16,159,0,2,H,28.5,49,24,416,-18,-7,-55,2,-2,2008
1322,1322,11/22/2008,U-A-B,13,35,142,25,11,116,1,0,East Carolina,17,39,56,27,20,239,2,3,H,-6.5,-4,-4,86,-2,-9,-123,-1,-3,2008
1323,1323,11/22/2008,U-C-F,28,40,73,19,8,121,0,1,Memphis,21,37,122,37,15,183,1,1,V,-6,7,3,-49,-18,-7,-62,-1,0,2008
1324,1324,11/22/2008,UL-Lafayette,3,35,183,15,7,72,2,0,Troy,48,55,391,20,9,68,0,1,V,-10,-45,-20,-208,-5,-2,4,2,-1,2008
1325,1325,11/22/2008,UL-Monroe,31,41,173,25,14,156,2,0,Florida Intl,27,32,124,31,18,239,0,1,V,-7,4,9,49,-6,-4,-83,2,-1,2008
1326,1326,11/22/2008,UTEP,37,33,102,45,27,362,0,0,Houston,42,32,220,51,41,480,0,1,V,-17,-5,1,-118,-6,-14,-118,0,-1,2008
1327,1327,11/22/2008,Utah,48,35,113,37,31,307,0,0,Brigham Young,24,30,214,41,21,205,5,1,H,7,24,5,-101,-4,10,102,-5,-1,2008
1328,1328,11/22/2008,Vanderbilt,10,28,25,44,19,188,2,1,Tennessee,20,51,222,9,4,21,2,1,H,3,-10,-23,-197,35,15,167,0,0,2008
1329,1329,11/22/2008,Virginia,3,24,30,39,24,160,3,1,Clemson,13,39,56,29,19,136,0,1,H,-2.5,-10,-15,-26,10,5,24,3,0,2008
1330,1330,11/22/2008,Virginia Tech,14,47,187,25,14,147,3,2,Duke,3,40,116,9,2,20,4,0,H,15,11,7,71,16,12,127,-1,2,2008
1331,1331,11/22/2008,Wake Forest,21,28,65,28,14,126,2,0,Boston College,24,44,97,27,16,137,0,3,H,-2.5,-3,-16,-32,1,-2,-11,2,-3,2008
1332,1332,11/22/2008,Washington,13,58,224,16,11,99,1,0,Washington State,16,37,171,30,17,167,1,0,V,7,-3,21,53,-14,-6,-68,0,0,2008
1333,1333,11/22/2008,Washington State,16,37,171,30,17,167,1,0,Washington,13,58,224,16,11,99,1,0,H,-7,3,-21,-53,14,6,68,0,0,2008
1334,1334,11/22/2008,West Virginia,35,41,376,11,6,122,0,1,Louisville,21,38,198,47,27,276,3,2,V,7.5,14,3,178,-36,-21,-154,-3,-1,2008
1335,1335,11/22/2008,Wisconsin,36,32,184,22,13,245,1,1,Cal-San Luis Obispo,35,59,276,16,8,95,0,0,H, ,1,-27,-92,6,5,150,1,1,2008
1336,1336,11/22/2008,Wyoming,20,45,209,43,22,220,0,3,Colorado State,31,38,186,29,16,236,2,1,H,1,-11,7,23,14,6,-16,-2,2,2008
1337,1337,11/23/2008,Connecticut,13,43,139,24,10,119,0,1,South Florida,17,37,123,18,9,124,1,0,V,-2.5,-4,6,16,6,1,-5,-1,1,2008
1338,1338,11/23/2008,South Florida,17,37,123,18,9,124,1,0,Connecticut,13,43,139,24,10,119,0,1,H,2.5,4,-6,-16,-6,-1,5,1,-1,2008
1339,1339,11/25/2008,Ball State,45,43,179,25,17,273,0,0,Western Michigan,22,28,137,36,17,206,2,0,H,10,23,15,42,-11,0,67,-2,0,2008
1340,1340,11/25/2008,Navy,16,55,262,2,1,32,0,0,Northern Illinois,0,33,135,24,14,116,2,0,V,-3,16,22,127,-22,-13,-84,-2,0,2008
1341,1341,11/25/2008,Northern Illinois,0,33,135,24,14,116,2,0,Navy,16,55,262,2,1,32,0,0,H,3,-16,-22,-127,22,13,84,2,0,2008
1342,1342,11/25/2008,Western Michigan,22,28,137,36,17,206,2,0,Ball State,45,43,179,25,17,273,0,0,V,-10,-23,-15,-42,11,0,-67,2,0,2008
1343,1343,11/27/2008,Texas,49,43,216,30,24,320,0,0,Texas A+M,9,22,-24,35,20,269,0,1,H,35.5,40,21,240,-5,4,51,0,-1,2008
1344,1344,11/27/2008,Texas A+M,9,22,-24,35,20,269,0,1,Texas,49,43,216,30,24,320,0,0,V,-35.5,-40,-21,-240,5,-4,-51,0,1,2008
1345,1345,11/28/2008,Akron,6,31,165,39,20,166,3,0,Temple,27,44,148,30,15,220,2,1,V,-3,-21,-13,17,9,5,-54,1,-1,2008
1346,1346,11/28/2008,Arizona State,34,24,21,26,13,101,1,0,U.C.L.A.,9,35,89,44,26,217,3,1,H,9.5,25,-11,-68,-18,-13,-116,-2,-1,2008
1347,1347,11/28/2008,Arkansas,31,31,118,40,25,280,1,0,Louisiana State,30,44,161,21,9,143,0,0,H,-7,1,-13,-43,19,16,137,1,0,2008
1348,1348,11/28/2008,Boise State,61,34,246,25,18,248,1,0,Fresno State,10,35,83,37,23,211,2,0,H,21.5,51,-1,163,-12,-5,37,-1,0,2008
1349,1349,11/28/2008,Bowling Green,38,46,294,34,21,240,1,2,Toledo,10,37,129,20,7,67,2,1,V,2.5,28,9,165,14,14,173,-1,1,2008
1350,1350,11/28/2008,Buffalo,21,33,145,31,21,240,0,1,Kent State,24,44,312,23,13,114,0,0,H,9.5,-3,-11,-167,8,8,126,0,1,2008
1351,1351,11/28/2008,Central Michigan,52,31,177,38,22,378,1,1,Eastern Michigan,56,25,100,80,58,516,1,0,V,11,-4,6,77,-42,-36,-138,0,1,2008
1352,1352,11/28/2008,Colorado,31,22,42,26,14,249,3,1,Nebraska,40,51,178,26,19,229,0,2,V,-19,-9,-29,-136,0,-5,20,3,-1,2008
1353,1353,11/28/2008,East Carolina,53,53,231,28,19,244,0,1,UTEP,21,15,57,41,23,313,3,0,H,6.5,32,38,174,-13,-4,-69,-3,1,2008
1354,1354,11/28/2008,Eastern Michigan,56,25,100,80,58,516,1,0,Central Michigan,52,31,177,38,22,378,1,1,H,-11,4,-6,-77,42,36,138,0,-1,2008
1355,1355,11/28/2008,Fresno State,10,35,83,37,23,211,2,0,Boise State,61,34,246,25,18,248,1,0,V,-21.5,-51,1,-163,12,5,-37,1,0,2008
1356,1356,11/28/2008,Kent State,24,44,312,23,13,114,0,0,Buffalo,21,33,145,31,21,240,0,1,V,-9.5,3,11,167,-8,-8,-126,0,-1,2008
1357,1357,11/28/2008,Louisiana State,30,44,161,21,9,143,0,0,Arkansas,31,31,118,40,25,280,1,0,V,7,-1,13,43,-19,-16,-137,-1,0,2008
1358,1358,11/28/2008,Miami-Ohio,26,28,92,43,27,274,2,0,Ohio,41,39,326,20,15,190,1,1,H,-2.5,-15,-11,-234,23,12,84,1,-1,2008
1359,1359,11/28/2008,Mississippi,45,44,220,24,16,241,1,1,Mississippi State,0,26,-51,30,10,88,2,0,H,18,45,18,271,-6,6,153,-1,1,2008
1360,1360,11/28/2008,Mississippi State,0,26,-51,30,10,88,2,0,Mississippi,45,44,220,24,16,241,1,1,V,-18,-45,-18,-271,6,-6,-153,1,-1,2008
1361,1361,11/28/2008,Nebraska,40,51,178,26,19,229,0,2,Colorado,31,22,42,26,14,249,3,1,H,19,9,29,136,0,5,-20,-3,1,2008
1362,1362,11/28/2008,Ohio,41,39,326,20,15,190,1,1,Miami-Ohio,26,28,92,43,27,274,2,0,V,2.5,15,11,234,-23,-12,-84,-1,1,2008
1363,1363,11/28/2008,Pittsburgh,19,44,190,23,12,156,2,1,West Virginia,15,32,157,28,15,143,2,0,H,-3,4,12,33,-5,-3,13,0,1,2008
1364,1364,11/28/2008,Temple,27,44,148,30,15,220,2,1,Akron,6,31,165,39,20,166,3,0,H,3,21,13,-17,-9,-5,54,-1,1,2008
1365,1365,11/28/2008,Toledo,10,37,129,20,7,67,2,1,Bowling Green,38,46,294,34,21,240,1,2,H,-2.5,-28,-9,-165,-14,-14,-173,1,-1,2008
1366,1366,11/28/2008,U.C.L.A.,9,35,89,44,26,217,3,1,Arizona State,34,24,21,26,13,101,1,0,V,-9.5,-25,11,68,18,13,116,2,1,2008
1367,1367,11/28/2008,UTEP,21,15,57,41,23,313,3,0,East Carolina,53,53,231,28,19,244,0,1,V,-6.5,-32,-38,-174,13,4,69,3,-1,2008
1368,1368,11/28/2008,West Virginia,15,32,157,28,15,143,2,0,Pittsburgh,19,44,190,23,12,156,2,1,V,3,-4,-12,-33,5,3,-13,0,-1,2008
1369,1369,11/29/2008,Alabama,36,50,234,18,10,178,0,0,Auburn,0,30,57,23,9,113,0,3,H,14.5,36,20,177,-5,1,65,0,-3,2008
1370,1370,11/29/2008,Arkansas State,33,45,188,22,12,205,0,1,North Texas,28,31,110,42,28,217,3,0,V,20.5,5,14,78,-20,-16,-12,-3,1,2008
1371,1371,11/29/2008,Auburn,0,30,57,23,9,113,0,3,Alabama,36,50,234,18,10,178,0,0,V,-14.5,-36,-20,-177,5,-1,-65,0,3,2008
1372,1372,11/29/2008,Baylor,28,43,229,16,12,91,1,0,Texas Tech,35,24,56,50,41,309,1,1,V,-22.5,-7,19,173,-34,-29,-218,0,-1,2008
1373,1373,11/29/2008,Boston College,28,41,175,25,13,143,0,0,Maryland,21,26,-6,57,33,360,2,0,H,6.5,7,15,181,-32,-20,-217,-2,0,2008
1374,1374,11/29/2008,Cincinnati,30,31,140,44,28,272,1,1,Syracuse,10,27,152,23,6,59,1,0,H,20.5,20,4,-12,21,22,213,0,1,2008
1375,1375,11/29/2008,Clemson,31,47,184,17,12,199,0,2,South Carolina,14,26,92,47,22,212,4,0,H,-1,17,21,92,-30,-10,-13,-4,2,2008
1376,1376,11/29/2008,Duke,20,22,72,49,34,278,1,1,North Carolina,28,47,179,19,15,190,1,1,H,-7,-8,-25,-107,30,19,88,0,0,2008
1377,1377,11/29/2008,Florida,45,46,317,22,12,185,0,1,Florida State,15,33,102,32,10,140,3,1,V,17,30,13,215,-10,2,45,-3,0,2008
1378,1378,11/29/2008,Florida Atlantic,57,36,135,50,25,389,1,1,Florida Intl,50,37,112,48,27,400,1,1,H,5.5,7,-1,23,2,-2,-11,0,0,2008
1379,1379,11/29/2008,Florida Intl,50,37,112,48,27,400,1,1,Florida Atlantic,57,36,135,50,25,389,1,1,V,-5.5,-7,1,-23,-2,2,11,0,0,2008
1380,1380,11/29/2008,Florida State,15,33,102,32,10,140,3,1,Florida,45,46,317,22,12,185,0,1,H,-17,-30,-13,-215,10,-2,-45,3,0,2008
1381,1381,11/29/2008,Georgia,42,22,81,40,24,407,1,1,Georgia Tech,45,56,409,6,1,19,1,0,H,7.5,-3,-34,-328,34,23,388,0,1,2008
1382,1382,11/29/2008,Georgia Tech,45,56,409,6,1,19,1,0,Georgia,42,22,81,40,24,407,1,1,V,-7.5,3,34,328,-34,-23,-388,0,-1,2008
1383,1383,11/29/2008,Hawaii,24,34,63,34,19,315,1,0,Washington State,10,37,120,17,8,76,0,2,H,27.5,14,-3,-57,17,11,239,1,-2,2008
1384,1384,11/29/2008,Houston,42,27,140,54,30,494,1,1,Rice,56,38,198,43,30,393,0,0,V,3,-14,-11,-58,11,0,101,1,1,2008
1385,1385,11/29/2008,Kansas,40,32,63,51,37,375,2,0,Missouri,37,26,190,42,25,288,2,1,N,-16.5,3,6,-127,9,12,87,0,-1,2008
1386,1386,11/29/2008,Kentucky,10,38,96,14,9,97,0,0,Tennessee,28,53,210,8,6,101,0,0,V,-4,-18,-15,-114,6,3,-4,0,0,2008
1387,1387,11/29/2008,Louisiana Tech,31,37,185,31,17,258,0,1,Nevada-Reno,35,42,103,42,24,397,1,1,H,-5,-4,-5,82,-11,-7,-139,-1,0,2008
1388,1388,11/29/2008,Marshall,35,36,260,19,14,177,0,0,Tulsa,38,55,203,33,21,313,0,0,H,-16,-3,-19,57,-14,-7,-136,0,0,2008
1389,1389,11/29/2008,Maryland,21,26,-6,57,33,360,2,0,Boston College,28,41,175,25,13,143,0,0,V,-6.5,-7,-15,-181,32,20,217,2,0,2008
1390,1390,11/29/2008,Memphis,45,66,379,12,10,109,0,0,Tulane,6,21,45,24,14,177,2,1,H,14,39,45,334,-12,-4,-68,-2,-1,2008
1391,1391,11/29/2008,Miami-Florida,28,32,122,32,21,269,4,0,No Carolina State,38,44,219,24,11,220,1,0,V,2,-10,-12,-97,8,10,49,3,0,2008
1392,1392,11/29/2008,Missouri,37,26,190,42,25,288,2,1,Kansas,40,32,63,51,37,375,2,0,N,16.5,-3,-6,127,-9,-12,-87,0,1,2008
1393,1393,11/29/2008,Nevada-Reno,35,42,103,42,24,397,1,1,Louisiana Tech,31,37,185,31,17,258,0,1,V,5,4,5,-82,11,7,139,1,0,2008
1394,1394,11/29/2008,New Mexico State,2,19,-7,37,25,163,1,1,Utah State,47,47,241,30,18,169,0,0,V,-5.5,-45,-28,-248,7,7,-6,1,1,2008
1395,1395,11/29/2008,No Carolina State,38,44,219,24,11,220,1,0,Miami-Florida,28,32,122,32,21,269,4,0,H,-2,10,12,97,-8,-10,-49,-3,0,2008
1396,1396,11/29/2008,North Carolina,28,47,179,19,15,190,1,1,Duke,20,22,72,49,34,278,1,1,V,7,8,25,107,-30,-19,-88,0,0,2008
1397,1397,11/29/2008,North Texas,28,31,110,42,28,217,3,0,Arkansas State,33,45,188,22,12,205,0,1,H,-20.5,-5,-14,-78,20,16,12,3,-1,2008
1398,1398,11/29/2008,Notre Dame,3,27,50,22,11,41,2,1,Southern Cal,38,33,175,33,23,274,3,0,V,-33.5,-35,-6,-125,-11,-12,-233,-1,1,2008
1399,1399,11/29/2008,Oklahoma,61,38,187,44,30,370,0,0,Oklahoma State,41,39,198,26,17,254,1,1,V,10.5,20,-1,-11,18,13,116,-1,-1,2008
1400,1400,11/29/2008,Oklahoma State,41,39,198,26,17,254,1,1,Oklahoma,61,38,187,44,30,370,0,0,H,-10.5,-20,1,11,-18,-13,-116,1,1,2008
1401,1401,11/29/2008,Oregon,65,51,385,18,12,309,0,0,Oregon State,38,31,89,51,27,374,2,2,V,-3,27,20,296,-33,-15,-65,-2,-2,2008
1402,1402,11/29/2008,Oregon State,38,31,89,51,27,374,2,2,Oregon,65,51,385,18,12,309,0,0,H,3,-27,-20,-296,33,15,65,2,2,2008
1403,1403,11/29/2008,Rice,56,38,198,43,30,393,0,0,Houston,42,27,140,54,30,494,1,1,H,-3,14,11,58,-11,0,-101,-1,-1,2008
1404,1404,11/29/2008,S-M-U,12,19,4,49,26,253,2,0,Southern Miss,28,39,145,26,15,212,1,0,H,-14,-16,-20,-141,23,11,41,1,0,2008
1405,1405,11/29/2008,South Carolina,14,26,92,47,22,212,4,0,Clemson,31,47,184,17,12,199,0,2,V,1,-17,-21,-92,30,10,13,4,-2,2008
1406,1406,11/29/2008,Southern Cal,38,33,175,33,23,274,3,0,Notre Dame,3,27,50,22,11,41,2,1,H,33.5,35,6,125,11,12,233,1,-1,2008
1407,1407,11/29/2008,Southern Miss,28,39,145,26,15,212,1,0,S-M-U,12,19,4,49,26,253,2,0,V,14,16,20,141,-23,-11,-41,-1,0,2008
1408,1408,11/29/2008,Syracuse,10,27,152,23,6,59,1,0,Cincinnati,30,31,140,44,28,272,1,1,V,-20.5,-20,-4,12,-21,-22,-213,0,-1,2008
1409,1409,11/29/2008,Tennessee,28,53,210,8,6,101,0,0,Kentucky,10,38,96,14,9,97,0,0,H,4,18,15,114,-6,-3,4,0,0,2008
1410,1410,11/29/2008,Texas Tech,35,24,56,50,41,309,1,1,Baylor,28,43,229,16,12,91,1,0,H,22.5,7,-19,-173,34,29,218,0,1,2008
1411,1411,11/29/2008,Tulane,6,21,45,24,14,177,2,1,Memphis,45,66,379,12,10,109,0,0,V,-14,-39,-45,-334,12,4,68,2,1,2008
1412,1412,11/29/2008,Tulsa,38,55,203,33,21,313,0,0,Marshall,35,36,260,19,14,177,0,0,V,16,3,19,-57,14,7,136,0,0,2008
1413,1413,11/29/2008,U-A-B,15,47,140,28,20,244,0,0,U-C-F,0,22,104,34,14,105,2,0,V,-9.5,15,25,36,-6,6,139,-2,0,2008
1414,1414,11/29/2008,U-C-F,0,22,104,34,14,105,2,0,U-A-B,15,47,140,28,20,244,0,0,H,9.5,-15,-25,-36,6,-6,-139,2,0,2008
1415,1415,11/29/2008,Utah State,47,47,241,30,18,169,0,0,New Mexico State,2,19,-7,37,25,163,1,1,H,5.5,45,28,248,-7,-7,6,-1,-1,2008
1416,1416,11/29/2008,Vanderbilt,10,34,116,35,14,133,2,1,Wake Forest,23,42,158,21,13,173,0,2,V,-4.5,-13,-8,-42,14,1,-40,2,-1,2008
1417,1417,11/29/2008,Virginia,14,31,172,15,8,77,1,0,Virginia Tech,17,52,216,28,15,176,1,0,V,-7.5,-3,-21,-44,-13,-7,-99,0,0,2008
1418,1418,11/29/2008,Virginia Tech,17,52,216,28,15,176,1,0,Virginia,14,31,172,15,8,77,1,0,H,7.5,3,21,44,13,7,99,0,0,2008
1419,1419,11/29/2008,Wake Forest,23,42,158,21,13,173,0,2,Vanderbilt,10,34,116,35,14,133,2,1,H,4.5,13,8,42,-14,-1,40,-2,1,2008
1420,1420,11/29/2008,Washington State,10,37,120,17,8,76,0,2,Hawaii,24,34,63,34,19,315,1,0,V,-27.5,-14,3,57,-17,-11,-239,-1,2,2008
1421,1421,12/03/2008,Middle Tennessee,28,40,167,29,22,242,1,2,UL-Lafayette,42,43,152,25,18,243,0,0,V,-5,-14,-3,15,4,4,-1,1,2,2008
1422,1422,12/03/2008,UL-Lafayette,42,42,151,25,18,243,0,0,Middle Tennessee,28,41,166,29,22,242,1,2,H,5,14,1,-15,-4,-4,1,-1,-2,2008
1423,1423,12/04/2008,Louisville,14,31,48,34,24,270,1,1,Rutgers,63,33,224,26,21,447,0,0,V,-12,-49,-2,-176,8,3,-177,1,1,2008
1424,1424,12/04/2008,Rutgers,63,33,224,26,21,447,0,0,Louisville,14,31,48,34,24,270,1,1,H,12,49,2,176,-8,-3,177,-1,-1,2008
1425,1425,12/05/2008,Ball State,24,41,152,48,31,351,1,4,Buffalo,42,26,95,29,19,206,0,2,N,15.5,-18,15,57,19,12,145,1,2,2008
1426,1426,12/05/2008,Buffalo,42,26,95,29,19,206,0,2,Ball State,24,41,152,48,31,351,1,4,N,-15.5,18,-15,-57,-19,-12,-145,-1,-2,2008
1427,1427,12/06/2008,Alabama,20,33,136,25,12,187,1,0,Florida,31,42,142,22,14,216,0,0,N,-10,-11,-9,-6,3,-2,-29,1,0,2008
1428,1428,12/06/2008,Arizona,31,40,105,37,25,284,1,0,Arizona State,10,23,38,31,13,124,1,0,H,11,21,17,67,6,12,160,0,0,2008
1429,1429,12/06/2008,Arizona State,10,23,38,31,13,124,1,0,Arizona,31,40,105,37,25,284,1,0,V,-11,-21,-17,-67,-6,-12,-160,0,0,2008
1430,1430,12/06/2008,Arkansas State,9,45,160,32,17,172,2,1,Troy,35,30,156,24,15,181,0,0,V,-11.5,-26,15,4,8,2,-9,2,1,2008
1431,1431,12/06/2008,Army,0,36,102,16,9,52,1,1,Navy,34,57,368,10,3,62,0,0,N,-10.5,-34,-21,-266,6,6,-10,1,1,2008
1432,1432,12/06/2008,Boston College,12,24,45,43,17,263,2,2,Virginia Tech,30,53,150,19,11,84,1,2,N,1,-18,-29,-105,24,6,179,1,0,2008
1433,1433,12/06/2008,California,48,44,431,22,10,118,0,0,Washington,7,44,104,25,11,96,2,2,H,35.5,41,0,327,-3,-1,22,-2,-2,2008
1434,1434,12/06/2008,Cincinnati,29,33,139,28,16,183,2,1,Hawaii,24,24,45,42,28,275,1,1,V,7.5,5,9,94,-14,-12,-92,1,0,2008
1435,1435,12/06/2008,Connecticut,10,44,225,31,6,80,5,0,Pittsburgh,34,34,87,19,10,141,1,2,H,1.5,-24,10,138,12,-4,-61,4,-2,2008
1436,1436,12/06/2008,East Carolina,27,35,156,24,10,122,0,1,Tulsa,24,55,204,42,23,195,5,2,V,-12.5,3,-20,-48,-18,-13,-73,-5,-1,2008
1437,1437,12/06/2008,Florida,31,42,142,22,14,216,0,0,Alabama,20,33,136,25,12,187,1,0,N,10,11,9,6,-3,2,29,-1,0,2008
1438,1438,12/06/2008,Florida Intl,27,47,143,34,20,292,0,0,Western Kentucky,3,23,42,37,13,138,2,0,H,6.5,24,24,101,-3,7,154,-2,0,2008
1439,1439,12/06/2008,Hawaii,24,24,45,42,28,275,1,1,Cincinnati,29,33,139,28,16,183,2,1,H,-7.5,-5,-9,-94,14,12,92,-1,0,2008
1440,1440,12/06/2008,Missouri,21,28,60,44,28,294,2,1,Oklahoma,62,43,243,49,34,384,0,0,N,-17,-41,-15,-183,-5,-6,-90,2,1,2008
1441,1441,12/06/2008,Navy,34,57,368,10,3,62,0,0,Army,0,36,102,16,9,52,1,1,N,10.5,34,21,266,-6,-6,10,-1,-1,2008
1442,1442,12/06/2008,Oklahoma,62,43,243,49,34,384,0,0,Missouri,21,28,60,44,28,294,2,1,N,17,41,15,183,5,6,90,-2,-1,2008
1443,1443,12/06/2008,Pittsburgh,34,34,87,19,10,141,1,2,Connecticut,10,44,225,31,6,80,5,0,V,-1.5,24,-10,-138,-12,4,61,-4,2,2008
1444,1444,12/06/2008,South Florida,7,38,167,33,18,189,2,1,West Virginia,13,40,139,23,14,141,0,1,V,-7,-6,-2,28,10,4,48,2,0,2008
1445,1445,12/06/2008,Southern Cal,28,47,209,33,18,269,1,1,U.C.L.A.,7,21,47,29,12,110,1,0,V,32.5,21,26,162,4,6,159,0,1,2008
1446,1446,12/06/2008,Troy,35,31,155,24,15,181,0,0,Arkansas State,9,44,159,32,17,172,2,1,H,11.5,26,-13,-4,-8,-2,9,-2,-1,2008
1447,1447,12/06/2008,Tulsa,24,55,204,42,23,195,5,2,East Carolina,27,35,156,24,10,122,0,1,H,12.5,-3,20,48,18,13,73,5,1,2008
1448,1448,12/06/2008,U.C.L.A.,7,21,47,29,12,110,1,0,Southern Cal,28,47,209,33,18,269,1,1,H,-32.5,-21,-26,-162,-4,-6,-159,0,-1,2008
1449,1449,12/06/2008,Virginia Tech,30,53,150,19,11,84,1,2,Boston College,12,24,45,43,17,263,2,2,N,-1,18,29,105,-24,-6,-179,-1,0,2008
1450,1450,12/06/2008,Washington,7,44,104,25,11,96,2,2,California,48,44,431,22,10,118,0,0,V,-35.5,-41,0,-327,3,1,-22,2,2,2008
1451,1451,12/06/2008,West Virginia,13,40,139,23,14,141,0,1,South Florida,7,38,167,33,18,189,2,1,H,7,6,2,-28,-10,-4,-48,-2,0,2008
1452,1452,12/06/2008,Western Kentucky,3,23,42,37,13,138,2,0,Florida Intl,27,47,143,34,20,292,0,0,V,-6.5,-24,-24,-101,3,-7,-154,2,0,2008
