,Unnamed: 0,Date,TeamName,ScoreOff,RushAttOff,RushYdsOff,PassAttOff,PassCompOff,PassYdsOff,PassIntOff,FumblesOff,Opponent,ScoreDef,RushAttDef,RushYdsDef,PassAttDef,PassCompDef,PassYdsDef,PassIntDef,FumblesDef,Site,Line,ScoreDiff,RushAttDiff,RushYdsDiff,PassAttDiff,PassCompDiff,PassYdsDiff,PassIntDiff,FumblesDiff,season
0,0,09/01/2005,Arizona State,63,44,300,31,19,259,2,1,Temple,16,35,62,37,18,203,2,1,H,26,47,9,238,-6,1,56,0,0,2005
1,1,09/01/2005,Buffalo,0,27,77,21,10,60,0,0,Connecticut,38,55,290,21,14,132,1,0,V,-18.5,-38,-28,-213,0,-4,-72,-1,0,2005
2,2,09/01/2005,Cincinnati,28,55,293,26,17,176,0,1,Eastern Michigan,26,31,149,33,22,167,0,0,H,12.5,2,24,144,-7,-5,9,0,1,2005
3,3,09/01/2005,Connecticut,38,55,290,21,14,132,1,0,Buffalo,0,27,77,21,10,60,0,0,H,18.5,38,28,213,0,4,72,1,0,2005
4,4,09/01/2005,Eastern Michigan,26,31,149,33,22,167,0,0,Cincinnati,28,55,293,26,17,176,0,1,V,-12.5,-2,-24,-144,7,5,-9,0,-1,2005
5,5,09/01/2005,Houston,24,26,100,43,24,312,2,0,Oregon,38,36,206,49,30,348,1,0,H,-10,-14,-10,-106,-6,-6,-36,1,0,2005
6,6,09/01/2005,Idaho,26,41,86,32,19,180,0,1,Washington State,38,35,206,29,17,230,2,1,V,-29.5,-12,6,-120,3,2,-50,-2,0,2005
7,7,09/01/2005,Marshall,36,30,103,40,26,313,1,1,William + Mary,24,37,155,35,18,204,1,2,H, ,12,-7,-52,5,8,109,0,-1,2005
8,8,09/01/2005,Minnesota,41,44,301,25,14,235,1,1,Tulsa,10,35,135,41,27,218,1,3,V,14,31,9,166,-16,-13,17,0,-2,2005
9,9,09/01/2005,Oregon,38,36,206,49,30,348,1,0,Houston,24,26,100,43,24,312,2,0,V,10,14,10,106,6,6,36,-1,0,2005
10,10,09/01/2005,South Carolina,24,28,32,23,18,330,0,3,U-C-F,15,41,83,39,27,258,1,0,H,18.5,9,-13,-51,-16,-9,72,-1,3,2005
11,11,09/01/2005,Temple,16,35,62,37,18,203,2,1,Arizona State,63,44,300,31,19,259,2,1,V,-26,-47,-9,-238,6,-1,-56,0,0,2005
12,12,09/01/2005,Toledo,62,37,210,26,16,191,0,1,Western Illinois,14,41,64,29,18,239,3,3,H, ,48,-4,146,-3,-2,-48,-3,-2,2005
13,13,09/01/2005,Tulsa,10,35,135,41,27,218,1,3,Minnesota,41,44,301,25,14,235,1,1,H,-14,-31,-9,-166,16,13,-17,0,2,2005
14,14,09/01/2005,U-C-F,15,41,83,39,27,258,1,0,South Carolina,24,28,32,23,18,330,0,3,V,-18.5,-9,13,51,16,9,-72,1,-3,2005
15,15,09/01/2005,UL-Monroe,23,36,128,41,25,283,1,2,Northwestern St(LA),27,40,120,23,15,230,3,0,H, ,-4,-4,8,18,10,53,-2,2,2005
16,16,09/01/2005,Vanderbilt,24,30,146,36,25,276,1,0,Wake Forest,20,51,274,26,15,198,0,1,V,-10.5,4,-21,-128,10,10,78,1,-1,2005
17,17,09/01/2005,Wake Forest,20,51,274,26,15,198,0,1,Vanderbilt,24,30,146,36,25,276,1,0,H,10.5,-4,21,128,-10,-10,-78,-1,1,2005
18,18,09/01/2005,Washington State,38,35,206,29,17,230,2,1,Idaho,26,41,86,32,19,180,0,1,H,29.5,12,-6,120,-3,-2,50,2,0,2005
19,19,09/02/2005,Arizona,24,33,104,42,24,287,2,2,Utah,27,38,226,31,19,220,0,1,V,-9.5,-3,-5,-122,11,5,67,2,1,2005
20,20,09/02/2005,Central Michigan,13,32,167,36,18,216,0,0,Indiana,20,45,109,35,17,276,1,0,H,-10.5,-7,-13,58,1,1,-60,-1,0,2005
21,21,09/02/2005,Indiana,20,45,109,35,17,276,1,0,Central Michigan,13,32,167,36,18,216,0,0,V,10.5,7,13,-58,-1,-1,60,1,0,2005
22,22,09/02/2005,Utah,27,38,226,31,19,220,0,1,Arizona,24,33,104,42,24,287,2,2,H,9.5,3,5,122,-11,-5,-67,-2,-1,2005
23,23,09/03/2005,Air Force,20,52,218,22,13,207,0,2,Washington,17,34,129,27,19,242,0,0,V,-1.5,3,18,89,-5,-6,-35,0,2,2005
24,24,09/03/2005,Alabama,26,37,133,25,17,212,1,0,Middle Tennessee,7,25,34,20,13,123,0,1,H,22.5,19,12,99,5,4,89,1,-1,2005
25,25,09/03/2005,Arkansas,49,51,483,25,13,108,1,4,Missouri State,17,39,178,28,12,160,2,3,H, ,32,12,305,-3,1,-52,-1,1,2005
26,26,09/03/2005,Arkansas State,17,29,117,38,19,206,1,1,Missouri,44,41,317,48,33,340,1,2,N,-25.5,-27,-12,-200,-10,-14,-134,0,-1,2005
27,27,09/03/2005,Auburn,14,23,50,44,22,342,4,1,Georgia Tech,23,39,139,36,17,174,1,0,H,6.5,-9,-16,-89,8,5,168,3,1,2005
28,28,09/03/2005,Ball State,0,34,51,23,11,93,0,1,Iowa,56,47,241,20,19,200,0,2,V,-38.5,-56,-13,-190,3,-8,-107,0,-1,2005
29,29,09/03/2005,Baylor,28,45,215,40,23,198,2,1,S-M-U,23,36,164,26,9,106,0,2,V,4.5,5,9,51,14,14,92,2,-1,2005
30,30,09/03/2005,Boise State,13,35,169,25,13,123,4,2,Georgia,48,33,180,33,22,394,0,1,V,-6.5,-35,2,-11,-8,-9,-271,4,1,2005
31,31,09/03/2005,Boston College,20,31,133,35,27,232,0,1,Brigham Young,3,16,8,60,41,330,0,0,V,5,17,15,125,-25,-14,-98,0,1,2005
32,32,09/03/2005,Bowling Green,42,29,73,52,30,458,1,0,Wisconsin,56,63,388,10,8,116,1,0,V,-5,-14,-34,-315,42,22,342,0,0,2005
33,33,09/03/2005,Brigham Young,3,16,8,60,41,330,0,0,Boston College,20,31,133,35,27,232,0,1,H,-5,-17,-15,-125,25,14,98,0,-1,2005
34,34,09/03/2005,California,41,41,212,28,10,183,2,2,Sacramento State,3,32,68,37,16,121,0,3,H, ,38,9,144,-9,-6,62,2,-1,2005
35,35,09/03/2005,Clemson,25,51,183,24,16,213,0,0,Texas A+M,24,33,248,17,8,110,1,0,H,0,1,18,-65,7,8,103,-1,0,2005
36,36,09/03/2005,Colorado,31,29,113,33,22,283,1,2,Colorado State,28,34,95,43,28,291,4,0,H,8,3,-5,18,-10,-6,-8,-3,2,2005
37,37,09/03/2005,Colorado State,28,34,95,43,28,291,4,0,Colorado,31,29,113,33,22,283,1,2,V,-8,-3,5,-18,10,6,8,3,-2,2005
38,38,09/03/2005,Duke,21,43,162,30,15,139,3,1,East Carolina,24,36,103,21,17,235,0,2,V,1.5,-3,7,59,9,-2,-96,3,-1,2005
39,39,09/03/2005,East Carolina,24,36,103,21,17,235,0,2,Duke,21,43,162,30,15,139,3,1,H,-1.5,3,-7,-59,-9,2,96,-3,1,2005
40,40,09/03/2005,Florida,32,36,91,34,26,320,0,0,Wyoming,14,27,72,32,14,150,1,1,H,22.5,18,9,19,2,12,170,-1,-1,2005
41,41,09/03/2005,Florida Atlantic,19,37,70,28,20,299,0,1,Kansas,30,37,201,35,16,177,2,0,V,-19.5,-11,0,-131,-7,4,122,-2,1,2005
42,42,09/03/2005,Florida Intl,21,26,82,34,17,154,1,2,Kansas State,35,42,246,31,19,161,1,3,V,-34.5,-14,-16,-164,3,-2,-7,0,-1,2005
43,43,09/03/2005,Georgia,48,33,180,33,22,394,0,1,Boise State,13,35,169,25,13,123,4,2,H,6.5,35,-2,11,8,9,271,-4,-1,2005
44,44,09/03/2005,Georgia Tech,23,39,139,36,17,174,1,0,Auburn,14,23,50,44,22,342,4,1,V,-6.5,9,16,89,-8,-5,-168,-3,-1,2005
45,45,09/03/2005,Hawaii,17,21,60,49,33,377,1,2,Southern Cal,63,33,177,29,20,341,1,0,H,-31,-46,-12,-117,20,13,36,0,2,2005
46,46,09/03/2005,Illinois,33,48,204,34,24,233,2,1,Rutgers,30,27,175,44,27,342,0,0,H,1.5,3,21,29,-10,-3,-109,2,1,2005
47,47,09/03/2005,Iowa,56,47,241,20,19,200,0,2,Ball State,0,34,51,23,11,93,0,1,H,38.5,56,13,190,-3,8,107,0,1,2005
48,48,09/03/2005,Iowa State,32,41,92,41,30,314,0,2,Illinois State,21,34,89,25,10,222,2,0,H, ,11,7,3,16,20,92,-2,2,2005
49,49,09/03/2005,Kansas,30,37,201,35,16,177,2,0,Florida Atlantic,19,37,70,28,20,299,0,1,H,19.5,11,0,131,7,-4,-122,2,-1,2005
50,50,09/03/2005,Kansas State,35,42,246,31,19,161,1,3,Florida Intl,21,26,82,34,17,154,1,2,H,34.5,14,16,164,-3,2,7,0,1,2005
51,51,09/03/2005,Kent State,14,15,14,55,32,301,1,0,Michigan State,49,55,354,35,27,331,1,2,V,-18.5,-35,-40,-340,20,5,-30,0,-2,2005
52,52,09/03/2005,Maryland,23,40,210,30,19,217,2,0,Navy,20,49,246,12,5,97,1,0,N,7.5,3,-9,-36,18,14,120,1,0,2005
53,53,09/03/2005,Miami-Ohio,14,30,48,44,24,250,1,1,Ohio State,34,36,160,30,22,222,1,1,V,-17,-20,-6,-112,14,2,28,0,0,2005
54,54,09/03/2005,Michigan,33,48,208,33,21,239,0,1,Northern Illinois,17,32,211,25,17,200,1,4,H,18,16,16,-3,8,4,39,-1,-3,2005
55,55,09/03/2005,Michigan State,49,55,354,35,27,331,1,2,Kent State,14,15,14,55,32,301,1,0,H,18.5,35,40,340,-20,-5,30,0,2,2005
56,56,09/03/2005,Middle Tennessee,7,25,34,20,13,123,0,1,Alabama,26,37,133,25,17,212,1,0,V,-22.5,-19,-12,-99,-5,-4,-89,-1,1,2005
57,57,09/03/2005,Mississippi State,38,44,249,27,17,233,0,0,Murray State,6,33,88,20,14,141,1,1,H, ,32,11,161,7,3,92,-1,-1,2005
58,58,09/03/2005,Missouri,44,41,317,48,33,340,1,2,Arkansas State,17,29,117,38,19,206,1,1,N,25.5,27,12,200,10,14,134,0,1,2005
59,59,09/03/2005,Navy,20,49,246,12,5,97,1,0,Maryland,23,40,210,30,19,217,2,0,N,-7.5,-3,9,36,-18,-14,-120,-1,0,2005
60,60,09/03/2005,Nebraska,25,42,121,36,15,192,2,3,Maine,7,37,-6,36,16,151,1,1,H, ,18,5,127,0,-1,41,1,2,2005
61,61,09/03/2005,New Mexico State,17,24,-17,62,38,347,3,1,UTEP,34,35,97,33,17,204,0,1,H,-11,-17,-11,-114,29,21,143,3,0,2005
62,62,09/03/2005,Northern Illinois,17,32,211,25,17,200,1,4,Michigan,33,48,208,33,21,239,0,1,V,-18,-16,-16,3,-8,-4,-39,1,3,2005
63,63,09/03/2005,Northwestern,38,47,194,40,28,356,1,2,Ohio,14,23,62,28,12,177,1,2,H,14.5,24,24,132,12,16,179,0,0,2005
64,64,09/03/2005,Notre Dame,42,50,275,27,18,227,1,0,Pittsburgh,21,31,103,35,20,220,1,1,V,-4.5,21,19,172,-8,-2,7,0,-1,2005
65,65,09/03/2005,Ohio,14,23,62,28,12,177,1,2,Northwestern,38,47,194,40,28,356,1,2,V,-14.5,-24,-24,-132,-12,-16,-179,0,0,2005
66,66,09/03/2005,Ohio State,34,36,160,30,22,222,1,1,Miami-Ohio,14,30,48,44,24,250,1,1,H,17,20,6,112,-14,-2,-28,0,0,2005
67,67,09/03/2005,Oklahoma,10,36,97,31,13,128,1,3,Texas Christian,17,35,58,45,24,226,1,1,H,27,-7,1,39,-14,-11,-98,0,2,2005
68,68,09/03/2005,Oklahoma State,15,41,244,23,11,134,0,1,Montana State,10,28,49,34,22,205,0,1,H, ,5,13,195,-11,-11,-71,0,0,2005
69,69,09/03/2005,Oregon State,41,26,77,46,28,402,1,0,Portland State,14,34,126,33,15,174,2,0,H, ,27,-8,-49,13,13,228,-1,0,2005
70,70,09/03/2005,Penn State,23,39,264,15,9,90,1,2,South Florida,13,36,97,39,21,200,1,1,H,24.5,10,3,167,-24,-12,-110,0,1,2005
71,71,09/03/2005,Pittsburgh,21,31,103,35,20,220,1,1,Notre Dame,42,50,275,27,18,227,1,0,H,4.5,-21,-19,-172,8,2,-7,0,1,2005
72,72,09/03/2005,Rutgers,30,27,175,44,27,342,0,0,Illinois,33,48,204,34,24,233,2,1,V,-1.5,-3,-21,-29,10,3,109,-2,-1,2005
73,73,09/03/2005,S-M-U,23,36,164,26,9,106,0,2,Baylor,28,45,215,40,23,198,2,1,H,-4.5,-5,-9,-51,-14,-14,-92,-2,1,2005
74,74,09/03/2005,San Diego State,21,46,156,35,24,246,2,0,U.C.L.A.,44,35,191,18,12,158,0,0,H,-8.5,-23,11,-35,17,12,88,2,0,2005
75,75,09/03/2005,San Jose State,35,45,253,36,21,290,1,2,Eastern Washington,24,31,90,40,23,372,1,1,H, ,11,14,163,-4,-2,-82,0,1,2005
76,76,09/03/2005,South Florida,13,36,97,39,21,200,1,1,Penn State,23,39,264,15,9,90,1,2,V,-24.5,-10,-3,-167,24,12,110,0,-1,2005
77,77,09/03/2005,Southern Cal,63,33,177,29,20,341,1,0,Hawaii,17,21,60,49,33,377,1,2,V,31,46,12,117,-20,-13,-36,0,-2,2005
78,78,09/03/2005,Tennessee,17,35,138,38,22,274,3,0,U-A-B,10,23,53,38,27,282,1,1,H,24,7,12,85,0,-5,-8,2,-1,2005
79,79,09/03/2005,Texas,60,52,418,17,13,173,1,1,UL-Lafayette,3,34,72,33,16,166,1,0,H,38.5,57,18,346,-16,-3,7,0,1,2005
80,80,09/03/2005,Texas A+M,24,33,248,17,8,110,1,0,Clemson,25,51,183,24,16,213,0,0,V,0,-1,-18,65,-7,-8,-103,1,0,2005
81,81,09/03/2005,Texas Christian,17,35,58,45,24,226,1,1,Oklahoma,10,36,97,31,13,128,1,3,V,-27,7,-1,-39,14,11,98,0,-2,2005
82,82,09/03/2005,Troy,27,43,65,31,14,213,1,1,Cal-San Luis Obispo,10,36,71,16,10,68,1,1,H, ,17,7,-6,15,4,145,0,0,2005
83,83,09/03/2005,U-A-B,10,23,53,38,27,282,1,1,Tennessee,17,35,138,38,22,274,3,0,V,-24,-7,-12,-85,0,5,8,-2,1,2005
84,84,09/03/2005,U.C.L.A.,44,35,191,18,12,158,0,0,San Diego State,21,46,156,35,24,246,2,0,V,8.5,23,-11,35,-17,-12,-88,-2,0,2005
85,85,09/03/2005,UL-Lafayette,3,34,72,33,16,166,1,0,Texas,60,52,418,17,13,173,1,1,V,-38.5,-57,-18,-346,16,3,-7,0,-1,2005
86,86,09/03/2005,UTEP,34,35,97,33,17,204,0,1,New Mexico State,17,24,-17,62,38,347,3,1,V,11,17,11,114,-29,-21,-143,-3,0,2005
87,87,09/03/2005,Virginia,31,41,188,25,17,252,2,1,Western Michigan,19,37,86,50,33,271,1,1,H,32.5,12,4,102,-25,-16,-19,1,0,2005
88,88,09/03/2005,Washington,17,34,129,27,19,242,0,0,Air Force,20,52,218,22,13,207,0,2,H,1.5,-3,-18,-89,5,6,35,0,-2,2005
89,89,09/03/2005,Western Michigan,19,37,86,50,33,271,1,1,Virginia,31,41,188,25,17,252,2,1,V,-32.5,-12,-4,-102,25,16,19,-1,0,2005
90,90,09/03/2005,Wisconsin,56,63,388,10,8,116,1,0,Bowling Green,42,29,73,52,30,458,1,0,H,5,14,34,315,-42,-22,-342,0,0,2005
91,91,09/03/2005,Wyoming,14,27,72,32,14,150,1,1,Florida,32,36,91,34,26,320,0,0,V,-22.5,-18,-9,-19,-2,-12,-170,1,1,2005
92,92,09/04/2005,Kentucky,24,27,47,27,17,278,0,3,Louisville,31,46,209,27,19,179,0,0,H,-22,-7,-19,-162,0,-2,99,0,3,2005
93,93,09/04/2005,Louisville,31,46,209,27,19,179,0,0,Kentucky,24,27,47,27,17,278,0,3,V,22,7,19,162,0,2,-99,0,-3,2005
94,94,09/04/2005,No Carolina State,16,29,127,44,27,311,2,1,Virginia Tech,20,41,124,21,10,108,0,0,H,-5.5,-4,-12,3,23,17,203,2,1,2005
95,95,09/04/2005,Syracuse,7,26,18,31,15,85,2,0,West Virginia,15,45,172,27,17,167,1,4,H,1.5,-8,-19,-154,4,-2,-82,1,-4,2005
96,96,09/04/2005,Virginia Tech,20,41,124,21,10,108,0,0,No Carolina State,16,29,127,44,27,311,2,1,V,5.5,4,12,-3,-23,-17,-203,-2,-1,2005
97,97,09/04/2005,West Virginia,15,45,172,27,17,167,1,4,Syracuse,7,26,18,31,15,85,2,0,V,-1.5,8,19,154,-4,2,82,-1,4,2005
98,98,09/05/2005,Florida State,10,33,96,26,8,74,1,1,Miami-Florida,7,44,81,28,16,232,2,1,H,-2.5,3,-11,15,-2,-8,-158,-1,0,2005
99,99,09/05/2005,Memphis,6,38,119,29,16,149,2,1,Mississippi,10,36,55,31,15,207,2,0,H,1.5,-4,2,64,-2,1,-58,0,1,2005
100,100,09/05/2005,Miami-Florida,7,44,81,28,16,232,2,1,Florida State,10,33,96,26,8,74,1,1,V,2.5,-3,11,-15,2,8,158,1,0,2005
101,101,09/05/2005,Mississippi,10,36,55,31,15,207,2,0,Memphis,6,38,119,29,16,149,2,1,V,-1.5,4,-2,-64,2,-1,58,0,-1,2005
102,102,09/05/2005,Nevada-Las Vegas,22,29,108,31,19,255,1,0,New Mexico,24,39,87,29,20,284,0,0,V,-14.5,-2,-10,21,2,-1,-29,1,0,2005
103,103,09/05/2005,New Mexico,24,39,87,29,20,284,0,0,Nevada-Las Vegas,22,29,108,31,19,255,1,0,H,14.5,2,10,-21,-2,1,29,-1,0,2005
104,104,09/08/2005,Florida Atlantic,3,41,129,16,7,91,0,4,Oklahoma State,23,49,194,22,11,98,0,1,H,-16.5,-20,-8,-65,-6,-4,-7,0,3,2005
105,105,09/08/2005,Oklahoma State,23,49,194,22,11,98,0,1,Florida Atlantic,3,41,129,16,7,91,0,4,V,16.5,20,8,65,6,4,7,0,-3,2005
106,106,09/09/2005,Nevada-Reno,21,35,125,42,23,257,1,0,Washington State,55,43,247,32,19,287,0,1,H,-10,-34,-8,-122,10,4,-30,1,-1,2005
107,107,09/09/2005,Ohio,16,35,94,24,14,114,0,0,Pittsburgh,10,41,148,26,13,120,3,0,H,-14,6,-6,-54,-2,1,-6,-3,0,2005
108,108,09/09/2005,Pittsburgh,10,41,148,26,13,120,3,0,Ohio,16,35,94,24,14,114,0,0,V,14,-6,6,54,2,-1,6,3,0,2005
109,109,09/09/2005,Washington State,55,43,247,32,19,287,0,1,Nevada-Reno,21,35,125,42,23,257,1,0,V,10,34,8,122,-10,-4,30,-1,1,2005
110,110,09/10/2005,Air Force,41,67,272,12,10,231,0,1,San Diego State,29,33,164,44,27,253,1,2,H,5.5,12,34,108,-32,-17,-22,-1,-1,2005
111,111,09/10/2005,Akron,24,21,23,46,26,362,0,2,Purdue,49,50,211,36,23,267,0,1,V,-35,-25,-29,-188,10,3,95,0,1,2005
112,112,09/10/2005,Alabama,30,43,140,37,21,330,1,1,Southern Miss,21,23,9,30,15,190,1,0,H,12,9,20,131,7,6,140,0,1,2005
113,113,09/10/2005,Arizona,31,44,187,31,19,255,1,1,Northern Arizona,12,36,141,33,15,133,0,1,H, ,19,8,46,-2,4,122,1,0,2005
114,114,09/10/2005,Arizona State,31,25,99,56,35,461,0,1,Louisiana State,35,47,190,30,17,244,0,2,H,-1,-4,-22,-91,26,18,217,0,-1,2005
115,115,09/10/2005,Arkansas,24,43,194,30,17,204,1,0,Vanderbilt,28,33,130,45,23,278,1,0,H,11.5,-4,10,64,-15,-6,-74,0,0,2005
116,116,09/10/2005,Arkansas State,56,35,279,16,10,145,0,1,Tennessee-Martin,7,52,128,20,11,103,0,1,H, ,49,-17,151,-4,-1,42,0,0,2005
117,117,09/10/2005,Army,7,35,96,32,17,154,2,1,Boston College,44,41,175,28,22,289,0,0,V,-28.5,-37,-6,-79,4,-5,-135,2,1,2005
118,118,09/10/2005,Auburn,28,41,118,18,12,202,0,1,Mississippi State,0,38,81,21,12,126,1,2,H,16,28,3,37,-3,0,76,-1,-1,2005
119,119,09/10/2005,Ball State,31,32,160,32,23,294,2,0,Bowling Green,40,36,126,43,27,428,1,3,H,-28.5,-9,-4,34,-11,-4,-134,1,-3,2005
120,120,09/10/2005,Baylor,48,37,137,30,19,235,0,1,Samford,14,29,61,47,23,249,2,1,H, ,34,8,76,-17,-4,-14,-2,0,2005
121,121,09/10/2005,Boise State,27,44,149,36,19,233,0,2,Oregon State,30,30,83,38,27,279,0,2,V,-5,-3,14,66,-2,-8,-46,0,0,2005
122,122,09/10/2005,Boston College,44,41,175,28,22,289,0,0,Army,7,35,96,32,17,154,2,1,H,28.5,37,6,79,-4,5,135,-2,-1,2005
123,123,09/10/2005,Bowling Green,40,36,126,43,27,428,1,3,Ball State,31,32,160,32,23,294,2,0,V,28.5,9,4,-34,11,4,134,-1,3,2005
124,124,09/10/2005,Brigham Young,45,32,176,41,26,255,2,2,Eastern Illinois,10,30,70,29,14,126,1,2,H, ,35,2,106,12,12,129,1,0,2005
125,125,09/10/2005,Buffalo,0,30,38,26,9,73,2,0,Syracuse,31,55,348,22,10,139,0,0,V,-24,-31,-25,-310,4,-1,-66,2,0,2005
126,126,09/10/2005,California,56,39,286,27,17,271,1,0,Washington,17,27,68,39,22,301,1,0,V,10.5,39,12,218,-12,-5,-30,0,0,2005
127,127,09/10/2005,Central Michigan,38,38,213,36,26,356,1,1,Miami-Ohio,37,33,127,47,28,397,0,0,V,-24.5,1,5,86,-11,-2,-41,1,1,2005
128,128,09/10/2005,Cincinnati,24,34,31,49,29,329,2,2,Penn State,42,37,148,22,15,245,1,2,V,-19.5,-18,-3,-117,27,14,84,1,0,2005
129,129,09/10/2005,Clemson,28,40,114,22,18,178,0,0,Maryland,24,38,56,28,18,288,1,2,V,-1,4,2,58,-6,0,-110,-1,-2,2005
130,130,09/10/2005,Colorado,39,50,238,33,22,233,0,2,New Mexico State,0,22,5,31,17,176,2,1,H,24,39,28,233,2,5,57,-2,1,2005
131,131,09/10/2005,Colorado State,24,25,59,42,21,362,1,2,Minnesota,56,59,355,24,11,190,1,0,V,-12.5,-32,-34,-296,18,10,172,0,2,2005
132,132,09/10/2005,Connecticut,59,62,376,27,19,224,0,0,Liberty,0,29,17,15,11,132,1,3,H, ,59,33,359,12,8,92,-1,-3,2005
133,133,09/10/2005,Duke,0,35,13,18,5,22,1,0,Virginia Tech,45,44,180,22,13,182,1,0,H,-20.5,-45,-9,-167,-4,-8,-160,0,0,2005
134,134,09/10/2005,Eastern Michigan,31,41,156,39,27,268,0,1,UL-Lafayette,10,37,182,29,21,228,0,4,H,4.5,21,4,-26,10,6,40,0,-3,2005
135,135,09/10/2005,Florida,41,49,251,24,14,224,0,1,Louisiana Tech,3,26,45,32,11,117,3,1,H,29,38,23,206,-8,3,107,-3,0,2005
136,136,09/10/2005,Florida Intl,3,38,135,42,26,214,0,2,Texas Tech,56,23,135,45,36,518,0,0,V,-33,-53,15,0,-3,-10,-304,0,2,2005
137,137,09/10/2005,Florida State,62,32,144,45,31,485,2,2,The Citadel,10,32,26,27,16,65,1,2,H, ,52,0,118,18,15,420,1,0,2005
138,138,09/10/2005,Fresno State,55,30,157,22,16,200,0,0,Weber State,17,35,77,42,23,261,1,0,H, ,38,-5,80,-20,-7,-61,-1,0,2005
139,139,09/10/2005,Georgia,17,49,238,17,8,112,2,0,South Carolina,15,23,43,34,22,236,2,0,H,17,2,26,195,-17,-14,-124,0,0,2005
140,140,09/10/2005,Georgia Tech,27,33,122,48,25,353,0,0,North Carolina,21,26,61,39,18,280,3,0,H,12,6,7,61,9,7,73,-3,0,2005
141,141,09/10/2005,Hawaii,14,28,123,43,25,236,1,0,Michigan State,42,41,198,26,21,301,0,0,V,-29.5,-28,-13,-75,17,4,-65,1,0,2005
142,142,09/10/2005,Houston,31,57,293,31,19,206,1,2,Sam Houston State,10,22,136,39,18,179,1,0,H, ,21,35,157,-8,1,27,0,2,2005
143,143,09/10/2005,Idaho,31,30,100,31,19,390,1,1,Nevada-Las Vegas,34,41,193,34,22,250,1,0,V,-11.5,-3,-11,-93,-3,-3,140,0,1,2005
144,144,09/10/2005,Illinois,40,53,243,29,20,249,1,0,San Jose State,19,25,15,30,19,216,1,0,H,16.5,21,28,228,-1,1,33,0,0,2005
145,145,09/10/2005,Indiana,35,35,114,36,19,307,2,1,Nicholls State,31,65,408,11,4,51,0,3,H, ,4,-30,-294,25,15,256,2,-2,2005
146,146,09/10/2005,Iowa,3,32,173,42,15,174,2,3,Iowa State,23,55,169,24,14,154,1,0,V,7.5,-20,-23,4,18,1,20,1,3,2005
147,147,09/10/2005,Iowa State,23,55,169,24,14,154,1,0,Iowa,3,32,173,42,15,174,2,3,H,-7.5,20,23,-4,-18,-1,-20,-1,-3,2005
148,148,09/10/2005,Kansas,36,38,207,29,19,228,1,0,Appalachian State,8,33,133,35,22,178,0,1,H, ,28,5,74,-6,-3,50,1,-1,2005
149,149,09/10/2005,Kansas State,21,46,208,19,10,126,1,2,Marshall,19,26,74,38,22,262,2,3,V,9.5,2,20,134,-19,-12,-136,-1,-1,2005
150,150,09/10/2005,Kent State,33,23,24,44,19,171,1,2,S E Missouri St,12,32,20,63,34,275,3,1,H, ,21,-9,4,-19,-15,-104,-2,1,2005
151,151,09/10/2005,Kentucky,41,34,143,20,15,167,0,0,Idaho State,29,36,157,38,25,291,4,0,H, ,12,-2,-14,-18,-10,-124,-4,0,2005
152,152,09/10/2005,Louisiana State,35,47,190,30,17,244,0,2,Arizona State,31,25,99,56,35,461,0,1,V,1,4,22,91,-26,-18,-217,0,1,2005
153,153,09/10/2005,Louisiana Tech,3,26,45,32,11,117,3,1,Florida,41,49,251,24,14,224,0,1,V,-29,-38,-23,-206,8,-3,-107,3,0,2005
154,154,09/10/2005,Marshall,19,26,74,38,22,262,2,3,Kansas State,21,46,208,19,10,126,1,2,H,-9.5,-2,-20,-134,19,12,136,1,1,2005
155,155,09/10/2005,Maryland,24,38,56,28,18,288,1,1,Clemson,28,40,114,22,18,178,0,0,H,1,-4,-2,-58,6,0,110,1,1,2005
156,156,09/10/2005,Miami-Ohio,37,33,127,47,28,397,0,0,Central Michigan,38,38,213,36,26,356,1,1,H,24.5,-1,-5,-86,11,2,41,-1,-1,2005
157,157,09/10/2005,Michigan,10,29,114,44,19,223,1,1,Notre Dame,17,44,104,30,19,140,0,1,H,7,-7,-15,10,14,0,83,1,0,2005
158,158,09/10/2005,Michigan State,42,41,198,26,21,301,0,0,Hawaii,14,28,123,43,25,236,1,0,H,29.5,28,13,75,-17,-4,65,-1,0,2005
159,159,09/10/2005,Middle Tennessee,7,48,188,27,21,195,3,2,North Texas,14,44,152,16,10,122,0,0,H,4.5,-7,4,36,11,11,73,3,2,2005
160,160,09/10/2005,Minnesota,56,59,355,24,11,190,1,0,Colorado State,24,25,59,42,21,362,1,2,H,12.5,32,34,296,-18,-10,-172,0,-2,2005
161,161,09/10/2005,Mississippi State,0,38,81,21,12,126,1,2,Auburn,28,41,118,18,12,202,0,1,V,-16,-28,-3,-37,3,0,-76,1,1,2005
162,162,09/10/2005,Missouri,35,50,242,55,32,248,2,1,New Mexico,45,45,202,27,15,229,0,0,H,8.5,-10,5,40,28,17,19,2,1,2005
163,163,09/10/2005,Navy,38,54,210,29,15,248,2,0,Stanford,41,35,181,33,21,235,0,1,H,-3,-3,19,29,-4,-6,13,2,-1,2005
164,164,09/10/2005,Nebraska,31,30,120,33,14,114,1,0,Wake Forest,3,52,130,28,12,117,3,1,H,7.5,28,-22,-10,5,2,-3,-2,-1,2005
165,165,09/10/2005,Nevada-Las Vegas,34,41,193,34,22,250,1,0,Idaho,31,30,100,31,19,394,1,1,H,11.5,3,11,93,3,3,-144,0,-1,2005
166,166,09/10/2005,New Mexico,45,45,202,27,15,233,0,0,Missouri,35,50,242,55,32,248,2,1,V,-8.5,10,-5,-40,-28,-17,-15,-2,-1,2005
167,167,09/10/2005,New Mexico State,0,22,5,31,17,176,2,1,Colorado,39,50,238,33,22,233,0,2,V,-24,-39,-28,-233,-2,-5,-57,2,-1,2005
168,168,09/10/2005,North Carolina,21,26,61,39,18,280,3,0,Georgia Tech,27,33,122,48,25,353,0,0,V,-12,-6,-7,-61,-9,-7,-73,3,0,2005
169,169,09/10/2005,North Texas,14,44,152,16,10,122,0,0,Middle Tennessee,7,48,188,27,21,195,3,2,V,-4.5,7,-4,-36,-11,-11,-73,-3,-2,2005
170,170,09/10/2005,Northern Illinois,37,41,256,37,24,283,1,1,Northwestern,38,47,282,32,21,220,0,1,V,-3,-1,-6,-26,5,3,63,1,0,2005
171,171,09/10/2005,Northwestern,38,47,282,32,21,220,0,1,Northern Illinois,37,41,256,37,24,283,1,1,H,3,1,6,26,-5,-3,-63,-1,0,2005
172,172,09/10/2005,Notre Dame,17,44,104,30,19,140,0,1,Michigan,10,29,114,44,19,223,1,1,V,-7,7,15,-10,-14,0,-83,-1,0,2005
173,173,09/10/2005,Ohio State,22,36,111,26,14,144,0,1,Texas,25,38,112,29,18,270,2,1,H,1,-3,-2,-1,-3,-4,-126,-2,0,2005
174,174,09/10/2005,Oklahoma,31,45,227,13,5,42,2,0,Tulsa,15,39,98,36,24,246,1,1,H,31,16,6,129,-23,-19,-204,1,-1,2005
175,175,09/10/2005,Oregon,47,38,87,48,27,339,0,2,Montana,14,30,31,31,16,113,2,1,H, ,33,8,56,17,11,226,-2,1,2005
176,176,09/10/2005,Oregon State,30,30,83,38,27,279,0,2,Boise State,27,44,149,36,19,233,0,2,H,5,3,-14,-66,2,8,46,0,0,2005
177,177,09/10/2005,Penn State,42,37,148,22,15,245,1,2,Cincinnati,24,34,31,49,29,329,2,2,H,19.5,18,3,117,-27,-14,-84,-1,0,2005
178,178,09/10/2005,Purdue,49,50,211,36,23,267,0,1,Akron,24,21,23,46,26,362,0,2,H,35,25,29,188,-10,-3,-95,0,-1,2005
179,179,09/10/2005,Rice,21,49,192,17,8,63,0,2,U.C.L.A.,63,39,253,27,19,325,0,0,V,-24,-42,10,-61,-10,-11,-262,0,2,2005
180,180,09/10/2005,Rutgers,38,33,96,28,19,276,0,0,Villanova,6,31,85,54,33,359,0,1,H, ,32,2,11,-26,-14,-83,0,-1,2005
181,181,09/10/2005,S-M-U,21,52,178,21,11,101,0,1,Texas Christian,10,32,119,36,16,134,3,1,H,-16,11,20,59,-15,-5,-33,-3,0,2005
182,182,09/10/2005,San Diego State,29,33,164,44,27,253,1,2,Air Force,41,67,272,12,10,231,0,1,V,-5.5,-12,-34,-108,32,17,22,1,1,2005
183,183,09/10/2005,San Jose State,19,25,15,30,19,216,1,0,Illinois,40,53,243,29,20,249,1,0,V,-16.5,-21,-28,-228,1,-1,-33,0,0,2005
184,184,09/10/2005,South Carolina,15,23,43,34,22,236,2,0,Georgia,17,49,238,17,8,112,2,0,V,-17,-2,-26,-195,17,14,124,0,0,2005
185,185,09/10/2005,South Florida,37,56,377,18,8,113,0,1,Florida A+M,3,26,31,20,9,54,1,0,H, ,34,30,346,-2,-1,59,-1,1,2005
186,186,09/10/2005,Southern Miss,21,23,9,30,15,190,1,0,Alabama,30,43,140,37,21,330,1,1,V,-12,-9,-20,-131,-7,-6,-140,0,-1,2005
187,187,09/10/2005,Stanford,41,35,181,33,21,235,0,1,Navy,38,54,210,29,15,248,2,0,V,3,3,-19,-29,4,6,-13,-2,1,2005
188,188,09/10/2005,Syracuse,31,55,348,22,10,139,0,0,Buffalo,0,29,50,27,9,73,2,0,H,24,31,26,298,-5,1,66,-2,0,2005
189,189,09/10/2005,Temple,0,26,-11,26,6,56,1,0,Wisconsin,65,53,263,25,15,229,0,1,V,-34,-65,-27,-274,1,-9,-173,1,-1,2005
190,190,09/10/2005,Texas,25,38,112,29,18,270,2,1,Ohio State,22,36,111,26,14,144,0,1,V,-1,3,2,1,3,4,126,2,0,2005
191,191,09/10/2005,Texas Christian,10,32,119,36,16,134,3,1,S-M-U,21,52,172,21,11,101,0,1,V,16,-11,-20,-53,15,5,33,3,0,2005
192,192,09/10/2005,Texas Tech,56,23,135,45,36,518,0,0,Florida Intl,3,38,135,42,26,214,0,2,H,33,53,-15,0,3,10,304,0,-2,2005
193,193,09/10/2005,Toledo,56,43,254,39,29,358,1,0,Western Michigan,23,30,84,35,20,215,0,0,H,23,33,13,170,4,9,143,1,0,2005
194,194,09/10/2005,Troy,7,20,26,26,12,164,4,0,U-A-B,27,39,164,38,25,296,0,0,H,-7.5,-20,-19,-138,-12,-13,-132,4,0,2005
195,195,09/10/2005,Tulsa,15,39,98,36,24,246,1,1,Oklahoma,31,45,227,13,5,42,2,0,V,-31,-16,-6,-129,23,19,204,-1,1,2005
196,196,09/10/2005,U-A-B,27,39,164,38,25,296,0,0,Troy,7,20,26,26,12,164,4,0,V,7.5,20,19,138,12,13,132,-4,0,2005
197,197,09/10/2005,U.C.L.A.,63,39,253,27,19,325,0,0,Rice,21,49,192,17,8,63,0,2,H,24,42,-10,61,10,11,262,0,-2,2005
198,198,09/10/2005,UL-Lafayette,10,37,182,29,21,228,0,4,Eastern Michigan,31,41,156,39,27,268,0,1,V,-4.5,-21,-4,26,-10,-6,-40,0,3,2005
199,199,09/10/2005,UL-Monroe,0,32,94,39,16,126,2,0,Wyoming,38,45,210,31,18,253,3,0,V,-18,-38,-13,-116,8,-2,-127,-1,0,2005
200,200,09/10/2005,Utah,31,49,242,22,18,268,0,2,Utah State,7,38,163,25,12,95,1,1,H,24,24,11,79,-3,6,173,-1,1,2005
201,201,09/10/2005,Utah State,7,38,163,25,12,95,1,1,Utah,31,49,242,22,18,268,0,2,V,-24,-24,-11,-79,3,-6,-173,1,-1,2005
202,202,09/10/2005,Vanderbilt,28,33,130,45,23,278,1,0,Arkansas,24,43,194,30,17,204,1,0,V,-11.5,4,-10,-64,15,6,74,0,0,2005
203,203,09/10/2005,Virginia Tech,45,44,180,22,13,182,1,0,Duke,0,35,13,18,5,22,1,0,V,20.5,45,9,167,4,8,160,0,0,2005
204,204,09/10/2005,Wake Forest,3,52,130,28,12,117,3,1,Nebraska,31,30,120,33,14,114,1,0,V,-7.5,-28,22,10,-5,-2,3,2,1,2005
205,205,09/10/2005,Washington,17,27,68,39,22,301,1,0,California,56,39,286,27,17,271,1,0,H,-10.5,-39,-12,-218,12,5,30,0,0,2005
206,206,09/10/2005,West Virginia,35,64,339,18,12,172,0,0,Wofford,7,45,78,12,6,76,2,2,H, ,28,19,261,6,6,96,-2,-2,2005
207,207,09/10/2005,Western Michigan,23,30,84,34,20,215,0,0,Toledo,56,43,254,39,29,358,1,0,V,-23,-33,-13,-170,-5,-9,-143,-1,0,2005
208,208,09/10/2005,Wisconsin,65,53,263,25,15,229,0,1,Temple,0,26,-11,26,6,56,1,0,H,34,65,27,274,-1,9,173,-1,1,2005
209,209,09/10/2005,Wyoming,38,45,210,31,18,254,3,0,UL-Monroe,0,32,94,39,16,126,2,0,H,18,38,13,116,-8,2,128,1,0,2005
210,210,09/15/2005,Texas Christian,23,46,228,17,8,88,0,1,Utah,20,50,109,31,15,208,1,1,H,-2.5,3,-4,119,-14,-7,-120,-1,0,2005
211,211,09/15/2005,Utah,20,50,109,31,15,208,1,1,Texas Christian,23,46,228,17,8,88,0,1,V,2.5,-3,4,-119,14,7,120,1,0,2005
212,212,09/16/2005,Houston,41,42,183,50,32,331,5,1,UTEP,44,32,174,51,26,379,2,2,V,-11.5,-3,10,9,-1,6,-48,3,-1,2005
213,213,09/16/2005,UTEP,44,32,174,51,26,379,2,2,Houston,41,42,183,50,32,331,5,1,H,11.5,3,-10,-9,1,-6,48,-3,1,2005
214,214,09/17/2005,Air Force,28,63,286,12,4,53,2,1,Wyoming,29,33,68,29,19,267,0,1,H,1.5,-1,30,218,-17,-15,-214,2,0,2005
215,215,09/17/2005,Akron,17,39,102,43,23,319,3,0,Middle Tennessee,7,23,54,40,23,157,0,1,V,-7,10,16,48,3,0,162,3,-1,2005
216,216,09/17/2005,Alabama,37,52,338,22,13,151,0,0,South Carolina,14,19,71,39,21,185,1,1,V,1,23,33,267,-17,-8,-34,-1,-1,2005
217,217,09/17/2005,Arizona,24,23,9,40,23,287,1,1,Purdue,31,45,239,18,7,140,1,0,H,-9.5,-7,-22,-230,22,16,147,0,1,2005
218,218,09/17/2005,Arizona State,52,45,290,39,27,483,0,1,Northwestern,21,32,180,38,25,236,0,1,H,14.5,31,13,110,1,2,247,0,0,2005
219,219,09/17/2005,Arkansas,17,52,197,26,12,129,2,0,Southern Cal,70,33,291,34,23,445,0,0,V,-30.5,-53,19,-94,-8,-11,-316,2,0,2005
220,220,09/17/2005,Arkansas State,10,47,200,24,11,122,1,2,Oklahoma State,20,31,125,21,8,148,0,3,V,-26,-10,16,75,3,3,-26,1,-1,2005
221,221,09/17/2005,Army,10,40,56,37,19,228,2,0,Baylor,20,37,146,30,20,205,2,1,H,-4.5,-10,3,-90,7,-1,23,0,-1,2005
222,222,09/17/2005,Auburn,63,35,390,22,17,182,0,0,Ball State,3,29,93,26,14,127,1,0,H,37,60,6,297,-4,3,55,-1,0,2005
223,223,09/17/2005,Ball State,3,29,93,26,14,127,1,0,Auburn,63,35,390,22,17,182,0,0,V,-37,-60,-6,-297,4,-3,-55,1,0,2005
224,224,09/17/2005,Baylor,20,37,146,30,20,205,2,1,Army,10,40,56,37,19,228,2,0,V,4.5,10,-3,90,-7,1,-23,0,1,2005
225,225,09/17/2005,Boston College,17,48,140,42,27,240,2,0,Florida State,28,19,13,38,20,243,1,2,H,-1,-11,29,127,4,7,-3,1,-2,2005
226,226,09/17/2005,Buffalo,3,44,121,41,25,228,0,0,Rutgers,17,32,138,29,14,150,1,0,H,-21,-14,12,-17,12,11,78,-1,0,2005
227,227,09/17/2005,California,35,35,294,18,8,121,0,0,Illinois,20,43,109,37,21,228,0,0,H,19.5,15,-8,185,-19,-13,-107,0,0,2005
228,228,09/17/2005,Central Michigan,3,39,14,38,25,158,0,0,Penn State,40,31,138,36,22,381,1,2,V,-23,-37,8,-124,2,3,-223,-1,-2,2005
229,229,09/17/2005,Cincinnati,7,41,185,24,10,88,1,1,Western Carolina,3,34,82,40,20,202,3,0,H, ,4,7,103,-16,-10,-114,-2,1,2005
230,230,09/17/2005,Clemson,30,22,90,55,31,288,1,0,Miami-Florida,36,52,195,26,16,152,0,0,H,-7,-6,-30,-105,29,15,136,1,0,2005
231,231,09/17/2005,Connecticut,13,33,129,25,7,67,3,1,Georgia Tech,28,54,165,30,11,142,0,2,V,-15.5,-15,-21,-36,-5,-4,-75,3,-1,2005
232,232,09/17/2005,Duke,40,45,235,23,13,116,0,3,Virginia Military,14,34,70,22,14,109,2,1,H, ,26,11,165,1,-1,7,-2,2,2005
233,233,09/17/2005,East Carolina,34,26,118,45,20,292,0,0,Wake Forest,44,65,407,17,10,69,1,0,V,-15,-10,-39,-289,28,10,223,-1,0,2005
234,234,09/17/2005,Eastern Michigan,0,24,15,30,15,119,1,0,Michigan,55,56,232,28,20,233,0,0,V,-30,-55,-32,-217,2,-5,-114,1,0,2005
235,235,09/17/2005,Florida,16,37,68,26,17,179,0,0,Tennessee,7,25,66,35,16,147,0,1,H,3.5,9,12,2,-9,1,32,0,-1,2005
236,236,09/17/2005,Florida Atlantic,7,39,92,30,13,154,1,0,Minnesota,46,48,349,21,10,230,0,1,V,-33,-39,-9,-257,9,3,-76,1,-1,2005
237,237,09/17/2005,Florida State,28,19,13,38,20,243,1,2,Boston College,17,48,140,42,27,240,2,0,V,1,11,-29,-127,-4,-7,3,-1,2,2005
238,238,09/17/2005,Fresno State,34,28,112,43,33,418,1,0,Oregon,37,37,160,39,28,332,0,0,V,-3,-3,-9,-48,4,5,86,1,0,2005
239,239,09/17/2005,Georgia,44,29,280,24,16,263,0,2,UL-Monroe,7,38,88,34,18,123,1,3,H,38,37,-9,192,-10,-2,140,-1,-1,2005
240,240,09/17/2005,Georgia Tech,28,54,165,30,11,142,0,2,Connecticut,13,33,129,25,7,67,3,1,H,15.5,15,21,36,5,4,75,-3,1,2005
241,241,09/17/2005,Idaho,6,31,-4,30,20,190,2,0,Washington,34,39,192,18,10,148,1,1,V,-13,-28,-8,-196,12,10,42,1,-1,2005
242,242,09/17/2005,Illinois,20,43,109,37,21,228,0,0,California,35,35,294,18,8,121,0,0,V,-19.5,-15,8,-185,19,13,107,0,0,2005
243,243,09/17/2005,Indiana,38,60,305,22,17,135,0,0,Kentucky,14,25,77,20,11,140,0,1,H,4,24,35,228,2,6,-5,0,-1,2005
244,244,09/17/2005,Iowa,45,39,231,23,18,265,0,0,Northern Iowa,21,41,105,29,19,263,1,1,H, ,24,-2,126,-6,-1,2,-1,-1,2005
245,245,09/17/2005,Kansas,34,32,41,31,19,236,1,0,Louisiana Tech,14,30,38,46,26,257,4,0,H,14,20,2,3,-15,-7,-21,-3,0,2005
246,246,09/17/2005,Kent State,10,16,31,58,31,338,2,0,Miami-Ohio,27,51,176,37,22,251,1,2,H,-6,-17,-35,-145,21,9,87,1,-2,2005
247,247,09/17/2005,Kentucky,14,25,77,20,11,140,0,1,Indiana,38,60,305,22,17,135,0,0,V,-4,-24,-35,-228,-2,-6,5,0,1,2005
248,248,09/17/2005,Louisiana Tech,14,30,38,46,26,257,4,0,Kansas,34,32,41,31,19,236,1,0,V,-14,-20,-2,-3,15,7,21,3,0,2005
249,249,09/17/2005,Louisville,63,25,125,25,21,428,1,0,Oregon State,27,35,42,59,33,377,1,2,H,12.5,36,-10,83,-34,-12,51,0,-2,2005
250,250,09/17/2005,Maryland,19,29,50,31,20,291,0,1,West Virginia,31,64,301,11,8,86,0,1,H,4.5,-12,-35,-251,20,12,205,0,0,2005
251,251,09/17/2005,Memphis,59,54,398,23,17,194,0,0,Chattanooga,14,43,227,21,11,105,2,1,H, ,45,11,171,2,6,89,-2,-1,2005
252,252,09/17/2005,Miami-Florida,36,52,195,26,16,152,0,0,Clemson,30,22,90,55,31,288,1,0,V,7,6,30,105,-29,-15,-136,-1,0,2005
253,253,09/17/2005,Miami-Ohio,27,51,176,37,22,251,1,2,Kent State,10,16,31,58,31,338,2,0,V,6,17,35,145,-21,-9,-87,-1,2,2005
254,254,09/17/2005,Michigan,55,56,232,28,20,233,0,0,Eastern Michigan,0,24,15,30,15,119,1,0,H,30,55,32,217,-2,5,114,-1,0,2005
255,255,09/17/2005,Michigan State,44,36,161,27,16,327,1,2,Notre Dame,41,38,107,60,33,487,1,1,V,-7,3,-2,54,-33,-17,-160,0,1,2005
256,256,09/17/2005,Middle Tennessee,7,23,54,40,23,157,0,1,Akron,17,39,102,43,23,319,3,0,H,7,-10,-16,-48,-3,0,-162,-3,1,2005
257,257,09/17/2005,Minnesota,46,48,349,21,10,230,0,1,Florida Atlantic,7,39,92,30,13,154,1,0,H,33,39,9,257,-9,-3,76,-1,1,2005
258,258,09/17/2005,Mississippi,23,28,124,35,17,276,0,1,Vanderbilt,31,49,209,41,24,314,0,1,V,-4,-8,-21,-85,-6,-7,-38,0,0,2005
259,259,09/17/2005,Mississippi State,21,30,117,26,13,108,1,1,Tulane,14,35,87,48,27,206,0,2,V,3,7,-5,30,-22,-14,-98,1,-1,2005
260,260,09/17/2005,Missouri,52,49,303,37,26,211,0,0,Troy,21,30,74,42,22,260,0,1,H,18.5,31,19,229,-5,4,-49,0,-1,2005
261,261,09/17/2005,Nebraska,7,48,174,20,10,93,0,0,Pittsburgh,6,36,114,28,11,190,0,0,H,9,1,12,60,-8,-1,-97,0,0,2005
262,262,09/17/2005,Nevada-Las Vegas,14,34,205,26,7,58,1,2,Nevada-Reno,22,49,131,33,21,265,0,2,V,1.5,-8,-15,74,-7,-14,-207,1,0,2005
263,263,09/17/2005,Nevada-Reno,22,49,131,33,21,265,0,2,Nevada-Las Vegas,14,34,205,26,7,58,1,2,H,-1.5,8,15,-74,7,14,207,-1,0,2005
264,264,09/17/2005,New Mexico,38,52,314,22,14,170,1,0,New Mexico State,21,34,98,32,14,263,3,0,H,22,17,18,216,-10,0,-93,-2,0,2005
265,265,09/17/2005,New Mexico State,21,34,98,32,14,263,3,0,New Mexico,38,52,314,22,14,170,1,0,V,-22,-17,-18,-216,10,0,93,2,0,2005
266,266,09/17/2005,No Carolina State,54,42,189,28,18,286,1,3,Eastern Kentucky,10,31,48,37,10,180,2,3,H, ,44,11,141,-9,8,106,-1,0,2005
267,267,09/17/2005,North Carolina,5,25,57,37,16,281,1,0,Wisconsin,14,52,166,23,14,138,0,1,H,-4,-9,-27,-109,14,2,143,1,-1,2005
268,268,09/17/2005,North Texas,2,36,70,22,10,59,2,1,Tulsa,54,41,213,22,13,193,0,0,H,6.5,-52,-5,-143,0,-3,-134,2,1,2005
269,269,09/17/2005,Northern Illinois,42,40,318,24,15,265,1,0,Tennessee Tech,3,32,74,32,18,131,0,1,H, ,39,8,244,-8,-3,134,1,-1,2005
270,270,09/17/2005,Northwestern,21,32,180,38,25,236,0,1,Arizona State,52,45,290,39,27,483,0,1,V,-14.5,-31,-13,-110,-1,-2,-247,0,0,2005
271,271,09/17/2005,Notre Dame,41,38,107,60,33,487,1,1,Michigan State,44,36,161,27,16,327,1,2,H,7,-3,2,-54,33,17,160,0,-1,2005
272,272,09/17/2005,Ohio,0,32,87,23,10,102,2,1,Virginia Tech,45,53,218,19,14,257,0,0,V,-34,-45,-21,-131,4,-4,-155,2,1,2005
273,273,09/17/2005,Ohio State,27,46,179,36,23,196,1,1,San Diego State,6,19,13,22,14,166,0,1,H,27,21,27,166,14,9,30,1,0,2005
274,274,09/17/2005,Oklahoma,24,45,157,29,20,241,0,3,U.C.L.A.,41,30,83,38,28,314,0,0,V,-6.5,-17,15,74,-9,-8,-73,0,3,2005
275,275,09/17/2005,Oklahoma State,20,31,125,21,8,148,0,3,Arkansas State,10,47,200,24,11,122,1,2,H,26,10,-16,-75,-3,-3,26,-1,1,2005
276,276,09/17/2005,Oregon,37,37,160,39,28,332,0,0,Fresno State,34,28,112,43,33,418,1,0,H,3,3,9,48,-4,-5,-86,-1,0,2005
277,277,09/17/2005,Oregon State,27,35,42,59,33,377,1,2,Louisville,63,25,125,25,21,428,1,0,V,-12.5,-36,10,-83,34,12,-51,0,2,2005
278,278,09/17/2005,Penn State,40,31,138,36,22,381,1,2,Central Michigan,3,39,14,38,25,158,0,0,H,23,37,-8,124,-2,-3,223,1,2,2005
279,279,09/17/2005,Pittsburgh,6,36,114,28,11,190,0,0,Nebraska,7,48,174,20,10,93,0,0,V,-9,-1,-12,-60,8,1,97,0,0,2005
280,280,09/17/2005,Purdue,31,45,239,18,7,140,1,0,Arizona,24,23,9,40,23,287,1,1,V,9.5,7,22,230,-22,-16,-147,0,-1,2005
281,281,09/17/2005,Rice,10,46,110,15,4,99,0,2,Texas,51,47,361,18,11,122,1,0,V,-40,-41,-1,-251,-3,-7,-23,-1,2,2005
282,282,09/17/2005,Rutgers,17,32,138,29,14,150,1,0,Buffalo,3,44,121,41,25,228,0,0,V,21,14,-12,17,-12,-11,-78,1,0,2005
283,283,09/17/2005,S-M-U,8,26,39,45,23,309,2,2,Texas A+M,66,44,309,27,18,405,0,1,V,-29,-58,-18,-270,18,5,-96,2,1,2005
284,284,09/17/2005,San Diego State,6,19,13,22,14,166,0,1,Ohio State,27,46,179,36,23,196,1,1,V,-27,-21,-27,-166,-14,-9,-30,-1,0,2005
285,285,09/17/2005,South Carolina,14,19,71,39,21,185,1,1,Alabama,37,52,338,22,13,151,0,0,H,-1,-23,-33,-267,17,8,34,1,1,2005
286,286,09/17/2005,South Florida,31,66,326,17,11,100,0,0,U-C-F,14,20,45,40,19,208,0,1,H,10,17,46,281,-23,-8,-108,0,-1,2005
287,287,09/17/2005,Southern Cal,70,33,291,34,23,445,0,0,Arkansas,17,52,197,26,12,129,2,0,H,30.5,53,-19,94,8,11,316,-2,0,2005
288,288,09/17/2005,Southern Miss,48,50,197,32,20,259,3,1,McNeese State,20,29,74,25,13,182,2,2,H, ,28,21,123,7,7,77,1,-1,2005
289,289,09/17/2005,Stanford,17,30,74,21,8,118,1,3,UC-Davis,20,46,110,44,23,251,0,3,H, ,-3,-16,-36,-23,-15,-133,1,0,2005
290,290,09/17/2005,Syracuse,24,36,80,26,17,172,0,0,Virginia,27,44,271,26,16,145,3,0,H,-8.5,-3,-8,-191,0,1,27,-3,0,2005
291,291,09/17/2005,Temple,17,34,136,38,18,245,2,1,Toledo,42,33,196,32,23,197,1,0,H,-30,-25,1,-60,6,-5,48,1,1,2005
292,292,09/17/2005,Tennessee,7,25,66,35,16,147,0,1,Florida,16,37,68,26,17,179,0,0,V,-3.5,-9,-12,-2,9,-1,-32,0,1,2005
293,293,09/17/2005,Texas,51,47,361,18,11,122,1,0,Rice,10,46,110,15,4,99,0,2,H,40,41,1,251,3,7,23,1,-2,2005
294,294,09/17/2005,Texas A+M,66,44,309,27,18,405,0,1,S-M-U,8,26,39,45,23,309,2,2,H,29,58,18,270,-18,-5,96,-2,-1,2005
295,295,09/17/2005,Texas Tech,80,26,120,55,41,650,0,0,Sam Houston State,21,28,58,41,20,195,0,1,H, ,59,-2,62,14,21,455,0,-1,2005
296,296,09/17/2005,Toledo,42,33,196,32,23,197,1,0,Temple,17,34,136,38,18,245,2,1,V,30,25,-1,60,-6,5,-48,-1,-1,2005
297,297,09/17/2005,Troy,21,31,64,42,22,260,0,1,Missouri,52,49,303,37,26,211,0,0,V,-18.5,-31,-18,-239,5,-4,49,0,1,2005
298,298,09/17/2005,Tulane,14,35,87,48,27,206,0,2,Mississippi State,21,30,117,26,13,108,1,1,H,-3,-7,5,-30,22,14,98,-1,1,2005
299,299,09/17/2005,Tulsa,54,41,213,22,13,193,0,0,North Texas,2,36,70,22,10,59,2,1,V,-6.5,52,5,143,0,3,134,-2,-1,2005
300,300,09/17/2005,U-A-B,35,40,151,24,16,231,0,0,Jacksonville St,28,34,103,29,21,259,0,1,H, ,7,6,48,-5,-5,-28,0,-1,2005
301,301,09/17/2005,U-C-F,14,20,45,40,19,208,0,1,South Florida,31,66,326,17,11,100,0,0,V,-10,-17,-46,-281,23,8,108,0,1,2005
302,302,09/17/2005,U.C.L.A.,41,30,83,38,28,314,0,0,Oklahoma,24,45,157,29,20,241,0,3,H,6.5,17,-15,-74,9,8,73,0,-3,2005
303,303,09/17/2005,UL-Lafayette,49,42,322,28,18,222,2,1,Northwestern St(LA),28,48,244,29,15,184,1,5,H, ,21,-6,78,-1,3,38,1,-4,2005
304,304,09/17/2005,UL-Monroe,7,38,88,34,18,123,1,3,Georgia,44,29,280,24,16,263,0,2,V,-38,-37,9,-192,10,2,-140,1,1,2005
305,305,09/17/2005,Vanderbilt,31,49,209,41,24,314,0,1,Mississippi,23,28,124,35,17,276,0,1,H,4,8,21,85,6,7,38,0,0,2005
306,306,09/17/2005,Virginia,27,44,271,26,16,145,3,0,Syracuse,24,36,80,26,17,172,0,0,V,8.5,3,8,191,0,-1,-27,3,0,2005
307,307,09/17/2005,Virginia Tech,45,53,218,19,14,257,0,0,Ohio,0,32,87,23,10,102,2,1,H,34,45,21,131,-4,4,155,-2,-1,2005
308,308,09/17/2005,Wake Forest,44,65,407,17,10,69,1,0,East Carolina,34,26,118,45,20,292,0,0,H,15,10,39,289,-28,-10,-223,1,0,2005
309,309,09/17/2005,Washington,34,39,192,18,10,148,1,1,Idaho,6,31,-4,30,20,190,2,0,H,13,28,8,196,-12,-10,-42,-1,1,2005
310,310,09/17/2005,Washington State,48,48,204,35,22,311,0,2,Grambling,7,37,11,31,14,197,1,1,N, ,41,11,193,4,8,114,-1,1,2005
311,311,09/17/2005,West Virginia,31,64,301,11,8,86,0,1,Maryland,19,29,50,31,20,291,0,1,V,-4.5,12,35,251,-20,-12,-205,0,0,2005
312,312,09/17/2005,Western Michigan,34,37,178,45,26,262,2,0,Southern Illinois,28,35,117,30,15,241,2,1,H, ,6,2,61,15,11,21,0,-1,2005
313,313,09/17/2005,Wisconsin,14,52,166,23,14,138,0,1,North Carolina,5,25,57,37,16,281,1,0,V,4,9,27,109,-14,-2,-143,-1,1,2005
314,314,09/17/2005,Wyoming,29,33,68,29,19,267,0,1,Air Force,28,63,286,12,4,53,2,1,V,-1.5,1,-30,-218,17,15,214,-2,0,2005
315,315,09/21/2005,Boise State,48,64,337,26,17,209,0,2,Bowling Green,20,21,84,36,18,220,0,0,H,9,28,43,253,-10,-1,-11,0,2,2005
316,316,09/21/2005,Bowling Green,20,21,84,36,18,220,0,0,Boise State,48,64,337,26,17,209,0,2,V,-9,-28,-43,-253,10,1,11,0,-2,2005
317,317,09/22/2005,Air Force,35,50,251,27,13,234,2,1,Utah,38,43,152,30,21,305,1,1,V,-8,-3,7,99,-3,-8,-71,1,0,2005
318,318,09/22/2005,Florida Atlantic,21,42,181,31,14,168,4,0,UL-Monroe,28,39,172,31,19,214,3,1,H,7,-7,3,9,0,-5,-46,1,-1,2005
319,319,09/22/2005,Texas A+M,44,46,242,24,13,317,0,2,Texas State,31,30,115,36,26,378,1,2,H, ,13,16,127,-12,-13,-61,-1,0,2005
320,320,09/22/2005,UL-Monroe,28,39,172,31,19,214,3,1,Florida Atlantic,21,42,181,31,14,168,4,0,V,-7,7,-3,-9,0,5,46,-1,1,2005
321,321,09/22/2005,Utah,38,43,152,30,21,305,1,1,Air Force,35,50,251,27,13,234,2,1,H,8,3,-7,-99,3,8,71,-1,0,2005
322,322,09/23/2005,Army,21,47,132,34,19,233,3,0,Iowa State,28,32,71,26,18,158,3,0,H,-18.5,-7,15,61,8,1,75,0,0,2005
323,323,09/23/2005,California,41,45,311,26,17,284,0,0,New Mexico State,13,36,178,39,18,164,2,0,V,28,28,9,133,-13,-1,120,-2,0,2005
324,324,09/23/2005,Iowa State,28,32,71,26,18,158,3,0,Army,21,47,132,34,19,233,3,0,V,18.5,7,-15,-61,-8,-1,-75,0,0,2005
325,325,09/23/2005,New Mexico State,13,36,178,39,18,164,2,0,California,41,45,311,26,17,284,0,0,H,-28,-28,-9,-133,13,1,-120,2,0,2005
326,326,09/24/2005,Akron,48,32,119,39,20,406,0,0,Northern Illinois,42,27,50,52,39,486,1,1,H,-6,6,5,69,-13,-19,-80,-1,-1,2005
327,327,09/24/2005,Alabama,24,37,128,27,13,173,0,0,Arkansas,13,40,237,27,11,81,1,1,H,16.5,11,-3,-109,0,2,92,-1,-1,2005
328,328,09/24/2005,Arizona State,42,32,95,38,21,380,0,0,Oregon State,24,47,144,49,29,381,3,3,V,4.5,18,-15,-49,-11,-8,-1,-3,-3,2005
329,329,09/24/2005,Arkansas,13,40,237,27,11,81,1,1,Alabama,24,37,128,27,13,173,0,0,V,-16.5,-11,3,109,0,-2,-92,1,1,2005
330,330,09/24/2005,Arkansas State,66,35,304,13,11,194,0,2,Florida Intl,24,40,98,45,30,362,5,2,H,9.5,42,-5,206,-32,-19,-168,-5,0,2005
331,331,09/24/2005,Auburn,37,42,209,22,13,200,0,1,Western Kentucky,14,34,155,22,12,187,2,0,H, ,23,8,54,0,1,13,-2,1,2005
332,332,09/24/2005,Boston College,16,46,164,44,24,221,2,0,Clemson,13,29,102,28,19,149,0,0,V,-3,3,17,62,16,5,72,2,0,2005
333,333,09/24/2005,Brigham Young,50,39,97,51,30,517,2,1,Texas Christian,51,37,127,50,24,348,0,0,H,3.5,-1,2,-30,1,6,169,2,1,2005
334,334,09/24/2005,Central Michigan,20,49,202,31,18,182,0,0,Eastern Michigan,23,28,117,56,36,380,0,0,H,4,-3,21,85,-25,-18,-198,0,0,2005
335,335,09/24/2005,Clemson,13,29,102,28,19,149,0,0,Boston College,16,46,164,44,24,221,2,0,H,3,-3,-17,-62,-16,-5,-72,-2,0,2005
336,336,09/24/2005,Colorado,3,32,103,41,25,228,2,1,Miami-Florida,23,29,123,40,21,271,0,0,V,-14,-20,3,-20,1,4,-43,2,1,2005
337,337,09/24/2005,Colorado State,42,43,257,27,15,223,0,1,Nevada-Reno,21,31,95,34,23,324,2,1,H,16,21,12,162,-7,-8,-101,-2,0,2005
338,338,09/24/2005,Duke,7,39,107,18,9,108,3,1,Virginia,38,35,110,25,15,214,0,1,V,-24.5,-31,4,-3,-7,-6,-106,3,0,2005
339,339,09/24/2005,East Carolina,15,42,81,35,21,206,1,1,West Virginia,20,46,127,20,15,180,3,1,V,-20.5,-5,-4,-46,15,6,26,-2,0,2005
340,340,09/24/2005,Eastern Michigan,23,28,117,56,36,380,0,0,Central Michigan,20,49,202,31,18,182,0,0,V,-4,3,-21,-85,25,18,198,0,0,2005
341,341,09/24/2005,Florida,49,42,187,36,28,350,0,1,Kentucky,28,33,133,33,15,162,3,1,V,23.5,21,9,54,3,13,188,-3,0,2005
342,342,09/24/2005,Florida Intl,24,40,98,45,30,362,5,0,Arkansas State,66,35,304,13,11,194,0,0,V,-9.5,-42,5,-206,32,19,168,5,0,2005
343,343,09/24/2005,Georgia,23,34,94,36,21,312,0,1,Mississippi State,10,26,49,32,19,205,1,1,V,16,13,8,45,4,2,107,-1,0,2005
344,344,09/24/2005,Georgia Tech,7,25,74,32,13,143,2,1,Virginia Tech,51,44,97,22,13,223,0,0,V,-11,-44,-19,-23,10,0,-80,2,1,2005
345,345,09/24/2005,Hawaii,24,25,41,47,36,364,0,0,Idaho,0,21,41,25,8,112,1,0,V,-3,24,4,0,22,28,252,-1,0,2005
346,346,09/24/2005,Idaho,0,21,41,25,8,112,1,0,Hawaii,24,25,41,47,36,364,0,0,H,3,-24,-4,0,-22,-28,-252,1,0,2005
347,347,09/24/2005,Illinois,14,33,123,30,16,148,1,1,Michigan State,61,48,376,34,26,329,0,0,H,-11,-47,-15,-253,-4,-10,-181,1,1,2005
348,348,09/24/2005,Iowa,6,18,-9,39,22,146,1,0,Ohio State,31,60,314,21,14,216,0,2,V,-7.5,-25,-42,-323,18,8,-70,1,-2,2005
349,349,09/24/2005,Kansas State,54,53,305,22,15,353,1,0,North Texas,7,26,87,21,9,74,0,0,H,23,47,27,218,1,6,279,1,0,2005
350,350,09/24/2005,Kent State,32,24,72,51,30,388,6,0,Ohio,35,57,373,20,13,145,2,0,V,-4,-3,-33,-301,31,17,243,4,0,2005
351,351,09/24/2005,Kentucky,28,33,133,33,15,162,3,1,Florida,49,42,187,36,28,350,0,1,H,-23.5,-21,-9,-54,-3,-13,-188,3,0,2005
352,352,09/24/2005,Louisville,14,33,104,47,29,389,1,2,South Florida,45,47,251,10,5,104,1,1,V,23,-31,-14,-147,37,24,285,0,1,2005
353,353,09/24/2005,Marshall,13,16,11,58,33,368,2,2,U-C-F,23,43,76,26,19,260,1,2,V,3,-10,-27,-65,32,14,108,1,0,2005
354,354,09/24/2005,Maryland,22,46,162,22,12,169,1,1,Wake Forest,12,39,111,35,18,133,0,2,V,-2.5,10,7,51,-13,-6,36,1,-1,2005
355,355,09/24/2005,Memphis,31,48,335,24,9,147,0,2,Tulsa,37,47,197,23,15,234,1,0,V,0,-6,1,138,1,-6,-87,-1,2,2005
356,356,09/24/2005,Miami-Florida,23,29,123,40,21,271,0,0,Colorado,3,32,103,41,25,228,2,1,H,14,20,-3,20,-1,-4,43,-2,-1,2005
357,357,09/24/2005,Michigan,20,36,143,34,16,258,1,1,Wisconsin,23,43,140,32,15,147,1,0,V,3,-3,-7,3,2,1,111,0,1,2005
358,358,09/24/2005,Michigan State,61,48,376,34,26,329,0,0,Illinois,14,33,123,30,16,148,1,1,V,11,47,15,253,4,10,181,-1,-1,2005
359,359,09/24/2005,Minnesota,42,68,301,36,22,271,3,0,Purdue,35,29,180,34,15,246,2,0,H,3,7,39,121,2,7,25,1,0,2005
360,360,09/24/2005,Mississippi,14,28,162,29,12,120,3,1,Wyoming,24,43,163,34,17,220,1,0,H,2.5,-10,-15,-1,-5,-5,-100,2,1,2005
361,361,09/24/2005,Mississippi State,10,26,49,32,19,205,1,1,Georgia,23,34,94,36,21,312,0,1,H,-16,-13,-8,-45,-4,-2,-107,1,0,2005
362,362,09/24/2005,Nevada-Las Vegas,24,31,122,43,25,265,1,1,Utah State,31,35,61,29,21,222,0,1,V,4,-7,-4,61,14,4,43,1,0,2005
363,363,09/24/2005,Nevada-Reno,21,31,95,34,23,324,2,1,Colorado State,42,43,257,27,15,223,0,1,V,-16,-21,-12,-162,7,8,101,2,0,2005
364,364,09/24/2005,New Mexico,13,43,149,25,15,136,1,0,UTEP,21,31,70,31,16,178,1,0,V,-2.5,-8,12,79,-6,-1,-42,0,0,2005
365,365,09/24/2005,No Carolina State,24,28,13,35,21,257,0,2,North Carolina,31,49,144,23,13,177,1,1,H,10,-7,-21,-131,12,8,80,-1,1,2005
366,366,09/24/2005,North Carolina,31,49,144,23,13,177,1,1,No Carolina State,24,28,13,35,21,257,0,2,V,-10,7,21,131,-12,-8,-80,1,-1,2005
367,367,09/24/2005,North Texas,7,26,87,21,9,74,0,0,Kansas State,54,53,305,22,15,353,1,0,V,-23,-47,-27,-218,-1,-6,-279,-1,0,2005
368,368,09/24/2005,Northern Illinois,42,27,58,52,39,486,1,1,Akron,48,32,119,39,20,406,0,0,V,6,-6,-5,-61,13,19,80,1,1,2005
369,369,09/24/2005,Northwestern,29,57,198,38,20,229,1,1,Penn State,34,27,209,36,17,271,3,1,H,-6.5,-5,30,-11,2,3,-42,-2,0,2005
370,370,09/24/2005,Notre Dame,36,47,233,37,25,327,0,0,Washington,17,22,41,40,19,408,1,2,V,13,19,25,192,-3,6,-81,-1,-2,2005
371,371,09/24/2005,Ohio,35,57,373,20,13,145,2,0,Kent State,32,24,72,51,30,388,6,0,H,4,3,33,301,-31,-17,-243,-4,0,2005
372,372,09/24/2005,Ohio State,31,60,314,21,14,216,0,2,Iowa,6,18,-9,39,22,146,1,0,H,7.5,25,42,323,-18,-8,70,-1,2,2005
373,373,09/24/2005,Oregon,13,29,65,37,21,197,1,0,Southern Cal,45,42,278,39,23,315,1,1,H,-20,-32,-13,-213,-2,-2,-118,0,-1,2005
374,374,09/24/2005,Oregon State,24,47,144,49,29,381,3,3,Arizona State,42,32,95,38,21,380,0,0,H,-4.5,-18,15,49,11,8,1,3,3,2005
375,375,09/24/2005,Penn State,34,27,209,36,17,271,3,1,Northwestern,29,57,198,38,20,229,1,1,V,6.5,5,-30,11,-2,-3,42,2,0,2005
376,376,09/24/2005,Pittsburgh,41,43,221,24,15,307,1,1,Youngstown State,0,31,109,25,8,43,1,0,H, ,41,12,112,-1,7,264,0,1,2005
377,377,09/24/2005,Purdue,35,29,180,34,15,246,2,0,Minnesota,42,69,305,36,22,267,3,0,V,-3,-7,-40,-125,-2,-7,-21,-1,0,2005
378,378,09/24/2005,S-M-U,10,31,63,18,8,64,0,2,Tulane,31,47,144,34,22,213,1,0,H,-4,-21,-16,-81,-16,-14,-149,-1,2,2005
379,379,09/24/2005,San Diego State,52,57,210,33,25,303,0,1,San Jose State,21,30,132,40,12,101,2,0,H,14.5,31,27,78,-7,13,202,-2,1,2005
380,380,09/24/2005,San Jose State,21,30,132,40,12,101,2,0,San Diego State,52,57,210,33,25,303,0,1,V,-14.5,-31,-27,-78,7,-13,-202,2,-1,2005
381,381,09/24/2005,South Carolina,45,41,116,23,17,268,0,0,Troy,20,40,137,30,12,99,1,4,H,18.5,25,1,-21,-7,5,169,-1,-4,2005
382,382,09/24/2005,South Florida,45,47,251,10,5,104,1,1,Louisville,14,33,104,47,29,389,1,2,H,-23,31,14,147,-37,-24,-285,0,-1,2005
383,383,09/24/2005,Southern Cal,45,42,278,39,23,315,1,1,Oregon,13,29,65,37,21,197,1,0,V,20,32,13,213,2,2,118,0,1,2005
384,384,09/24/2005,Temple,16,45,127,23,10,158,1,2,Western Michigan,19,43,151,36,22,227,2,3,H,-3.5,-3,2,-24,-13,-12,-69,-1,-1,2005
385,385,09/24/2005,Texas Christian,51,37,127,50,24,348,0,0,Brigham Young,50,39,97,51,30,517,2,1,V,-3.5,1,-2,30,-1,-6,-169,-2,-1,2005
386,386,09/24/2005,Texas Tech,63,23,242,47,34,296,1,0,Indiana State,7,39,148,32,16,120,0,3,H, ,56,-16,94,15,18,176,1,-3,2005
387,387,09/24/2005,Troy,20,40,137,30,12,99,1,4,South Carolina,45,41,116,23,17,268,0,0,V,-18.5,-25,-1,21,7,-5,-169,1,4,2005
388,388,09/24/2005,Tulane,31,47,144,34,22,213,1,0,S-M-U,10,31,63,18,8,64,0,2,V,4,21,16,81,16,14,149,1,-2,2005
389,389,09/24/2005,Tulsa,37,47,197,23,15,234,1,0,Memphis,31,48,335,24,9,147,0,2,H,0,6,-1,-138,-1,6,87,1,-2,2005
390,390,09/24/2005,U-C-F,23,43,76,26,19,260,1,2,Marshall,13,16,11,58,33,368,2,2,H,-3,10,27,65,-32,-14,-108,-1,0,2005
391,391,09/24/2005,UTEP,21,31,70,31,16,178,1,0,New Mexico,13,43,149,25,15,136,1,0,H,2.5,8,-12,-79,6,1,42,0,0,2005
392,392,09/24/2005,Utah State,31,35,61,29,21,222,0,1,Nevada-Las Vegas,24,31,122,43,25,265,1,1,H,-4,7,4,-61,-14,-4,-43,-1,0,2005
393,393,09/24/2005,Vanderbilt,37,37,237,42,29,276,0,0,Richmond,13,24,89,31,16,250,1,0,H, ,24,13,148,11,13,26,-1,0,2005
394,394,09/24/2005,Virginia,38,35,110,25,15,214,0,1,Duke,7,39,107,18,9,108,3,1,H,24.5,31,-4,3,7,6,106,-3,0,2005
395,395,09/24/2005,Virginia Tech,51,44,97,22,13,223,0,0,Georgia Tech,7,25,74,32,13,143,2,1,H,11,44,19,23,-10,0,80,-2,-1,2005
396,396,09/24/2005,Wake Forest,12,39,111,35,18,133,0,2,Maryland,22,46,162,22,12,169,1,1,H,2.5,-10,-7,-51,13,6,-36,-1,1,2005
397,397,09/24/2005,Washington,17,22,41,40,19,408,1,2,Notre Dame,36,47,233,37,25,327,0,0,H,-13,-19,-25,-192,3,-6,81,1,2,2005
398,398,09/24/2005,West Virginia,20,46,127,20,15,180,3,1,East Carolina,15,42,81,35,21,206,1,1,H,20.5,5,4,46,-15,-6,-26,2,0,2005
399,399,09/24/2005,Western Michigan,19,42,145,37,23,233,2,3,Temple,16,45,127,23,10,158,1,2,V,3.5,3,-3,18,14,13,75,1,1,2005
400,400,09/24/2005,Wisconsin,23,43,140,32,15,147,1,0,Michigan,20,36,143,34,16,258,1,1,H,-3,3,7,-3,-2,-1,-111,0,-1,2005
401,401,09/24/2005,Wyoming,24,43,163,34,17,220,1,0,Mississippi,14,28,162,29,12,120,3,1,V,-2.5,10,15,1,5,5,100,-2,-1,2005
402,402,09/26/2005,Louisiana State,27,33,98,28,14,258,1,2,Tennessee,30,34,70,51,28,250,2,2,H,6,-3,-1,28,-23,-14,8,-1,0,2005
403,403,09/26/2005,Tennessee,30,34,70,51,28,250,2,2,Louisiana State,27,33,98,28,14,158,1,2,V,-6,3,1,-28,23,14,92,1,0,2005
404,404,09/27/2005,Fresno State,44,33,179,17,9,69,0,1,Toledo,14,49,141,24,16,163,1,2,H,9.5,30,-16,38,-7,-7,-94,-1,-1,2005
405,405,09/27/2005,Toledo,14,49,141,24,16,163,1,2,Fresno State,44,33,179,17,9,69,0,1,V,-9.5,-30,16,-38,7,7,94,1,1,2005
406,406,09/28/2005,Cincinnati,16,27,66,46,27,248,5,0,Miami-Ohio,44,40,174,37,23,365,1,0,V,-14,-28,-13,-108,9,4,-117,4,0,2005
407,407,09/28/2005,Miami-Ohio,44,40,174,37,23,365,1,0,Cincinnati,16,27,66,46,27,248,5,0,H,14,28,13,108,-9,-4,117,-4,0,2005
408,408,09/29/2005,Air Force,23,44,227,20,9,130,0,2,Colorado State,41,42,213,29,18,338,1,1,V,-4,-18,2,14,-9,-9,-208,-1,1,2005
409,409,09/29/2005,Colorado State,41,42,213,29,18,338,1,1,Air Force,23,44,227,20,9,130,0,2,H,4,18,-2,-14,9,9,208,1,-1,2005
410,410,09/30/2005,Pittsburgh,29,25,-11,59,35,371,1,2,Rutgers,37,43,203,28,14,250,2,0,V,-1.5,-8,-18,-214,31,21,121,-1,2,2005
411,411,09/30/2005,Rutgers,37,43,203,28,14,250,2,0,Pittsburgh,29,25,-11,59,35,371,1,2,H,1.5,8,18,214,-31,-21,-121,1,-2,2005
412,412,10/01/2005,Akron,17,24,90,57,30,270,3,1,Central Michigan,31,39,237,33,18,224,1,0,H,11,-14,-15,-147,24,12,46,2,1,2005
413,413,10/01/2005,Alabama,31,37,121,18,15,286,0,2,Florida,3,31,139,37,16,187,2,0,H,-4,28,6,-18,-19,-1,99,-2,2,2005
414,414,10/01/2005,Arizona,0,28,37,36,19,169,3,0,California,28,44,194,21,14,137,1,1,V,-15.5,-28,-16,-157,15,5,32,2,-1,2005
415,415,10/01/2005,Arizona State,28,32,68,45,26,347,5,0,Southern Cal,38,49,373,39,23,258,0,1,H,-17,-10,-17,-305,6,3,89,5,-1,2005
416,416,10/01/2005,Arkansas State,27,51,175,32,22,275,1,1,UL-Monroe,31,34,148,32,16,261,0,0,V,2,-4,17,27,0,6,14,1,1,2005
417,417,10/01/2005,Army,13,40,71,42,19,190,4,0,Connecticut,47,44,167,27,18,180,0,0,H,-9.5,-34,-4,-96,15,1,10,4,0,2005
418,418,10/01/2005,Auburn,48,39,123,34,21,265,0,0,South Carolina,7,28,70,24,16,129,0,1,H,12.5,41,11,53,10,5,136,0,-1,2005
419,419,10/01/2005,Ball State,0,32,46,24,18,113,0,0,Boston College,38,38,223,33,24,248,0,2,V,-36,-38,-6,-177,-9,-6,-135,0,-2,2005
420,420,10/01/2005,Baylor,13,45,125,45,25,225,0,2,Texas A+M,16,34,155,31,12,132,2,0,V,-24.5,-3,11,-30,14,13,93,-2,2,2005
421,421,10/01/2005,Boise State,44,48,223,33,18,207,1,3,Hawaii,41,22,114,55,30,442,2,0,V,11,3,26,109,-22,-12,-235,-1,3,2005
422,422,10/01/2005,Boston College,38,38,223,33,24,248,0,2,Ball State,0,32,46,24,18,101,0,0,H,36,38,6,177,9,6,147,0,2,2005
423,423,10/01/2005,Bowling Green,70,41,135,31,26,326,1,0,Temple,7,38,161,24,12,102,3,2,H,29,63,3,-26,7,14,224,-2,-2,2005
424,424,10/01/2005,Brigham Young,10,19,44,49,25,261,2,1,San Diego State,31,55,265,31,21,243,0,1,V,2.5,-21,-36,-221,18,4,18,2,0,2005
425,425,10/01/2005,Buffalo,21,41,72,38,30,288,0,1,Western Michigan,31,31,151,24,14,184,0,0,V,-10,-10,10,-79,14,16,104,0,1,2005
426,426,10/01/2005,California,28,44,194,21,14,137,1,1,Arizona,0,28,37,36,19,169,3,0,H,15.5,28,16,157,-15,-5,-32,-2,1,2005
427,427,10/01/2005,Central Michigan,31,39,237,33,18,224,1,0,Akron,17,24,90,57,30,270,3,1,V,-11,14,15,147,-24,-12,-46,-2,-1,2005
428,428,10/01/2005,Clemson,27,38,150,42,28,304,2,0,Wake Forest,31,41,133,25,20,222,1,1,V,6,-4,-3,17,17,8,82,1,-1,2005
429,429,10/01/2005,Colorado,34,40,215,30,16,168,0,1,Oklahoma State,0,37,87,29,14,116,2,0,V,3,34,3,128,1,2,52,-2,1,2005
430,430,10/01/2005,Connecticut,47,44,167,27,18,180,0,0,Army,13,40,71,42,19,190,4,0,V,9.5,34,4,96,-15,-1,-10,-4,0,2005
431,431,10/01/2005,Duke,21,58,179,27,16,152,1,0,Navy,28,35,326,9,4,87,1,1,H,-6,-7,23,-147,18,12,65,0,-1,2005
432,432,10/01/2005,East Carolina,7,34,161,28,20,202,1,4,Southern Miss,33,42,169,35,23,324,0,1,H,-7,-26,-8,-8,-7,-3,-122,1,3,2005
433,433,10/01/2005,Eastern Michigan,27,41,122,40,23,218,1,0,Kent State,20,30,76,46,29,243,2,0,H,2.5,7,11,46,-6,-6,-25,-1,0,2005
434,434,10/01/2005,Florida,3,31,139,37,16,187,2,0,Alabama,31,37,121,18,15,286,0,2,V,4,-28,-6,18,19,1,-99,2,-2,2005
435,435,10/01/2005,Florida Atlantic,10,42,15,25,15,187,1,1,Louisville,61,41,326,24,15,282,1,0,V,-38,-51,1,-311,1,0,-95,0,1,2005
436,436,10/01/2005,Florida Intl,23,44,244,23,15,226,0,0,Florida A+M,6,26,28,18,10,126,2,0,H, ,17,18,216,5,5,100,-2,0,2005
437,437,10/01/2005,Florida State,38,36,116,36,22,384,1,1,Syracuse,14,31,45,25,14,189,1,3,H,20.5,24,5,71,11,8,195,0,-2,2005
438,438,10/01/2005,Hawaii,41,22,114,55,30,442,2,0,Boise State,44,48,223,33,18,207,1,3,H,-11,-3,-26,-109,22,12,235,1,-3,2005
439,439,10/01/2005,Houston,30,45,200,31,19,276,1,1,Tulsa,23,26,77,49,26,283,1,2,V,-3,7,19,123,-18,-7,-7,0,-1,2005
440,440,10/01/2005,Idaho,27,41,101,25,20,238,1,2,Utah State,13,34,136,27,14,157,3,0,H,-2.5,14,7,-35,-2,6,81,-2,2,2005
441,441,10/01/2005,Illinois,7,33,141,44,32,233,1,0,Iowa,35,39,301,23,17,175,1,1,V,-18,-28,-6,-160,21,15,58,0,-1,2005
442,442,10/01/2005,Indiana,24,33,125,41,20,244,2,2,Wisconsin,41,38,103,24,13,274,2,0,V,-19,-17,-5,22,17,7,-30,0,2,2005
443,443,10/01/2005,Iowa,35,39,301,23,17,175,1,1,Illinois,7,33,141,44,32,233,1,0,H,18,28,6,160,-21,-15,-58,0,1,2005
444,444,10/01/2005,Iowa State,20,38,57,41,23,317,1,0,Nebraska,27,25,36,55,36,431,0,1,V,-4.5,-7,13,21,-14,-13,-114,1,-1,2005
445,445,10/01/2005,Kansas,17,37,117,38,21,154,2,1,Texas Tech,30,26,47,53,34,333,1,2,V,-15.5,-13,11,70,-15,-13,-179,1,-1,2005
446,446,10/01/2005,Kansas State,21,32,22,29,14,226,1,2,Oklahoma,43,44,232,22,12,139,0,0,V,-6.5,-22,-12,-210,7,2,87,1,2,2005
447,447,10/01/2005,Kent State,20,30,76,46,29,243,2,0,Eastern Michigan,27,41,122,40,23,218,1,0,V,-2.5,-7,-11,-46,6,6,25,1,0,2005
448,448,10/01/2005,Louisiana State,37,38,180,27,22,122,0,1,Mississippi State,7,28,56,26,11,173,1,0,V,15,30,10,124,1,11,-51,-1,1,2005
449,449,10/01/2005,Louisiana Tech,34,42,177,39,22,249,0,0,New Mexico State,14,25,92,43,25,261,4,2,H,10.5,20,17,85,-4,-3,-12,-4,-2,2005
450,450,10/01/2005,Louisville,61,41,326,24,15,282,1,0,Florida Atlantic,10,42,15,25,15,187,1,1,H,38,51,-1,311,-1,0,95,0,-1,2005
451,451,10/01/2005,Marshall,16,33,99,60,34,314,1,0,S-M-U,13,34,40,25,10,151,0,0,H,11.5,3,-1,59,35,24,163,1,0,2005
452,452,10/01/2005,Maryland,45,46,250,33,25,320,2,0,Virginia,33,35,136,35,17,270,0,0,H,-3.5,12,11,114,-2,8,50,2,0,2005
453,453,10/01/2005,Memphis,27,51,252,21,13,122,0,0,UTEP,20,25,74,53,23,431,3,3,H,-3,7,26,178,-32,-10,-309,-3,-3,2005
454,454,10/01/2005,Miami-Florida,27,45,173,26,13,173,1,3,South Florida,7,39,107,33,11,69,4,1,H,22,20,6,66,-7,2,104,-3,2,2005
455,455,10/01/2005,Michigan,34,43,232,36,26,256,1,1,Michigan State,31,37,173,31,20,282,2,1,V,-4,3,6,59,5,6,-26,-1,0,2005
456,456,10/01/2005,Michigan State,31,37,173,31,20,282,2,1,Michigan,34,43,232,36,26,256,1,1,H,4,-3,-6,-59,-5,-6,26,1,0,2005
457,457,10/01/2005,Middle Tennessee,17,31,62,22,14,147,0,0,Vanderbilt,15,33,102,45,26,245,1,0,V,-17,2,-2,-40,-23,-12,-98,-1,0,2005
458,458,10/01/2005,Minnesota,14,32,113,28,16,174,1,1,Penn State,44,59,364,32,13,175,0,0,V,3,-30,-27,-251,-4,3,-1,1,1,2005
459,459,10/01/2005,Mississippi,10,25,50,38,18,200,2,1,Tennessee,27,48,172,35,18,206,0,0,V,-21,-17,-23,-122,3,0,-6,2,1,2005
460,460,10/01/2005,Mississippi State,7,28,56,26,11,173,1,0,Louisiana State,37,38,180,27,22,222,0,1,H,-15,-30,-10,-124,-1,-11,-49,1,-1,2005
461,461,10/01/2005,Missouri,20,47,139,39,21,191,1,2,Texas,51,50,349,22,15,236,1,1,H,-14.5,-31,-3,-210,17,6,-45,0,1,2005
462,462,10/01/2005,Navy,28,35,326,9,4,87,1,1,Duke,21,58,179,27,16,152,1,0,V,6,7,-23,147,-18,-12,-65,0,1,2005
463,463,10/01/2005,Nebraska,27,25,36,55,36,431,0,1,Iowa State,20,38,57,41,23,317,1,0,H,4.5,7,-13,-21,14,13,114,-1,1,2005
464,464,10/01/2005,Nevada-Las Vegas,17,32,91,48,26,239,2,1,Wyoming,42,33,95,31,23,346,0,0,V,-16.5,-25,-1,-4,17,3,-107,2,1,2005
465,465,10/01/2005,Nevada-Reno,30,44,148,35,20,226,0,2,San Jose State,23,25,49,40,20,328,2,0,V,4,7,19,99,-5,0,-102,-2,2,2005
466,466,10/01/2005,New Mexico,28,45,175,44,25,245,4,2,Texas Christian,49,34,272,28,16,192,0,1,V,-3,-21,11,-97,16,9,53,4,1,2005
467,467,10/01/2005,New Mexico State,14,25,92,43,25,261,4,2,Louisiana Tech,34,42,177,39,22,249,0,0,V,-10.5,-20,-17,-85,4,3,12,4,2,2005
468,468,10/01/2005,North Carolina,31,39,85,31,16,267,2,0,Utah,17,38,167,34,22,211,1,4,H,3.5,14,1,-82,-3,-6,56,1,-4,2005
469,469,10/01/2005,Notre Dame,49,50,153,39,30,468,2,0,Purdue,28,24,164,58,33,350,1,1,V,-3.5,21,26,-11,-19,-3,118,1,-1,2005
470,470,10/01/2005,Oklahoma,43,44,232,22,12,139,0,0,Kansas State,21,32,22,29,14,226,1,2,H,6.5,22,12,210,-7,-2,-87,-1,-2,2005
471,471,10/01/2005,Oklahoma State,0,38,92,29,14,116,2,0,Colorado,34,41,213,28,16,168,0,1,H,-3,-34,-3,-121,1,-2,-52,2,-1,2005
472,472,10/01/2005,Oregon,44,35,132,39,30,463,1,1,Stanford,20,27,64,29,16,156,2,1,V,7,24,8,68,10,14,307,-1,0,2005
473,473,10/01/2005,Oregon State,44,36,114,45,20,296,2,1,Washington State,33,38,107,59,31,531,4,1,H,2.5,11,-2,7,-14,-11,-235,-2,0,2005
474,474,10/01/2005,Penn State,44,59,364,32,13,175,0,0,Minnesota,14,32,113,28,16,174,1,1,H,-3,30,27,251,4,-3,1,-1,-1,2005
475,475,10/01/2005,Purdue,28,24,164,58,33,350,1,1,Notre Dame,49,50,153,39,30,468,2,0,H,3.5,-21,-26,11,19,3,-118,-1,1,2005
476,476,10/01/2005,Rice,26,51,267,18,9,98,3,1,U-A-B,45,31,134,36,27,372,0,0,V,-19.5,-19,20,133,-18,-18,-274,3,1,2005
477,477,10/01/2005,S-M-U,13,34,40,25,10,151,0,0,Marshall,16,33,99,60,34,314,1,0,V,-11.5,-3,1,-59,-35,-24,-163,-1,0,2005
478,478,10/01/2005,San Diego State,31,55,265,31,21,243,0,2,Brigham Young,10,19,44,49,25,261,2,1,H,-2.5,21,36,221,-18,-4,-18,-2,1,2005
479,479,10/01/2005,San Jose State,23,25,49,40,20,328,2,0,Nevada-Reno,30,44,148,35,20,226,0,3,H,-4,-7,-19,-99,5,0,102,2,-3,2005
480,480,10/01/2005,South Carolina,7,28,70,24,16,129,0,1,Auburn,48,39,123,34,21,265,0,0,V,-12.5,-41,-11,-53,-10,-5,-136,0,1,2005
481,481,10/01/2005,South Florida,7,40,105,31,11,69,4,1,Miami-Florida,27,46,178,26,13,173,1,3,V,-22,-20,-6,-73,5,-2,-104,3,-2,2005
482,482,10/01/2005,Southern Cal,38,49,373,39,23,258,0,1,Arizona State,28,32,68,45,26,347,5,0,V,17,10,17,305,-6,-3,-89,-5,1,2005
483,483,10/01/2005,Southern Miss,33,42,169,35,23,324,0,1,East Carolina,7,34,161,28,20,202,1,4,V,7,26,8,8,7,3,122,-1,-3,2005
484,484,10/01/2005,Stanford,20,27,64,29,16,156,2,1,Oregon,44,35,132,39,30,463,1,1,H,-7,-24,-8,-68,-10,-14,-307,1,0,2005
485,485,10/01/2005,Syracuse,14,31,45,25,14,189,1,3,Florida State,38,36,116,36,22,396,1,1,V,-20.5,-24,-5,-71,-11,-8,-207,0,2,2005
486,486,10/01/2005,Temple,7,38,161,24,12,102,3,2,Bowling Green,70,41,135,31,26,326,1,0,V,-29,-63,-3,26,-7,-14,-224,2,2,2005
487,487,10/01/2005,Tennessee,27,48,172,35,18,206,0,0,Mississippi,10,25,50,38,18,200,2,1,H,21,17,23,122,-3,0,6,-2,-1,2005
488,488,10/01/2005,Texas,51,50,349,22,15,236,1,1,Missouri,20,47,139,39,21,191,1,2,V,14.5,31,3,210,-17,-6,45,0,-1,2005
489,489,10/01/2005,Texas A+M,16,34,155,31,12,132,2,0,Baylor,13,45,125,45,25,222,0,2,H,24.5,3,-11,30,-14,-13,-90,2,-2,2005
490,490,10/01/2005,Texas Christian,49,34,272,28,16,192,0,1,New Mexico,28,45,175,44,25,245,4,2,H,3,21,-11,97,-16,-9,-53,-4,-1,2005
491,491,10/01/2005,Texas Tech,30,26,47,53,34,333,1,2,Kansas,17,37,117,38,21,154,2,1,H,15.5,13,-11,-70,15,13,179,-1,1,2005
492,492,10/01/2005,Tulane,28,21,28,50,24,324,2,0,S E Louisiana,21,27,41,54,38,268,1,1,H, ,7,-6,-13,-4,-14,56,1,-1,2005
493,493,10/01/2005,Tulsa,23,26,77,49,26,283,1,2,Houston,30,45,200,31,19,276,1,1,H,3,-7,-19,-123,18,7,7,0,1,2005
494,494,10/01/2005,U-A-B,45,31,134,36,27,372,0,0,Rice,26,50,277,18,9,98,3,1,H,19.5,19,-19,-143,18,18,274,-3,-1,2005
495,495,10/01/2005,U-C-F,24,48,129,25,15,232,1,1,UL-Lafayette,21,40,181,29,15,128,2,0,V,3.5,3,8,-52,-4,0,104,-1,1,2005
496,496,10/01/2005,U.C.L.A.,21,25,65,44,29,287,2,0,Washington,17,41,213,28,14,188,0,2,H,22,4,-16,-148,16,15,99,2,-2,2005
497,497,10/01/2005,UL-Lafayette,21,40,181,29,15,128,2,0,U-C-F,24,48,129,25,15,232,1,1,H,-3.5,-3,-8,52,4,0,-104,1,-1,2005
498,498,10/01/2005,UL-Monroe,31,34,148,32,16,261,0,0,Arkansas State,27,51,175,32,22,275,1,1,H,-2,4,-17,-27,0,-6,-14,-1,-1,2005
499,499,10/01/2005,UTEP,20,25,74,53,23,431,3,3,Memphis,27,51,252,21,13,122,0,0,V,3,-7,-26,-178,32,10,309,3,3,2005
500,500,10/01/2005,Utah,17,38,167,34,22,211,1,4,North Carolina,31,39,85,31,16,267,2,0,V,-3.5,-14,-1,82,3,6,-56,-1,4,2005
501,501,10/01/2005,Utah State,13,33,136,27,14,157,3,0,Idaho,27,41,101,25,20,238,1,2,V,2.5,-14,-8,35,2,-6,-81,2,-2,2005
502,502,10/01/2005,Vanderbilt,15,33,102,45,26,245,1,0,Middle Tennessee,17,31,62,22,14,147,0,0,H,17,-2,2,40,23,12,98,1,0,2005
503,503,10/01/2005,Virginia,33,35,136,35,17,270,0,0,Maryland,45,46,250,33,25,320,2,0,V,3.5,-12,-11,-114,2,-8,-50,-2,0,2005
504,504,10/01/2005,Virginia Tech,34,53,214,17,15,177,0,0,West Virginia,17,34,150,14,11,103,0,2,V,11,17,19,64,3,4,74,0,-2,2005
505,505,10/01/2005,Wake Forest,31,41,133,25,20,222,1,1,Clemson,27,38,150,42,28,304,2,0,H,-6,4,3,-17,-17,-8,-82,-1,1,2005
506,506,10/01/2005,Washington,17,41,213,28,14,188,0,2,U.C.L.A.,21,25,65,44,29,287,2,0,V,-22,-4,16,148,-16,-15,-99,-2,2,2005
507,507,10/01/2005,Washington State,33,38,107,59,31,531,4,1,Oregon State,44,36,114,45,20,296,2,1,V,-2.5,-11,2,-7,14,11,235,2,0,2005
508,508,10/01/2005,West Virginia,17,34,150,14,11,103,0,2,Virginia Tech,34,53,214,17,15,177,0,0,H,-11,-17,-19,-64,-3,-4,-74,0,2,2005
509,509,10/01/2005,Western Michigan,31,31,151,24,14,184,0,0,Buffalo,21,41,72,38,30,288,0,1,H,10,10,-10,79,-14,-16,-104,0,-1,2005
510,510,10/01/2005,Wisconsin,41,38,103,24,13,274,2,0,Indiana,24,33,125,41,20,244,2,2,H,19,17,5,-22,-17,-7,30,0,-2,2005
511,511,10/01/2005,Wyoming,42,34,95,31,23,346,0,0,Nevada-Las Vegas,17,32,91,48,26,239,2,1,H,16.5,25,2,4,-17,-3,107,-2,-1,2005
512,512,10/04/2005,North Texas,10,31,100,27,9,129,2,3,Troy,13,64,283,12,5,40,1,1,H,3,-3,-33,-183,15,4,89,1,2,2005
513,513,10/04/2005,Troy,13,64,283,12,5,40,1,1,North Texas,10,31,100,27,9,129,2,3,V,-3,3,33,183,-15,-4,-89,-1,-2,2005
514,514,10/05/2005,Miami-Ohio,27,31,168,32,17,133,1,0,Northern Illinois,38,42,220,22,19,296,1,1,V,-3,-11,-11,-52,10,-2,-163,0,-1,2005
515,515,10/05/2005,Northern Illinois,38,42,220,22,19,296,1,1,Miami-Ohio,27,31,168,32,17,133,1,0,H,3,11,11,52,-10,2,163,0,1,2005
516,516,10/06/2005,Florida Atlantic,28,50,154,27,17,276,0,0,UL-Lafayette,10,33,170,18,6,47,2,0,V,-6,18,17,-16,9,11,229,-2,0,2005
517,517,10/06/2005,Georgia Tech,14,38,164,53,21,279,2,0,No Carolina State,17,31,56,25,18,230,2,0,H,5.5,-3,7,108,28,3,49,0,0,2005
518,518,10/06/2005,No Carolina State,17,31,56,25,18,230,2,0,Georgia Tech,14,38,164,53,21,279,2,0,V,-5.5,3,-7,-108,-28,-3,-49,0,0,2005
519,519,10/06/2005,UL-Lafayette,10,33,170,18,6,47,2,0,Florida Atlantic,28,50,154,27,17,276,0,0,H,6,-18,-17,16,-9,-11,-229,2,0,2005
520,520,10/07/2005,Connecticut,26,58,297,15,6,45,0,0,Syracuse,7,33,160,32,10,125,2,1,H,4.5,19,25,137,-17,-4,-80,-2,-1,2005
521,521,10/07/2005,Syracuse,7,34,148,31,10,125,2,1,Connecticut,26,58,297,15,6,45,0,0,V,-4.5,-19,-24,-149,16,4,80,2,1,2005
522,522,10/08/2005,Air Force,24,49,195,9,6,111,1,0,Navy,27,52,217,12,8,171,1,1,V,-1.5,-3,-3,-22,-3,-2,-60,0,-1,2005
523,523,10/08/2005,Akron,13,36,79,33,12,145,0,1,Buffalo,7,38,66,25,12,71,1,1,V,13,6,-2,13,8,0,74,-1,0,2005
524,524,10/08/2005,Arizona,21,23,64,25,16,181,1,0,Southern Cal,42,52,337,44,29,387,1,1,V,-36,-21,-29,-273,-19,-13,-206,0,-1,2005
525,525,10/08/2005,Arizona State,17,25,53,56,31,277,2,0,Oregon,31,47,234,40,20,278,2,1,H,8.5,-14,-22,-181,16,11,-1,0,-1,2005
526,526,10/08/2005,Arkansas,44,49,321,20,12,119,1,1,UL-Monroe,15,42,177,36,15,150,1,1,H,23,29,7,144,-16,-3,-31,0,0,2005
527,527,10/08/2005,Army,10,46,173,13,7,66,0,1,Central Michigan,14,39,165,25,15,92,0,1,H,0,-4,7,8,-12,-8,-26,0,0,2005
528,528,10/08/2005,Ball State,60,57,240,41,23,306,1,0,Western Michigan,57,55,171,36,26,373,2,1,V,-10,3,2,69,5,-3,-67,-1,-1,2005
529,529,10/08/2005,Baylor,23,34,116,26,18,160,0,1,Iowa State,13,38,110,31,19,210,1,2,V,-10,10,-4,6,-5,-1,-50,-1,-1,2005
530,530,10/08/2005,Boise State,21,49,213,29,21,256,2,0,Portland State,14,27,165,30,16,104,0,0,H, ,7,22,48,-1,5,152,2,0,2005
531,531,10/08/2005,Boston College,28,37,196,37,25,301,1,1,Virginia,17,39,155,35,21,195,1,1,H,6.5,11,-2,41,2,4,106,0,0,2005
532,532,10/08/2005,Bowling Green,38,45,192,41,24,381,1,1,Ohio,14,33,68,27,13,171,2,0,H,22.5,24,12,124,14,11,210,-1,1,2005
533,533,10/08/2005,Brigham Young,27,30,93,44,34,371,1,0,New Mexico,24,45,244,28,18,218,0,1,V,-7.5,3,-15,-151,16,16,153,1,-1,2005
534,534,10/08/2005,Buffalo,7,37,78,26,12,71,1,1,Akron,13,36,79,33,12,145,0,1,H,-13,-6,1,-1,-7,0,-74,1,0,2005
535,535,10/08/2005,California,40,41,330,35,18,215,1,0,U.C.L.A.,47,31,170,33,17,225,0,1,V,-2.5,-7,10,160,2,1,-10,1,-1,2005
536,536,10/08/2005,Central Michigan,14,39,165,25,15,92,0,1,Army,10,46,173,13,7,66,0,1,V,0,4,-7,-8,12,8,26,0,0,2005
537,537,10/08/2005,Cincinnati,20,41,113,32,13,199,1,1,Pittsburgh,38,41,146,32,14,175,0,2,V,-13,-18,0,-33,0,-1,24,1,-1,2005
538,538,10/08/2005,Colorado,41,37,158,38,29,401,0,0,Texas A+M,20,28,78,36,19,258,0,1,H,3,21,9,80,2,10,143,0,-1,2005
539,539,10/08/2005,Colorado State,21,30,151,26,18,226,1,0,Utah,17,45,170,27,15,255,2,0,H,4,4,-15,-19,-1,3,-29,-1,0,2005
540,540,10/08/2005,Duke,7,40,120,17,4,8,0,1,Miami-Florida,52,40,255,40,22,302,2,1,V,-35,-45,0,-135,-23,-18,-294,-2,0,2005
541,541,10/08/2005,East Carolina,41,30,104,35,22,355,0,0,Rice,28,53,230,19,9,87,0,0,H,6,13,-23,-126,16,13,268,0,0,2005
542,542,10/08/2005,Eastern Michigan,3,25,101,43,25,190,1,1,Toledo,30,41,295,27,16,161,0,0,V,-20.5,-27,-16,-194,16,9,29,1,1,2005
543,543,10/08/2005,Florida,35,37,191,38,21,289,3,1,Mississippi State,9,30,109,25,11,134,1,2,H,27.5,26,7,82,13,10,155,2,-1,2005
544,544,10/08/2005,Florida State,41,36,192,37,24,395,0,0,Wake Forest,24,43,247,25,18,168,0,0,H,20,17,-7,-55,12,6,227,0,0,2005
545,545,10/08/2005,Fresno State,37,49,207,19,10,112,0,0,New Mexico State,7,28,90,31,17,105,0,2,V,26,30,21,117,-12,-7,7,0,-2,2005
546,546,10/08/2005,Georgia,27,42,198,27,16,207,1,1,Tennessee,14,26,48,36,21,310,1,2,V,-3.5,13,16,150,-9,-5,-103,0,-1,2005
547,547,10/08/2005,Hawaii,14,15,11,37,26,269,1,1,Louisiana Tech,46,54,327,20,14,149,0,0,V,-4.5,-32,-39,-316,17,12,120,1,1,2005
548,548,10/08/2005,Houston,35,46,248,22,11,192,0,0,Tulane,14,37,120,33,13,120,0,1,V,1.5,21,9,128,-11,-2,72,0,-1,2005
549,549,10/08/2005,Idaho,14,23,38,49,25,275,1,1,Nevada-Reno,62,44,265,32,23,272,0,0,V,-10,-48,-21,-227,17,2,3,1,1,2005
550,550,10/08/2005,Illinois,13,35,113,39,22,230,2,1,Indiana,36,47,205,35,22,198,1,2,V,-4.5,-23,-12,-92,4,0,32,1,-1,2005
551,551,10/08/2005,Indiana,36,47,205,35,22,198,1,2,Illinois,13,35,113,39,22,230,2,1,H,4.5,23,12,92,-4,0,-32,-1,1,2005
552,552,10/08/2005,Iowa,34,50,178,33,19,357,0,0,Purdue,17,24,92,50,31,353,1,0,V,-4,17,26,86,-17,-12,4,-1,0,2005
553,553,10/08/2005,Iowa State,13,38,110,31,19,210,1,2,Baylor,23,34,116,26,18,160,0,1,H,10,-10,4,-6,5,1,50,1,1,2005
554,554,10/08/2005,Kansas,3,33,109,22,8,127,0,3,Kansas State,12,45,35,24,15,147,1,0,V,-7,-9,-12,74,-2,-7,-20,-1,3,2005
555,555,10/08/2005,Kansas State,12,45,35,24,15,147,1,0,Kansas,3,33,109,22,8,127,0,3,H,7,9,12,-74,2,7,20,1,-3,2005
556,556,10/08/2005,Kentucky,16,53,213,18,12,95,1,4,South Carolina,44,34,139,35,24,278,1,1,V,-12.5,-28,19,74,-17,-12,-183,0,3,2005
557,557,10/08/2005,Louisiana State,34,42,186,33,22,293,1,3,Vanderbilt,6,26,25,33,11,113,2,1,V,14,28,16,161,0,11,180,-1,2,2005
558,558,10/08/2005,Louisiana Tech,46,54,327,20,14,149,0,0,Hawaii,14,15,11,37,26,269,1,1,H,4.5,32,39,316,-17,-12,-120,-1,-1,2005
559,559,10/08/2005,Louisville,69,38,144,24,18,307,0,0,North Carolina,14,38,108,30,19,224,1,3,H,12,55,0,36,-6,-1,83,-1,-3,2005
560,560,10/08/2005,Marshall,14,44,164,28,14,117,1,1,Virginia Tech,41,42,233,18,12,176,1,0,V,-35,-27,2,-69,10,2,-59,0,1,2005
561,561,10/08/2005,Maryland,38,46,220,35,22,252,1,1,Temple,7,37,110,16,8,116,1,3,V,27,31,9,110,19,14,136,0,-2,2005
562,562,10/08/2005,Memphis,17,32,221,23,14,80,1,0,U-C-F,38,57,261,21,14,290,0,0,V,4,-21,-25,-40,2,0,-210,1,0,2005
563,563,10/08/2005,Miami-Florida,52,40,255,40,22,302,2,1,Duke,7,40,120,17,4,8,0,1,H,35,45,0,135,23,18,294,2,0,2005
564,564,10/08/2005,Michigan,20,34,94,29,14,155,0,0,Minnesota,23,57,264,23,11,139,0,1,H,7.5,-3,-23,-170,6,3,16,0,-1,2005
565,565,10/08/2005,Minnesota,23,57,264,23,11,139,0,1,Michigan,20,34,94,29,14,155,0,0,V,-7.5,3,23,170,-6,-3,-16,0,1,2005
566,566,10/08/2005,Mississippi,27,38,112,30,20,254,1,2,The Citadel,7,28,60,14,5,21,1,1,H, ,20,10,52,16,15,233,0,1,2005
567,567,10/08/2005,Mississippi State,9,30,109,25,11,134,1,2,Florida,35,36,183,39,22,297,3,1,V,-27.5,-26,-6,-74,-14,-11,-163,-2,1,2005
568,568,10/08/2005,Missouri,38,49,326,29,22,223,0,1,Oklahoma State,31,44,132,27,15,219,1,2,V,5.5,7,5,194,2,7,4,-1,-1,2005
569,569,10/08/2005,Navy,27,52,217,12,8,171,1,1,Air Force,24,49,195,9,6,111,1,0,H,1.5,3,3,22,3,2,60,0,1,2005
570,570,10/08/2005,Nebraska,31,35,135,35,21,229,2,3,Texas Tech,34,23,44,45,34,368,1,1,H,-3.5,-3,12,91,-10,-13,-139,1,2,2005
571,571,10/08/2005,Nevada-Las Vegas,13,49,153,18,8,88,2,1,San Diego State,10,35,34,28,14,106,3,1,H,-9,3,14,119,-10,-6,-18,-1,0,2005
572,572,10/08/2005,Nevada-Reno,62,44,265,32,23,272,0,0,Idaho,14,23,38,49,25,275,1,1,H,10,48,21,227,-17,-2,-3,-1,-1,2005
573,573,10/08/2005,New Mexico,24,45,244,28,18,218,0,1,Brigham Young,27,30,93,44,34,371,1,0,H,7.5,-3,15,151,-16,-16,-153,-1,1,2005
574,574,10/08/2005,New Mexico State,7,28,90,31,17,105,0,2,Fresno State,37,49,207,19,10,112,0,0,H,-26,-30,-21,-117,12,7,-7,0,2,2005
575,575,10/08/2005,North Carolina,14,38,108,30,19,224,1,3,Louisville,69,38,144,24,18,307,0,0,V,-12,-55,0,-36,6,1,-83,1,3,2005
576,576,10/08/2005,Northwestern,51,45,313,36,26,361,0,2,Wisconsin,48,41,189,32,24,326,2,0,H,-7,3,4,124,4,2,35,-2,2,2005
577,577,10/08/2005,Ohio,14,33,68,27,13,171,2,0,Bowling Green,38,45,192,41,24,381,1,1,V,-22.5,-24,-12,-124,-14,-11,-210,1,-1,2005
578,578,10/08/2005,Ohio State,10,40,91,25,13,139,1,1,Penn State,17,37,117,20,11,78,0,0,V,3,-7,3,-26,5,2,61,1,1,2005
579,579,10/08/2005,Oklahoma,12,33,77,33,12,94,1,1,Texas,45,40,203,27,14,241,0,1,N,-13.5,-33,-7,-126,6,-2,-147,1,0,2005
580,580,10/08/2005,Oklahoma State,31,44,132,27,15,219,1,2,Missouri,38,49,326,29,22,223,0,1,H,-5.5,-7,-5,-194,-2,-7,-4,1,1,2005
581,581,10/08/2005,Oregon,31,47,234,40,20,278,2,1,Arizona State,17,25,53,56,31,277,2,0,V,-8.5,14,22,181,-16,-11,1,0,1,2005
582,582,10/08/2005,Penn State,17,37,117,20,11,78,0,0,Ohio State,10,40,91,25,13,139,1,1,H,-3,7,-3,26,-5,-2,-61,-1,-1,2005
583,583,10/08/2005,Pittsburgh,38,41,146,32,14,175,0,2,Cincinnati,20,41,113,32,13,199,1,1,H,13,18,0,33,0,1,-24,-1,1,2005
584,584,10/08/2005,Purdue,17,24,92,50,31,353,1,0,Iowa,34,50,178,33,19,357,0,0,H,4,-17,-26,-86,17,12,-4,1,0,2005
585,585,10/08/2005,Rice,28,53,230,19,9,87,0,0,East Carolina,41,30,104,35,22,355,0,0,V,-6,-13,23,126,-16,-13,-268,0,0,2005
586,586,10/08/2005,Rutgers,14,40,124,31,18,171,3,1,West Virginia,27,43,236,11,9,78,0,0,H,-3,-13,-3,-112,20,9,93,3,1,2005
587,587,10/08/2005,S-M-U,28,36,80,43,30,333,0,1,U-A-B,27,23,73,35,22,344,2,1,V,-21,1,13,7,8,8,-11,-2,0,2005
588,588,10/08/2005,San Diego State,10,35,34,28,14,106,3,1,Nevada-Las Vegas,13,49,153,18,8,88,2,1,V,9,-3,-14,-119,10,6,18,1,0,2005
589,589,10/08/2005,San Jose State,17,29,85,42,16,227,0,0,Utah State,24,44,84,26,17,200,0,0,V,-6.5,-7,-15,1,16,-1,27,0,0,2005
590,590,10/08/2005,South Carolina,44,34,139,35,24,278,1,1,Kentucky,16,53,213,18,12,95,1,4,H,12.5,28,-19,-74,17,12,183,0,-3,2005
591,591,10/08/2005,Southern Cal,42,52,337,44,29,387,1,1,Arizona,21,23,64,25,16,181,1,0,H,36,21,29,273,19,13,206,0,1,2005
592,592,10/08/2005,Southern Miss,17,16,37,30,12,132,4,0,Tulsa,34,49,243,35,21,232,2,0,H,12,-17,-33,-206,-5,-9,-100,2,0,2005
593,593,10/08/2005,Stanford,24,47,218,29,19,257,0,0,Washington State,21,37,246,26,13,161,2,0,V,-12.5,3,10,-28,3,6,96,-2,0,2005
594,594,10/08/2005,Temple,7,37,110,16,8,116,1,3,Maryland,38,46,220,35,22,252,1,1,H,-27,-31,-9,-110,-19,-14,-136,0,2,2005
595,595,10/08/2005,Tennessee,14,26,48,36,21,310,1,2,Georgia,27,42,198,27,16,207,1,1,H,3.5,-13,-16,-150,9,5,103,0,1,2005
596,596,10/08/2005,Texas,45,40,203,27,14,241,0,1,Oklahoma,12,33,77,33,12,94,1,1,N,13.5,33,7,126,-6,2,147,-1,0,2005
597,597,10/08/2005,Texas A+M,20,28,78,36,19,258,0,1,Colorado,41,37,158,38,29,401,0,0,V,-3,-21,-9,-80,-2,-10,-143,0,1,2005
598,598,10/08/2005,Texas Christian,28,53,145,24,9,112,2,0,Wyoming,14,32,73,36,16,220,4,3,V,-5,14,21,72,-12,-7,-108,-2,-3,2005
599,599,10/08/2005,Texas Tech,34,23,44,45,34,368,1,1,Nebraska,31,35,135,35,21,229,2,3,V,3.5,3,-12,-91,10,13,139,-1,-2,2005
600,600,10/08/2005,Toledo,30,41,295,27,16,161,0,0,Eastern Michigan,3,25,101,43,25,190,1,1,H,20.5,27,16,194,-16,-9,-29,-1,-1,2005
601,601,10/08/2005,Tulane,14,37,120,33,13,120,0,1,Houston,35,46,248,22,11,192,0,0,H,-1.5,-21,-9,-128,11,2,-72,0,1,2005
602,602,10/08/2005,Tulsa,34,49,243,35,21,232,2,0,Southern Miss,17,16,37,30,12,132,4,0,V,-12,17,33,206,5,9,100,-2,0,2005
603,603,10/08/2005,U-A-B,27,23,73,35,22,344,2,1,S-M-U,28,36,80,43,30,333,0,1,H,21,-1,-13,-7,-8,-8,11,2,0,2005
604,604,10/08/2005,U-C-F,38,57,261,21,14,290,0,0,Memphis,17,32,221,23,14,80,1,0,H,-4,21,25,40,-2,0,210,-1,0,2005
605,605,10/08/2005,U.C.L.A.,47,31,170,33,17,225,0,1,California,40,41,330,35,18,215,1,0,H,2.5,7,-10,-160,-2,-1,10,-1,1,2005
606,606,10/08/2005,UL-Monroe,15,42,177,36,15,150,1,1,Arkansas,44,49,321,20,12,119,1,1,V,-23,-29,-7,-144,16,3,31,0,0,2005
607,607,10/08/2005,Utah,17,45,170,27,15,255,2,0,Colorado State,21,30,151,26,18,226,1,0,V,-4,-4,15,19,1,-3,29,1,0,2005
608,608,10/08/2005,Utah State,24,44,84,26,17,200,0,0,San Jose State,17,29,85,42,16,227,0,0,H,6.5,7,15,-1,-16,1,-27,0,0,2005
609,609,10/08/2005,Vanderbilt,6,26,25,33,11,113,2,1,Louisiana State,34,43,194,32,21,285,1,3,H,-14,-28,-17,-169,1,-10,-172,1,-2,2005
610,610,10/08/2005,Virginia,17,39,155,35,21,195,1,1,Boston College,28,37,196,37,25,301,1,1,V,-6.5,-11,2,-41,-2,-4,-106,0,0,2005
611,611,10/08/2005,Virginia Tech,41,42,233,18,12,176,1,0,Marshall,14,44,164,28,14,117,1,1,H,35,27,-2,69,-10,-2,59,0,-1,2005
612,612,10/08/2005,Wake Forest,24,43,247,25,18,168,0,0,Florida State,41,36,192,37,24,395,0,0,V,-20,-17,7,55,-12,-6,-227,0,0,2005
613,613,10/08/2005,Washington State,21,37,246,26,13,161,2,0,Stanford,24,47,218,29,19,257,0,0,H,12.5,-3,-10,28,-3,-6,-96,2,0,2005
614,614,10/08/2005,West Virginia,27,43,236,11,9,78,0,0,Rutgers,14,40,124,31,18,171,3,1,V,3,13,3,112,-20,-9,-93,-3,-1,2005
615,615,10/08/2005,Western Michigan,57,55,171,36,26,373,2,1,Ball State,60,57,240,41,23,306,1,0,H,10,-3,-2,-69,-5,3,67,1,1,2005
616,616,10/08/2005,Wisconsin,48,41,189,32,24,326,2,0,Northwestern,51,45,313,36,26,361,0,2,V,7,-3,-4,-124,-4,-2,-35,2,-2,2005
617,617,10/08/2005,Wyoming,14,32,73,36,16,220,4,3,Texas Christian,28,53,145,24,9,112,2,0,H,5,-14,-21,-72,12,7,108,2,3,2005
618,618,10/13/2005,Arkansas State,39,41,264,20,10,194,0,0,UL-Lafayette,36,66,457,17,10,97,1,2,H,10,3,-25,-193,3,0,97,-1,-2,2005
619,619,10/13/2005,Clemson,31,41,243,31,22,246,1,0,No Carolina State,10,27,92,36,19,175,1,1,V,-4.5,21,14,151,-5,3,71,0,-1,2005
620,620,10/13/2005,No Carolina State,10,27,92,36,19,175,1,1,Clemson,31,41,243,31,22,246,1,0,H,4.5,-21,-14,-151,5,-3,-71,0,1,2005
621,621,10/13/2005,UL-Lafayette,36,66,457,17,10,97,1,2,Arkansas State,39,41,264,20,10,194,0,0,V,-10,-3,25,193,-3,0,-97,1,2,2005
622,622,10/14/2005,Tulane,21,26,48,56,30,381,0,3,UTEP,45,35,149,32,22,278,0,0,H,-7,-24,-9,-101,24,8,103,0,3,2005
623,623,10/14/2005,UTEP,45,35,149,32,22,278,0,0,Tulane,21,26,48,56,30,381,0,3,V,7,24,9,101,-24,-8,-103,0,-3,2005
624,624,10/15/2005,Air Force,42,64,316,12,10,96,0,3,Nevada-Las Vegas,7,25,2,26,19,215,2,1,H,14.5,35,39,314,-14,-9,-119,-2,2,2005
625,625,10/15/2005,Akron,23,33,160,44,22,217,2,4,Miami-Ohio,51,37,248,38,23,332,1,1,V,-14.5,-28,-4,-88,6,-1,-115,1,3,2005
626,626,10/15/2005,Alabama,13,30,121,37,22,234,0,2,Mississippi,10,30,69,33,19,210,1,1,V,12.5,3,0,52,4,3,24,-1,1,2005
627,627,10/15/2005,Arizona,16,40,110,39,21,161,2,3,Stanford,20,32,58,26,16,137,0,0,H,6,-4,8,52,13,5,24,2,3,2005
628,628,10/15/2005,Arkansas,17,30,148,28,17,174,1,1,Auburn,34,52,233,26,17,203,2,0,H,-7.5,-17,-22,-85,2,0,-29,-1,1,2005
629,629,10/15/2005,Army,17,34,110,40,22,252,3,0,Texas Christian,38,48,184,30,22,219,1,0,V,-23,-21,-14,-74,10,0,33,2,0,2005
630,630,10/15/2005,Auburn,34,52,233,26,17,203,2,0,Arkansas,17,30,148,28,17,174,1,1,V,7.5,17,22,85,-2,0,29,1,-1,2005
631,631,10/15/2005,Ball State,14,40,114,19,11,76,2,1,Toledo,34,45,231,30,18,241,2,0,H,-19.5,-20,-5,-117,-11,-7,-165,0,1,2005
632,632,10/15/2005,Baylor,14,23,51,31,17,202,2,1,Nebraska,23,51,182,32,18,168,0,1,H,-2.5,-9,-28,-131,-1,-1,34,2,0,2005
633,633,10/15/2005,Boise State,38,49,229,29,20,249,2,0,San Jose State,21,31,54,34,17,217,0,3,H,32,17,18,175,-5,3,32,2,-3,2005
634,634,10/15/2005,Boston College,35,28,84,50,27,318,3,2,Wake Forest,30,51,124,33,21,193,0,0,H,15,5,-23,-40,17,6,125,3,2,2005
635,635,10/15/2005,Bowling Green,27,41,200,34,18,187,2,0,Buffalo,7,47,198,22,10,113,2,1,V,24,20,-6,2,12,8,74,0,-1,2005
636,636,10/15/2005,Brigham Young,24,52,274,18,13,168,1,1,Colorado State,14,21,30,30,22,281,0,1,H,-1,10,31,244,-12,-9,-113,1,0,2005
637,637,10/15/2005,Buffalo,7,47,198,22,10,113,2,1,Bowling Green,27,41,200,34,18,187,2,0,H,-24,-20,6,-2,-12,-8,-74,0,1,2005
638,638,10/15/2005,California,20,34,75,40,14,240,2,3,Oregon State,23,45,181,34,21,196,3,1,H,16,-3,-11,-106,6,-7,44,-1,2,2005
639,639,10/15/2005,Central Michigan,37,36,157,26,17,275,0,0,Ohio,10,48,196,36,12,101,1,2,H,6,27,-12,-39,-10,5,174,-1,-2,2005
640,640,10/15/2005,Cincinnati,28,40,223,21,9,125,0,1,Connecticut,17,47,165,43,19,191,1,3,H,-8.5,11,-7,58,-22,-10,-66,-1,-2,2005
641,641,10/15/2005,Colorado,17,19,45,44,21,192,1,1,Texas,42,47,145,32,26,337,0,1,V,-19,-25,-28,-100,12,-5,-145,1,0,2005
642,642,10/15/2005,Colorado State,14,21,30,30,22,281,0,1,Brigham Young,24,52,274,18,13,168,1,1,V,1,-10,-31,-244,12,9,113,-1,0,2005
643,643,10/15/2005,Connecticut,17,47,165,43,19,191,1,3,Cincinnati,28,40,223,21,9,125,0,1,V,8.5,-11,7,-58,22,10,66,1,2,2005
644,644,10/15/2005,Duke,10,42,181,30,9,90,2,1,Georgia Tech,35,49,257,27,17,147,1,1,H,-19,-25,-7,-76,3,-8,-57,1,0,2005
645,645,10/15/2005,East Carolina,24,51,127,22,15,225,1,0,S-M-U,17,34,143,37,19,211,4,1,V,-1,7,17,-16,-15,-4,14,-3,-1,2005
646,646,10/15/2005,Eastern Michigan,8,32,65,32,16,108,1,1,Northern Illinois,24,54,330,23,15,113,2,1,V,-19,-16,-22,-265,9,1,-5,-1,0,2005
647,647,10/15/2005,Florida,17,32,99,30,10,107,0,0,Louisiana State,21,44,125,22,14,236,2,3,V,-6,-4,-12,-26,8,-4,-129,-2,-3,2005
648,648,10/15/2005,Florida Atlantic,14,26,104,28,11,165,3,2,Middle Tennessee,35,64,263,19,12,115,1,0,H,-6,-21,-38,-159,9,-1,50,2,2,2005
649,649,10/15/2005,Florida Intl,10,27,79,32,20,243,2,6,North Texas,13,48,147,15,10,79,0,1,H,-1.5,-3,-21,-68,17,10,164,2,5,2005
650,650,10/15/2005,Florida State,21,21,95,59,35,377,3,0,Virginia,26,28,20,39,27,306,0,0,V,7,-5,-7,75,20,8,71,3,0,2005
651,651,10/15/2005,Fresno State,53,45,193,23,13,174,2,0,Utah State,21,36,44,24,14,158,1,2,H,33,32,9,149,-1,-1,16,1,-2,2005
652,652,10/15/2005,Georgia,34,34,148,32,15,298,1,0,Vanderbilt,17,39,150,28,15,174,1,0,V,16,17,-5,-2,4,0,124,0,0,2005
653,653,10/15/2005,Georgia Tech,35,49,257,27,17,147,1,1,Duke,10,42,181,30,9,90,2,1,V,19,25,7,76,-3,8,57,-1,0,2005
654,654,10/15/2005,Hawaii,49,18,97,59,40,531,1,1,New Mexico State,28,38,112,60,36,391,1,2,H,20,21,-20,-15,-1,4,140,0,-1,2005
655,655,10/15/2005,Houston,20,36,106,45,26,396,0,2,Memphis,35,56,315,12,7,112,1,1,H,9,-15,-20,-209,33,19,284,-1,1,2005
656,656,10/15/2005,Indiana,21,44,86,57,37,360,1,0,Iowa,38,33,160,24,12,265,0,2,V,-16,-17,11,-74,33,25,95,1,-2,2005
657,657,10/15/2005,Iowa,38,33,160,24,12,265,0,2,Indiana,21,44,86,57,37,360,1,0,H,16,17,-11,74,-33,-25,-95,-1,2,2005
658,658,10/15/2005,Iowa State,24,54,157,25,16,169,1,2,Missouri,27,37,88,35,24,230,1,2,V,-6,-3,17,69,-10,-8,-61,0,0,2005
659,659,10/15/2005,Kansas,3,22,11,30,11,86,3,1,Oklahoma,19,49,96,32,17,210,2,1,N,-4.5,-16,-27,-85,-2,-6,-124,1,0,2005
660,660,10/15/2005,Kansas State,20,31,114,25,14,192,1,2,Texas Tech,59,25,15,72,47,669,2,1,V,-11.5,-39,6,99,-47,-33,-477,-1,1,2005
661,661,10/15/2005,Kent State,31,27,97,41,25,292,2,1,Navy,34,70,336,13,8,196,2,2,V,-13,-3,-43,-239,28,17,96,0,-1,2005
662,662,10/15/2005,Louisiana State,21,44,125,22,14,236,2,3,Florida,17,32,99,30,11,107,0,0,H,6,4,12,26,-8,3,129,2,3,2005
663,663,10/15/2005,Louisiana Tech,27,32,68,39,13,161,1,0,Nevada-Reno,37,44,189,45,25,269,1,2,V,0,-10,-12,-121,-6,-12,-108,0,-2,2005
664,664,10/15/2005,Louisville,44,44,182,49,31,277,1,0,West Virginia,46,53,281,27,13,109,0,0,V,7,-2,-9,-99,22,18,168,1,0,2005
665,665,10/15/2005,Marshall,20,35,152,28,14,99,1,0,U-A-B,19,37,187,35,20,245,1,0,H,-5.5,1,-2,-35,-7,-6,-146,0,0,2005
666,666,10/15/2005,Memphis,35,56,315,12,7,112,1,1,Houston,20,36,106,45,26,396,0,2,V,-9,15,20,209,-33,-19,-284,1,-1,2005
667,667,10/15/2005,Miami-Florida,34,33,34,21,16,317,0,2,Temple,3,41,84,23,10,96,0,0,V,41,31,-8,-50,-2,6,221,0,2,2005
668,668,10/15/2005,Miami-Ohio,51,37,248,38,23,332,1,1,Akron,23,33,160,44,22,217,2,4,H,14.5,28,4,88,-6,1,115,-1,-3,2005
669,669,10/15/2005,Michigan,27,39,163,36,21,212,0,1,Penn State,25,38,181,34,19,239,1,1,H,3.5,2,1,-18,2,2,-27,-1,0,2005
670,670,10/15/2005,Michigan State,24,51,116,36,26,340,0,0,Ohio State,35,26,137,15,10,249,0,4,V,-7,-11,25,-21,21,16,91,0,-4,2005
671,671,10/15/2005,Middle Tennessee,35,64,263,19,12,115,1,0,Florida Atlantic,14,26,104,28,11,165,3,2,V,6,21,38,159,-9,1,-50,-2,-2,2005
672,672,10/15/2005,Minnesota,34,63,411,17,7,99,1,1,Wisconsin,38,36,131,26,15,235,0,1,H,5.5,-4,27,280,-9,-8,-136,1,0,2005
673,673,10/15/2005,Mississippi,10,30,69,33,19,210,1,1,Alabama,13,30,121,37,22,234,0,2,H,-12.5,-3,0,-52,-4,-3,-24,1,-1,2005
674,674,10/15/2005,Missouri,27,37,88,35,24,230,1,2,Iowa State,24,54,157,25,16,169,1,2,H,6,3,-17,-69,10,8,61,0,0,2005
675,675,10/15/2005,Navy,34,70,336,13,8,196,2,2,Kent State,31,27,97,41,25,292,2,1,H,13,3,43,239,-28,-17,-96,0,1,2005
676,676,10/15/2005,Nebraska,23,51,182,32,18,168,0,1,Baylor,14,23,51,31,17,202,2,1,V,2.5,9,28,131,1,1,-34,-2,0,2005
677,677,10/15/2005,Nevada-Las Vegas,7,25,2,26,19,215,2,1,Air Force,42,64,316,12,10,96,0,3,V,-14.5,-35,-39,-314,14,9,119,2,-2,2005
678,678,10/15/2005,Nevada-Reno,37,44,189,45,25,269,1,2,Louisiana Tech,27,32,68,39,13,161,1,0,H,0,10,12,121,6,12,108,0,2,2005
679,679,10/15/2005,New Mexico,27,66,237,22,13,118,0,2,Wyoming,24,19,93,35,19,214,2,0,V,-7,3,47,144,-13,-6,-96,-2,2,2005
680,680,10/15/2005,New Mexico State,28,38,112,60,36,391,1,2,Hawaii,49,18,97,59,40,531,1,1,V,-20,-21,20,15,1,-4,-140,0,1,2005
681,681,10/15/2005,North Texas,13,48,147,15,10,79,0,1,Florida Intl,10,27,79,32,20,243,2,6,V,1.5,3,21,68,-17,-10,-164,-2,-5,2005
682,682,10/15/2005,Northern Illinois,24,54,330,23,15,113,2,1,Eastern Michigan,8,32,65,32,16,108,1,1,H,19,16,22,265,-9,-1,5,1,0,2005
683,683,10/15/2005,Northwestern,34,27,128,57,38,475,0,1,Purdue,29,36,127,65,40,378,2,2,V,-7.5,5,-9,1,-8,-2,97,-2,-1,2005
684,684,10/15/2005,Notre Dame,31,52,153,35,19,264,1,1,Southern Cal,34,31,175,33,17,301,2,0,H,-12,-3,21,-22,2,2,-37,-1,1,2005
685,685,10/15/2005,Ohio,10,48,196,36,12,101,1,2,Central Michigan,37,36,157,26,17,275,0,0,V,-6,-27,12,39,10,-5,-174,1,2,2005
686,686,10/15/2005,Ohio State,35,26,137,15,10,249,0,4,Michigan State,24,51,116,36,26,340,0,0,H,7,11,-25,21,-21,-16,-91,0,4,2005
687,687,10/15/2005,Oklahoma,19,49,96,32,17,210,2,1,Kansas,3,22,11,30,11,86,3,1,N,4.5,16,27,85,2,6,124,-1,0,2005
688,688,10/15/2005,Oklahoma State,23,34,127,33,14,207,4,3,Texas A+M,62,55,399,30,21,295,1,1,V,-17.5,-39,-21,-272,3,-7,-88,3,2,2005
689,689,10/15/2005,Oregon,45,31,146,50,37,424,0,2,Washington,21,35,121,28,15,117,1,0,H,16,24,-4,25,22,22,307,-1,2,2005
690,690,10/15/2005,Oregon State,23,45,181,34,21,196,3,1,California,20,34,75,40,14,240,2,3,V,-16,3,11,106,-6,7,-44,1,-2,2005
691,691,10/15/2005,Penn State,25,38,181,34,19,239,1,1,Michigan,27,39,163,36,21,212,0,1,V,-3.5,-2,-1,18,-2,-2,27,1,0,2005
692,692,10/15/2005,Pittsburgh,31,42,127,21,15,203,0,2,South Florida,17,47,142,37,18,222,1,2,H,3,14,-5,-15,-16,-3,-19,-1,0,2005
693,693,10/15/2005,Purdue,29,36,127,65,40,378,2,2,Northwestern,34,27,128,57,38,475,0,1,H,7.5,-5,9,-1,8,2,-97,2,1,2005
694,694,10/15/2005,Rice,21,59,231,21,8,85,2,2,Tulsa,41,34,178,24,18,205,1,0,H,-7,-20,25,53,-3,-10,-120,1,2,2005
695,695,10/15/2005,Rutgers,31,39,103,28,13,203,3,0,Syracuse,9,37,65,28,14,173,0,5,V,-3,22,2,38,0,-1,30,3,-5,2005
696,696,10/15/2005,S-M-U,17,34,143,37,19,211,4,1,East Carolina,24,51,127,22,15,225,1,0,H,1,-7,-17,16,15,4,-14,3,1,2005
697,697,10/15/2005,San Diego State,28,34,166,23,17,219,0,0,Utah,19,43,175,48,31,417,1,1,V,-9.5,9,-9,-9,-25,-14,-198,-1,-1,2005
698,698,10/15/2005,San Jose State,21,31,54,34,17,217,0,3,Boise State,38,49,229,29,20,249,2,1,V,-32,-17,-18,-175,5,-3,-32,-2,2,2005
699,699,10/15/2005,South Florida,17,47,142,37,18,222,1,2,Pittsburgh,31,42,127,21,15,203,0,2,V,-3,-14,5,15,16,3,19,1,0,2005
700,700,10/15/2005,Southern Cal,34,31,175,33,17,301,2,0,Notre Dame,31,52,153,35,19,264,1,1,V,12,3,-21,22,-2,-2,37,1,-1,2005
701,701,10/15/2005,Southern Miss,52,31,73,39,24,278,1,0,U-C-F,31,35,96,41,24,260,1,4,H,10,21,-4,-23,-2,0,18,0,-4,2005
702,702,10/15/2005,Stanford,20,32,58,26,16,137,0,0,Arizona,16,40,110,39,21,161,2,3,V,-6,4,-8,-52,-13,-5,-24,-2,-3,2005
703,703,10/15/2005,Syracuse,9,37,65,28,14,173,0,5,Rutgers,31,39,103,28,13,203,3,0,H,3,-22,-2,-38,0,1,-30,-3,5,2005
704,704,10/15/2005,Temple,3,41,84,23,10,96,0,0,Miami-Florida,34,33,34,21,16,317,0,2,H,-41,-31,8,50,2,-6,-221,0,-2,2005
705,705,10/15/2005,Texas,42,47,145,32,26,337,0,1,Colorado,17,19,45,44,21,192,1,1,H,19,25,28,100,-12,5,145,-1,0,2005
706,706,10/15/2005,Texas A+M,62,55,399,30,21,295,1,1,Oklahoma State,23,34,127,33,14,207,4,3,H,17.5,39,21,272,-3,7,88,-3,-2,2005
707,707,10/15/2005,Texas Christian,38,48,184,30,22,219,1,0,Army,17,34,110,40,22,252,3,0,H,23,21,14,74,-10,0,-33,-2,0,2005
708,708,10/15/2005,Texas Tech,59,25,15,72,47,669,2,1,Kansas State,20,31,114,25,14,192,1,2,H,11.5,39,-6,-99,47,33,477,1,-1,2005
709,709,10/15/2005,Toledo,34,45,231,30,18,241,2,0,Ball State,14,40,114,19,11,76,2,1,V,19.5,20,5,117,11,7,165,0,-1,2005
710,710,10/15/2005,Troy,3,43,154,29,15,174,2,2,UL-Monroe,27,34,165,29,15,190,0,1,V,1.5,-24,9,-11,0,0,-16,2,1,2005
711,711,10/15/2005,Tulsa,41,34,178,24,18,205,1,0,Rice,21,59,231,21,8,85,2,2,V,7,20,-25,-53,3,10,120,-1,-2,2005
712,712,10/15/2005,U-A-B,19,37,187,35,20,245,1,0,Marshall,20,35,152,28,14,99,1,0,V,5.5,-1,2,35,7,6,146,0,0,2005
713,713,10/15/2005,U-C-F,31,35,96,41,24,260,1,4,Southern Miss,52,31,73,39,24,278,1,0,V,-10,-21,4,23,2,0,-18,0,4,2005
714,714,10/15/2005,U.C.L.A.,44,46,178,45,31,338,1,0,Washington State,41,42,330,33,19,169,0,1,V,6.5,3,4,-152,12,12,169,1,-1,2005
715,715,10/15/2005,UL-Monroe,27,34,165,29,15,190,0,1,Troy,3,43,154,29,15,174,2,2,H,-1.5,24,-9,11,0,0,16,-2,-1,2005
716,716,10/15/2005,Utah,19,43,175,48,31,417,1,1,San Diego State,28,34,166,23,17,219,0,0,H,9.5,-9,9,9,25,14,198,1,1,2005
717,717,10/15/2005,Utah State,21,36,44,24,14,158,1,3,Fresno State,53,45,193,23,13,174,2,0,V,-33,-32,-9,-149,1,1,-16,-1,3,2005
718,718,10/15/2005,Vanderbilt,17,39,150,28,15,174,1,0,Georgia,34,34,148,32,15,298,1,0,H,-16,-17,5,2,-4,0,-124,0,0,2005
719,719,10/15/2005,Virginia,26,28,10,39,27,306,0,0,Florida State,21,21,95,59,35,377,3,0,H,-7,5,7,-85,-20,-8,-71,-3,0,2005
720,720,10/15/2005,Wake Forest,30,51,134,33,21,193,0,0,Boston College,35,28,84,50,27,318,3,2,V,-15,-5,23,50,-17,-6,-125,-3,-2,2005
721,721,10/15/2005,Washington,21,35,121,28,15,117,1,0,Oregon,45,31,146,50,37,424,0,2,V,-16,-24,4,-25,-22,-22,-307,1,-2,2005
722,722,10/15/2005,Washington State,41,42,330,33,19,169,0,1,U.C.L.A.,44,46,178,45,31,338,1,0,H,-6.5,-3,-4,152,-12,-12,-169,-1,1,2005
723,723,10/15/2005,West Virginia,46,53,281,27,13,109,0,0,Louisville,44,44,182,49,31,277,1,0,H,-7,2,9,99,-22,-18,-168,-1,0,2005
724,724,10/15/2005,Wisconsin,38,36,131,26,15,235,0,1,Minnesota,34,63,411,17,7,99,1,1,V,-5.5,4,-27,-280,9,8,136,-1,0,2005
725,725,10/15/2005,Wyoming,24,19,93,35,19,214,2,0,New Mexico,27,66,237,22,13,118,0,2,H,7,-3,-47,-144,13,6,96,2,-2,2005
726,726,10/20/2005,Florida Intl,13,26,28,51,31,247,1,4,Troy,18,45,123,19,12,150,1,2,V,-9,-5,-19,-95,32,19,97,0,2,2005
727,727,10/20/2005,Maryland,9,33,96,30,14,158,2,0,Virginia Tech,28,48,286,23,14,211,3,1,H,-11,-19,-15,-190,7,0,-53,-1,-1,2005
728,728,10/20/2005,Troy,18,45,123,19,12,150,1,2,Florida Intl,13,26,28,51,31,247,1,4,H,9,5,19,95,-32,-19,-97,0,-2,2005
729,729,10/20/2005,Virginia Tech,28,48,286,23,14,211,3,1,Maryland,9,33,96,30,14,158,2,0,V,11,19,15,190,-7,0,53,1,1,2005
730,730,10/21/2005,Southern Miss,37,36,177,33,18,247,0,0,U-A-B,28,28,80,42,29,407,1,0,V,-1,9,8,97,-9,-11,-160,-1,0,2005
731,731,10/21/2005,Tulane,24,18,80,47,27,360,4,1,U-C-F,34,48,286,31,18,202,0,0,V,-4.5,-10,-30,-206,16,9,158,4,1,2005
732,732,10/21/2005,U-A-B,28,28,80,42,29,407,1,0,Southern Miss,37,36,177,33,18,247,0,0,H,1,-9,-8,-97,9,11,160,1,0,2005
733,733,10/21/2005,U-C-F,34,48,286,31,18,202,0,0,Tulane,24,18,80,47,27,360,4,1,H,4.5,10,30,206,-16,-9,-158,-4,-1,2005
734,734,10/22/2005,Air Force,10,55,239,22,11,148,2,0,Texas Christian,48,42,220,32,22,326,0,0,H,-1,-38,13,19,-10,-11,-178,2,0,2005
735,735,10/22/2005,Akron,0,22,44,45,21,188,1,0,Army,20,51,186,19,8,110,0,0,H,10,-20,-29,-142,26,13,78,1,0,2005
736,736,10/22/2005,Alabama,6,35,67,27,17,190,0,1,Tennessee,3,35,109,19,11,144,1,3,H,3.5,3,0,-42,8,6,46,-1,-2,2005
737,737,10/22/2005,Arizona,21,37,212,41,22,199,2,2,Oregon,28,32,67,28,15,240,2,1,H,-8.5,-7,5,145,13,7,-41,0,1,2005
738,738,10/22/2005,Arizona State,35,42,126,41,29,402,1,0,Stanford,45,33,66,27,19,303,0,0,V,10,-10,9,60,14,10,99,1,0,2005
739,739,10/22/2005,Arkansas,20,49,216,20,11,116,1,1,Georgia,23,30,52,19,11,165,1,1,V,-18.5,-3,19,164,1,0,-49,0,0,2005
740,740,10/22/2005,Arkansas State,3,46,185,28,14,208,3,1,Florida Atlantic,0,37,91,25,11,77,2,0,H,9,3,9,94,3,3,131,1,1,2005
741,741,10/22/2005,Army,20,51,186,19,8,110,0,0,Akron,0,22,44,45,21,188,1,0,V,-10,20,29,142,-26,-13,-78,-1,0,2005
742,742,10/22/2005,Auburn,17,38,230,41,16,221,0,0,Louisiana State,20,34,149,33,16,190,0,0,V,-6.5,-3,4,81,8,0,31,0,0,2005
743,743,10/22/2005,Ball State,21,28,97,39,26,254,0,2,Ohio,38,52,415,23,6,50,0,0,V,-8.5,-17,-24,-318,16,20,204,0,2,2005
744,744,10/22/2005,Baylor,30,21,63,44,20,228,0,3,Oklahoma,38,53,205,42,24,269,2,2,V,-15,-8,-32,-142,2,-4,-41,-2,1,2005
745,745,10/22/2005,Boise State,45,34,84,40,27,351,0,0,Utah State,21,39,84,31,17,211,0,1,V,19.5,24,-5,0,9,10,140,0,-1,2005
746,746,10/22/2005,Bowling Green,14,41,107,47,26,339,2,1,Western Michigan,45,48,212,28,18,270,0,1,H,26.5,-31,-7,-105,19,8,69,2,0,2005
747,747,10/22/2005,Brigham Young,23,34,75,45,26,317,2,0,Notre Dame,49,23,44,41,32,467,0,2,V,-19.5,-26,11,31,4,-6,-150,2,-2,2005
748,748,10/22/2005,Buffalo,15,43,118,33,18,241,1,2,Toledo,38,40,292,21,16,186,2,0,V,-31,-23,3,-174,12,2,55,-1,2,2005
749,749,10/22/2005,California,42,48,274,35,19,274,2,1,Washington State,38,38,178,39,18,423,2,0,H,12.5,4,10,96,-4,1,-149,0,1,2005
750,750,10/22/2005,Cincinnati,22,50,149,41,20,235,1,2,Louisville,46,32,244,27,21,303,0,3,H,-23,-24,18,-95,14,-1,-68,1,-1,2005
751,751,10/22/2005,Clemson,37,34,155,33,22,359,1,0,Temple,7,33,12,44,26,319,1,2,H,35.5,30,1,143,-11,-4,40,0,-2,2005
752,752,10/22/2005,Colorado,44,29,104,30,18,200,0,0,Kansas,13,34,61,55,27,293,3,1,H,14.5,31,-5,43,-25,-9,-93,-3,-1,2005
753,753,10/22/2005,Colorado State,39,42,102,37,20,419,1,0,Wyoming,31,30,155,39,25,312,2,3,H,3,8,12,-53,-2,-5,107,-1,-3,2005
754,754,10/22/2005,Connecticut,24,33,97,35,18,196,1,0,Rutgers,26,42,238,33,15,270,2,0,H,1.5,-2,-9,-141,2,3,-74,-1,0,2005
755,755,10/22/2005,Duke,24,36,191,19,9,52,1,1,Florida State,55,33,163,49,34,376,1,0,H,-30,-31,3,28,-30,-25,-324,0,1,2005
756,756,10/22/2005,East Carolina,24,16,46,46,26,297,0,0,Memphis,27,63,340,14,10,117,0,0,V,-7.5,-3,-47,-294,32,16,180,0,0,2005
757,757,10/22/2005,Eastern Michigan,23,41,259,26,18,128,0,0,Miami-Ohio,24,39,170,43,23,258,2,0,H,-11,-1,2,89,-17,-5,-130,-2,0,2005
758,758,10/22/2005,Florida Atlantic,0,37,91,25,11,-23,2,0,Arkansas State,3,45,187,28,14,208,3,1,V,-9,-3,-8,-96,-3,-3,-231,-1,-1,2005
759,759,10/22/2005,Florida State,55,33,163,49,34,376,1,0,Duke,24,36,191,19,9,52,1,1,V,30,31,-3,-28,30,25,324,0,-1,2005
760,760,10/22/2005,Fresno State,40,35,156,34,21,228,0,2,Idaho,10,35,89,30,18,121,1,1,V,28,30,0,67,4,3,107,-1,1,2005
761,761,10/22/2005,Georgia,23,30,52,19,11,165,1,1,Arkansas,20,49,216,20,11,116,1,1,H,18.5,3,-19,-164,-1,0,49,0,0,2005
762,762,10/22/2005,Hawaii,45,28,62,48,36,457,2,0,San Jose State,38,35,170,35,22,262,2,2,V,7,7,-7,-108,13,14,195,0,-2,2005
763,763,10/22/2005,Houston,28,37,152,29,20,218,0,1,Mississippi State,16,38,244,31,14,84,0,0,V,-1,12,-1,-92,-2,6,134,0,1,2005
764,764,10/22/2005,Idaho,10,35,89,30,18,121,1,1,Fresno State,40,35,156,34,21,228,0,2,H,-28,-30,0,-67,-4,-3,-107,1,-1,2005
765,765,10/22/2005,Illinois,10,37,111,31,18,133,2,1,Penn State,63,46,221,20,12,217,0,0,H,-17,-53,-9,-110,11,6,-84,2,1,2005
766,766,10/22/2005,Indiana,10,26,42,33,15,95,1,1,Ohio State,41,48,240,24,15,238,1,1,H,-15.5,-31,-22,-198,9,0,-143,0,0,2005
767,767,10/22/2005,Iowa,20,38,139,39,27,288,1,0,Michigan,23,41,122,22,15,220,1,1,H,2.5,-3,-3,17,17,12,68,0,-1,2005
768,768,10/22/2005,Iowa State,37,44,147,20,13,227,0,1,Oklahoma State,10,34,123,40,24,203,4,1,H,15.5,27,10,24,-20,-11,24,-4,0,2005
769,769,10/22/2005,Kansas,13,34,61,55,27,293,3,1,Colorado,44,29,104,30,18,200,0,0,V,-14.5,-31,5,-43,25,9,93,3,1,2005
770,770,10/22/2005,Kansas State,28,20,27,44,23,357,2,1,Texas A+M,30,56,236,31,15,136,1,0,H,-3,-2,-36,-209,13,8,221,1,1,2005
771,771,10/22/2005,Kent State,3,33,93,31,15,102,2,1,Northern Illinois,34,48,252,20,12,156,0,1,H,-11,-31,-15,-159,11,3,-54,2,0,2005
772,772,10/22/2005,Kentucky,7,38,149,22,12,107,0,3,Mississippi,13,39,163,38,19,198,0,0,V,-10,-6,-1,-14,-16,-7,-91,0,3,2005
773,773,10/22/2005,Louisiana State,20,34,149,33,16,190,0,0,Auburn,17,38,230,41,16,221,0,0,H,6.5,3,-4,-81,-8,0,-31,0,0,2005
774,774,10/22/2005,Louisiana Tech,40,41,227,35,24,283,0,0,North Texas,14,36,188,23,10,99,2,1,H,16.5,26,5,39,12,14,184,-2,-1,2005
775,775,10/22/2005,Louisville,46,32,244,27,21,303,0,3,Cincinnati,22,50,149,41,20,235,1,2,V,23,24,-18,95,-14,1,68,-1,1,2005
776,776,10/22/2005,Marshall,3,42,179,30,13,125,1,0,UTEP,31,38,194,26,17,215,1,2,V,-12.5,-28,4,-15,4,-4,-90,0,-2,2005
777,777,10/22/2005,Memphis,27,63,340,14,10,117,0,0,East Carolina,24,16,46,46,26,297,0,0,H,7.5,3,47,294,-32,-16,-180,0,0,2005
778,778,10/22/2005,Miami-Ohio,24,40,185,43,23,252,2,0,Eastern Michigan,23,41,251,27,19,135,0,0,V,11,1,-1,-66,16,4,117,2,0,2005
779,779,10/22/2005,Michigan,23,41,122,22,15,220,1,1,Iowa,20,38,139,39,27,288,1,0,V,-2.5,3,3,-17,-17,-12,-68,0,1,2005
780,780,10/22/2005,Michigan State,14,43,189,46,24,291,3,1,Northwestern,49,37,202,30,24,331,0,1,H,11.5,-35,6,-13,16,0,-40,3,0,2005
781,781,10/22/2005,Middle Tennessee,10,37,45,25,19,218,0,1,UL-Lafayette,13,44,170,25,14,138,0,1,H,14,-3,-7,-125,0,5,80,0,0,2005
782,782,10/22/2005,Mississippi,13,39,163,38,19,198,0,0,Kentucky,7,38,149,22,12,107,0,3,H,10,6,1,14,16,7,91,0,-3,2005
783,783,10/22/2005,Mississippi State,16,38,244,31,14,84,0,0,Houston,28,37,152,29,20,218,0,1,H,1,-12,1,92,2,-6,-134,0,-1,2005
784,784,10/22/2005,Missouri,41,49,277,38,22,246,1,1,Nebraska,24,19,-2,43,22,281,2,1,H,3,17,30,279,-5,0,-35,-1,0,2005
785,785,10/22/2005,Navy,41,44,301,11,3,66,0,0,Rice,9,61,190,24,11,94,0,2,V,9.5,32,-17,111,-13,-8,-28,0,-2,2005
786,786,10/22/2005,Nebraska,24,19,-2,43,22,281,2,1,Missouri,41,49,277,38,22,246,1,1,V,-3,-17,-30,-279,5,0,35,1,0,2005
787,787,10/22/2005,Nevada-Las Vegas,32,40,132,55,29,356,2,0,Utah,42,36,242,29,20,264,0,1,H,-13,-10,4,-110,26,9,92,2,-1,2005
788,788,10/22/2005,New Mexico,47,63,286,32,21,248,1,1,San Diego State,24,25,94,35,15,197,3,0,V,1,23,38,192,-3,6,51,-2,1,2005
789,789,10/22/2005,No Carolina State,19,25,65,45,21,238,3,0,Wake Forest,27,49,85,17,13,140,0,1,V,1.5,-8,-24,-20,28,8,98,3,-1,2005
790,790,10/22/2005,North Carolina,7,46,172,24,13,98,1,0,Virginia,5,37,90,28,14,109,1,0,H,0,2,9,82,-4,-1,-11,0,0,2005
791,791,10/22/2005,North Texas,14,36,188,23,10,99,2,1,Louisiana Tech,40,41,227,35,24,283,0,0,V,-16.5,-26,-5,-39,-12,-14,-184,2,1,2005
792,792,10/22/2005,Northern Illinois,34,47,237,20,12,162,0,1,Kent State,3,33,101,30,14,95,2,1,V,11,31,14,136,-10,-2,67,-2,0,2005
793,793,10/22/2005,Northwestern,49,37,202,30,24,331,0,1,Michigan State,14,43,189,46,24,291,3,1,V,-11.5,35,-6,13,-16,0,40,-3,0,2005
794,794,10/22/2005,Notre Dame,49,23,44,41,32,467,0,2,Brigham Young,23,34,75,45,26,317,2,0,H,19.5,26,-11,-31,-4,6,150,-2,2,2005
795,795,10/22/2005,Ohio,38,52,414,23,6,51,0,0,Ball State,21,28,98,37,24,242,0,2,H,8.5,17,24,316,-14,-18,-191,0,-2,2005
796,796,10/22/2005,Ohio State,41,48,240,24,15,238,1,1,Indiana,10,26,42,33,15,95,1,1,V,15.5,31,22,198,-9,0,143,0,0,2005
797,797,10/22/2005,Oklahoma,38,53,205,42,24,269,2,2,Baylor,30,21,63,44,20,228,0,3,H,15,8,32,142,-2,4,41,2,-1,2005
798,798,10/22/2005,Oklahoma State,10,34,123,40,24,203,4,1,Iowa State,37,44,147,20,13,227,0,1,V,-15.5,-27,-10,-24,20,11,-24,4,0,2005
799,799,10/22/2005,Oregon,28,32,67,28,15,240,2,1,Arizona,21,37,212,41,22,199,2,2,V,8.5,7,-5,-145,-13,-7,41,0,-1,2005
800,800,10/22/2005,Oregon State,28,39,181,34,21,330,2,1,U.C.L.A.,51,45,235,25,16,262,0,0,V,-11,-23,-6,-54,9,5,68,2,1,2005
801,801,10/22/2005,Penn State,63,46,221,20,12,217,0,0,Illinois,10,37,111,31,18,133,2,1,V,17,53,9,110,-11,-6,84,-2,-1,2005
802,802,10/22/2005,Pittsburgh,34,50,177,28,18,201,1,2,Syracuse,17,34,113,26,9,89,4,1,H,13,17,16,64,2,9,112,-3,1,2005
803,803,10/22/2005,Purdue,20,40,216,44,23,212,3,2,Wisconsin,31,36,63,27,15,217,1,1,V,-7,-11,4,153,17,8,-5,2,1,2005
804,804,10/22/2005,Rice,9,61,190,24,11,94,0,2,Navy,41,44,301,11,3,66,0,0,H,-9.5,-32,17,-111,13,8,28,0,2,2005
805,805,10/22/2005,Rutgers,26,42,238,33,15,270,2,0,Connecticut,24,33,97,35,18,196,1,0,V,-1.5,2,9,141,-2,-3,74,1,0,2005
806,806,10/22/2005,S-M-U,13,36,114,32,20,223,1,2,Tulsa,20,31,103,33,20,220,0,0,V,-14.5,-7,5,11,-1,0,3,1,2,2005
807,807,10/22/2005,San Diego State,24,25,94,35,15,197,3,0,New Mexico,47,63,286,32,21,248,1,1,H,-1,-23,-38,-192,3,-6,-51,2,-1,2005
808,808,10/22/2005,San Jose State,38,35,170,35,22,262,2,2,Hawaii,45,28,62,48,36,457,2,0,H,-7,-7,7,108,-13,-14,-195,0,2,2005
809,809,10/22/2005,South Carolina,35,30,132,31,18,267,1,0,Vanderbilt,28,34,41,49,27,339,1,0,H,7.5,7,-4,91,-18,-9,-72,0,0,2005
810,810,10/22/2005,Southern Cal,51,32,118,32,25,272,1,0,Washington,24,35,59,29,21,270,0,2,V,31,27,-3,59,3,4,2,1,-2,2005
811,811,10/22/2005,Stanford,45,33,66,27,19,303,0,0,Arizona State,35,42,126,41,29,402,1,0,H,-10,10,-9,-60,-14,-10,-99,-1,0,2005
812,812,10/22/2005,Syracuse,17,34,113,26,9,89,4,1,Pittsburgh,34,50,177,28,18,201,1,2,V,-13,-17,-16,-64,-2,-9,-112,3,-1,2005
813,813,10/22/2005,Temple,7,33,12,44,26,319,1,2,Clemson,37,34,155,33,22,359,1,0,V,-35.5,-30,-1,-143,11,4,-40,0,2,2005
814,814,10/22/2005,Tennessee,3,35,109,19,11,144,1,3,Alabama,6,35,67,27,17,190,0,1,V,-3.5,-3,0,42,-8,-6,-46,1,2,2005
815,815,10/22/2005,Texas,52,40,205,22,12,239,2,0,Texas Tech,17,29,99,64,42,369,1,1,H,15.5,35,11,106,-42,-30,-130,1,-1,2005
816,816,10/22/2005,Texas A+M,30,56,236,31,15,136,1,0,Kansas State,28,20,27,44,23,357,2,1,V,3,2,36,209,-13,-8,-221,-1,-1,2005
817,817,10/22/2005,Texas Christian,48,42,220,32,22,326,0,0,Air Force,10,55,239,22,11,148,2,0,V,1,38,-13,-19,10,11,178,-2,0,2005
818,818,10/22/2005,Texas Tech,17,29,99,64,42,369,1,1,Texas,52,40,205,22,12,239,2,0,V,-15.5,-35,-11,-106,42,30,130,-1,1,2005
819,819,10/22/2005,Toledo,38,40,292,21,16,186,2,0,Buffalo,15,43,118,33,18,241,1,2,H,31,23,-3,174,-12,-2,-55,1,-2,2005
820,820,10/22/2005,Tulsa,20,31,103,33,20,220,0,0,S-M-U,13,36,114,32,20,223,1,2,H,14.5,7,-5,-11,1,0,-3,-1,-2,2005
821,821,10/22/2005,U.C.L.A.,51,45,235,25,16,262,0,0,Oregon State,28,39,181,34,21,330,2,1,H,11,23,6,54,-9,-5,-68,-2,-1,2005
822,822,10/22/2005,UL-Lafayette,13,44,170,25,14,138,0,1,Middle Tennessee,10,37,45,25,19,218,0,1,V,-14,3,7,125,0,-5,-80,0,0,2005
823,823,10/22/2005,UTEP,31,38,194,26,17,215,1,2,Marshall,3,41,215,30,13,125,1,0,H,12.5,28,-3,-21,-4,4,90,0,2,2005
824,824,10/22/2005,Utah,42,36,242,29,20,264,0,1,Nevada-Las Vegas,32,40,132,55,29,356,2,0,V,13,10,-4,110,-26,-9,-92,-2,1,2005
825,825,10/22/2005,Utah State,21,39,84,31,17,211,0,1,Boise State,45,34,84,40,27,351,0,0,H,-19.5,-24,5,0,-9,-10,-140,0,1,2005
826,826,10/22/2005,Vanderbilt,28,34,41,49,27,339,1,0,South Carolina,35,30,132,31,18,267,1,0,V,-7.5,-7,4,-91,18,9,72,0,0,2005
827,827,10/22/2005,Virginia,5,37,90,28,14,109,1,0,North Carolina,7,46,172,24,13,98,1,0,V,0,-2,-9,-82,4,1,11,0,0,2005
828,828,10/22/2005,Wake Forest,27,49,85,17,13,140,0,1,No Carolina State,19,25,65,45,21,238,3,0,H,-1.5,8,24,20,-28,-8,-98,-3,1,2005
829,829,10/22/2005,Washington,24,35,59,29,21,270,0,2,Southern Cal,51,32,118,32,25,272,1,0,H,-31,-27,3,-59,-3,-4,-2,-1,2,2005
830,830,10/22/2005,Washington State,38,38,178,39,18,423,2,0,California,42,48,274,35,19,274,2,1,V,-12.5,-4,-10,-96,4,-1,149,0,-1,2005
831,831,10/22/2005,Western Michigan,45,48,213,26,16,258,0,1,Bowling Green,14,41,106,47,26,340,2,1,V,-26.5,31,7,107,-21,-10,-82,-2,0,2005
832,832,10/22/2005,Wisconsin,31,36,63,27,15,217,1,1,Purdue,20,40,216,44,23,212,3,2,H,7,11,-4,-153,-17,-8,5,-2,-1,2005
833,833,10/22/2005,Wyoming,31,30,155,39,25,312,2,3,Colorado State,39,42,102,37,20,419,1,0,V,-3,-8,-12,53,2,5,-107,1,3,2005
834,834,10/27/2005,Boston College,10,21,27,30,15,156,2,0,Virginia Tech,30,53,212,28,22,280,0,1,V,-14,-20,-32,-185,2,-7,-124,2,-1,2005
835,835,10/27/2005,Virginia Tech,30,53,212,28,22,280,0,1,Boston College,10,21,27,30,15,156,2,0,H,14,20,32,185,-2,7,124,-2,1,2005
836,836,10/28/2005,Colorado State,35,41,31,26,20,312,0,0,New Mexico,25,39,191,23,14,160,2,2,V,-4.5,10,2,-160,3,6,152,-2,-2,2005
837,837,10/28/2005,New Mexico,25,39,191,23,14,160,2,2,Colorado State,35,41,31,26,20,312,0,0,H,4.5,-10,-2,160,-3,-6,-152,2,2,2005
838,838,10/29/2005,Air Force,41,38,200,31,17,279,3,2,Brigham Young,62,42,300,43,31,383,1,1,V,-5.5,-21,-4,-100,-12,-14,-104,2,1,2005
839,839,10/29/2005,Akron,24,42,153,29,15,205,0,0,Bowling Green,14,38,193,31,22,173,1,1,V,-16.5,10,4,-40,-2,-7,32,-1,-1,2005
840,840,10/29/2005,Alabama,35,32,205,36,23,288,0,1,Utah State,3,41,150,30,13,159,1,0,H,34.5,32,-9,55,6,10,129,-1,1,2005
841,841,10/29/2005,Arizona,29,30,49,22,13,335,0,1,Oregon State,27,44,218,43,32,436,6,1,V,-7.5,2,-14,-169,-21,-19,-101,-6,0,2005
842,842,10/29/2005,Arizona State,44,43,77,34,27,401,0,0,Washington,20,40,213,26,10,185,2,2,H,16,24,3,-136,8,17,216,-2,-2,2005
843,843,10/29/2005,Auburn,27,46,123,29,19,239,0,2,Mississippi,3,27,23,35,21,186,1,0,H,20,24,19,100,-6,-2,53,-1,2,2005
844,844,10/29/2005,Ball State,31,52,196,34,23,186,1,1,Northern Illinois,17,28,66,31,21,163,1,2,V,-26,14,24,130,3,2,23,0,-1,2005
845,845,10/29/2005,Baylor,0,40,121,38,21,204,3,1,Texas Tech,28,22,111,44,22,264,2,0,H,-10,-28,18,10,-6,-1,-60,1,1,2005
846,846,10/29/2005,Boise State,49,42,264,24,15,196,2,2,Nevada-Reno,14,46,117,42,23,321,5,1,H,20,35,-4,147,-18,-8,-125,-3,1,2005
847,847,10/29/2005,Bowling Green,14,38,193,31,22,173,1,1,Akron,24,42,153,29,15,205,0,0,H,16.5,-10,-4,40,2,7,-32,1,1,2005
848,848,10/29/2005,Brigham Young,62,42,300,43,31,383,1,1,Air Force,41,38,200,31,17,279,3,2,H,5.5,21,4,100,12,14,104,-2,-1,2005
849,849,10/29/2005,Buffalo,20,32,139,36,24,293,1,2,Ohio,34,45,307,19,12,167,0,0,H,-3.5,-14,-13,-168,17,12,126,1,2,2005
850,850,10/29/2005,Central Michigan,21,44,160,37,20,189,1,0,Toledo,17,30,95,45,28,262,0,0,H,-10,4,14,65,-8,-8,-73,1,0,2005
851,851,10/29/2005,Cincinnati,22,47,182,25,16,150,0,0,Syracuse,16,40,52,26,14,285,0,1,V,-5.5,6,7,130,-1,2,-135,0,-1,2005
852,852,10/29/2005,Clemson,9,35,145,30,19,180,1,3,Georgia Tech,10,39,182,24,14,126,1,1,V,-3,-1,-4,-37,6,5,54,0,2,2005
853,853,10/29/2005,Colorado,23,37,91,34,17,272,0,1,Kansas State,20,37,81,40,19,211,0,3,V,7.5,3,0,10,-6,-2,61,0,-2,2005
854,854,10/29/2005,Duke,6,31,50,29,17,153,2,0,Wake Forest,44,51,419,23,11,138,1,0,H,-14.5,-38,-20,-369,6,6,15,1,0,2005
855,855,10/29/2005,East Carolina,20,41,272,46,24,270,3,3,U-C-F,30,48,249,25,10,181,0,0,H,2.5,-10,-7,23,21,14,89,3,3,2005
856,856,10/29/2005,Florida,14,37,153,20,15,108,0,1,Georgia,10,42,177,22,9,109,1,0,N,5.5,4,-5,-24,-2,6,-1,-1,1,2005
857,857,10/29/2005,Florida State,35,33,136,37,27,264,2,0,Maryland,27,33,126,30,16,206,1,1,H,17.5,8,0,10,7,11,58,1,-1,2005
858,858,10/29/2005,Fresno State,27,28,232,25,15,213,2,1,Hawaii,13,23,129,56,35,327,2,0,V,12.5,14,5,103,-31,-20,-114,0,1,2005
859,859,10/29/2005,Georgia,10,42,177,22,9,109,1,0,Florida,14,37,153,20,15,108,0,1,N,-5.5,-4,5,24,2,-6,1,1,-1,2005
860,860,10/29/2005,Georgia Tech,10,39,182,24,14,126,1,1,Clemson,9,35,145,30,19,180,1,3,H,3,1,4,37,-6,-5,-54,0,-2,2005
861,861,10/29/2005,Hawaii,13,23,129,56,35,327,2,0,Fresno State,27,28,232,25,15,213,2,1,H,-12.5,-14,-5,-103,31,20,114,0,-1,2005
862,862,10/29/2005,Idaho,38,33,93,54,35,489,2,1,New Mexico State,37,39,154,51,28,341,1,2,V,-4,1,-6,-61,3,7,148,1,-1,2005
863,863,10/29/2005,Illinois,24,38,261,40,20,277,1,0,Wisconsin,41,50,239,23,14,225,0,0,H,-19,-17,-12,22,17,6,52,1,0,2005
864,864,10/29/2005,Indiana,15,31,137,44,25,232,3,1,Michigan State,46,46,237,33,18,256,1,1,V,-18,-31,-15,-100,11,7,-24,2,0,2005
865,865,10/29/2005,Iowa State,42,50,178,32,20,371,0,0,Texas A+M,14,20,126,41,23,221,2,1,V,-9.5,28,30,52,-9,-3,150,-2,-1,2005
866,866,10/29/2005,Kansas,13,49,208,19,12,90,2,1,Missouri,3,30,33,39,15,147,1,1,H,-6,10,19,175,-20,-3,-57,1,0,2005
867,867,10/29/2005,Kansas State,20,37,81,40,19,211,0,3,Colorado,23,37,91,34,17,272,0,1,H,-7.5,-3,0,-10,6,2,-61,0,2,2005
868,868,10/29/2005,Kent State,14,28,1,50,27,373,2,1,Western Michigan,44,39,158,31,20,249,2,0,V,-5.5,-30,-11,-157,19,7,124,0,1,2005
869,869,10/29/2005,Kentucky,13,47,183,27,13,141,0,1,Mississippi State,7,37,173,37,17,202,0,1,H,-1,6,10,10,-10,-4,-61,0,0,2005
870,870,10/29/2005,Louisiana State,56,36,183,28,24,383,1,0,North Texas,3,30,105,29,13,101,1,0,H,44,53,6,78,-1,11,282,0,0,2005
871,871,10/29/2005,Louisiana Tech,31,47,197,33,18,329,1,2,San Jose State,14,38,160,29,11,161,1,1,H,18.5,17,9,37,4,7,168,0,1,2005
872,872,10/29/2005,Marshall,27,38,134,32,17,152,3,0,Tulane,26,33,40,22,9,146,1,0,V,1,1,5,94,10,8,6,2,0,2005
873,873,10/29/2005,Maryland,27,33,126,30,16,206,1,1,Florida State,35,33,136,37,27,264,2,0,V,-17.5,-8,0,-10,-7,-11,-58,-1,1,2005
874,874,10/29/2005,Miami-Florida,34,38,210,19,11,111,3,1,North Carolina,16,44,102,25,13,86,1,2,H,20,18,-6,108,-6,-2,25,2,-1,2005
875,875,10/29/2005,Miami-Ohio,41,37,139,41,29,379,0,2,Temple,14,31,75,24,10,120,2,1,V,24,27,6,64,17,19,259,-2,1,2005
876,876,10/29/2005,Michigan,33,58,253,30,17,174,3,1,Northwestern,17,17,89,49,26,326,2,1,V,3.5,16,41,164,-19,-9,-152,1,0,2005
877,877,10/29/2005,Michigan State,46,46,237,33,18,256,1,1,Indiana,15,31,137,44,25,232,3,1,H,18,31,15,100,-11,-7,24,-2,0,2005
878,878,10/29/2005,Minnesota,31,42,182,36,26,396,0,1,Ohio State,45,43,216,20,14,233,0,0,H,-5.5,-14,-1,-34,16,12,163,0,1,2005
879,879,10/29/2005,Mississippi,3,27,23,35,21,186,1,0,Auburn,27,46,123,29,19,239,0,2,V,-20,-24,-19,-100,6,2,-53,1,-2,2005
880,880,10/29/2005,Mississippi State,7,37,173,37,17,202,0,1,Kentucky,13,47,183,27,13,141,0,1,V,1,-6,-10,-10,10,4,61,0,0,2005
881,881,10/29/2005,Missouri,3,30,33,39,15,147,1,1,Kansas,13,49,208,19,12,90,2,1,V,6,-10,-19,-175,20,3,57,-1,0,2005
882,882,10/29/2005,Navy,21,49,207,20,9,124,2,1,Rutgers,31,50,114,21,18,221,0,0,V,-5.5,-10,-1,93,-1,-9,-97,2,1,2005
883,883,10/29/2005,Nebraska,24,34,16,46,26,267,2,0,Oklahoma,31,45,180,28,14,157,0,0,H,1,-7,-11,-164,18,12,110,2,0,2005
884,884,10/29/2005,Nevada-Reno,14,46,117,42,23,321,5,1,Boise State,49,42,264,24,15,196,2,2,V,-20,-35,4,-147,18,8,125,3,-1,2005
885,885,10/29/2005,New Mexico State,37,39,154,51,28,341,1,2,Idaho,38,33,93,54,35,489,2,1,H,4,-1,6,61,-3,-7,-148,-1,1,2005
886,886,10/29/2005,No Carolina State,21,54,297,26,10,128,2,2,Southern Miss,17,31,69,35,15,177,0,1,H,5,4,23,228,-9,-5,-49,2,1,2005
887,887,10/29/2005,North Carolina,16,44,102,25,13,86,1,2,Miami-Florida,34,38,210,19,11,111,3,1,V,-20,-18,6,-108,6,2,-25,-2,1,2005
888,888,10/29/2005,North Texas,3,30,105,29,13,101,1,0,Louisiana State,56,36,183,28,24,383,1,0,V,-44,-53,-6,-78,1,-11,-282,0,0,2005
889,889,10/29/2005,Northern Illinois,17,28,66,31,21,163,1,2,Ball State,31,52,196,34,23,186,1,1,H,26,-14,-24,-130,-3,-2,-23,0,1,2005
890,890,10/29/2005,Northwestern,17,17,89,49,26,326,2,1,Michigan,33,58,253,30,17,174,3,1,H,-3.5,-16,-41,-164,19,9,152,-1,0,2005
891,891,10/29/2005,Ohio,34,45,307,19,12,167,0,0,Buffalo,20,32,139,36,24,293,1,1,V,3.5,14,13,168,-17,-12,-126,-1,-1,2005
892,892,10/29/2005,Ohio State,45,43,216,20,14,233,0,0,Minnesota,31,42,182,36,26,396,0,1,V,5.5,14,1,34,-16,-12,-163,0,-1,2005
893,893,10/29/2005,Oklahoma,31,45,180,28,14,157,0,0,Nebraska,24,34,16,46,26,267,2,0,V,-1,7,11,164,-18,-12,-110,-2,0,2005
894,894,10/29/2005,Oklahoma State,28,46,250,27,12,152,0,1,Texas,47,49,367,31,15,239,1,1,H,-35.5,-19,-3,-117,-4,-3,-87,-1,0,2005
895,895,10/29/2005,Oregon State,27,44,218,43,32,436,6,1,Arizona,29,30,49,22,13,335,0,1,H,7.5,-2,14,169,21,19,101,6,0,2005
896,896,10/29/2005,Penn State,33,55,303,29,13,213,0,2,Purdue,15,26,115,38,17,162,1,1,H,15,18,29,188,-9,-4,51,-1,1,2005
897,897,10/29/2005,Purdue,15,26,115,38,17,162,1,1,Penn State,33,55,303,29,13,213,0,2,V,-15,-18,-29,-188,9,4,-51,1,-1,2005
898,898,10/29/2005,Rice,31,65,272,19,9,108,0,1,UTEP,38,30,145,30,24,387,2,1,H,-19,-7,35,127,-11,-15,-279,-2,0,2005
899,899,10/29/2005,Rutgers,31,50,114,21,18,221,0,0,Navy,21,49,207,20,9,124,2,1,H,5.5,10,1,-93,1,9,97,-2,-1,2005
900,900,10/29/2005,San Diego State,20,33,125,46,25,235,2,0,Texas Christian,23,58,291,23,13,112,2,1,H,-6.5,-3,-25,-166,23,12,123,0,-1,2005
901,901,10/29/2005,San Jose State,14,38,160,29,11,161,1,1,Louisiana Tech,31,47,197,33,18,329,1,2,V,-18.5,-17,-9,-37,-4,-7,-168,0,-1,2005
902,902,10/29/2005,South Carolina,16,28,65,37,22,242,1,2,Tennessee,15,35,172,32,14,99,1,1,V,-14,1,-7,-107,5,8,143,0,1,2005
903,903,10/29/2005,Southern Cal,55,50,312,43,29,433,1,1,Washington State,13,33,195,25,13,89,0,2,H,30,42,17,117,18,16,344,1,-1,2005
904,904,10/29/2005,Southern Miss,17,31,69,35,15,177,0,1,No Carolina State,21,54,297,26,10,128,2,2,V,-5,-4,-23,-228,9,5,49,-2,-1,2005
905,905,10/29/2005,Stanford,27,46,140,25,18,169,0,0,U.C.L.A.,30,28,79,35,24,293,0,2,H,-8,-3,18,61,-10,-6,-124,0,-2,2005
906,906,10/29/2005,Syracuse,16,40,52,26,14,285,0,1,Cincinnati,22,47,182,25,16,150,0,0,H,5.5,-6,-7,-130,1,-2,135,0,1,2005
907,907,10/29/2005,Temple,14,31,75,24,10,120,2,1,Miami-Ohio,41,37,127,41,29,379,0,2,H,-24,-27,-6,-52,-17,-19,-259,2,-1,2005
908,908,10/29/2005,Tennessee,15,35,172,32,14,99,1,1,South Carolina,16,28,65,37,22,242,1,2,H,14,-1,7,107,-5,-8,-143,0,-1,2005
909,909,10/29/2005,Texas,47,49,367,31,15,239,1,1,Oklahoma State,28,46,250,27,12,152,0,1,V,35.5,19,3,117,4,3,87,1,0,2005
910,910,10/29/2005,Texas A+M,14,20,126,41,23,221,2,1,Iowa State,42,50,178,32,20,371,0,0,H,9.5,-28,-30,-52,9,3,-150,2,1,2005
911,911,10/29/2005,Texas Christian,23,58,291,23,13,112,2,1,San Diego State,20,33,125,46,25,235,2,0,V,6.5,3,25,166,-23,-12,-123,0,1,2005
912,912,10/29/2005,Texas Tech,28,22,111,44,22,264,2,0,Baylor,0,40,121,38,21,204,3,1,V,10,28,-18,-10,6,1,60,-1,-1,2005
913,913,10/29/2005,Toledo,17,30,95,45,28,262,0,0,Central Michigan,21,44,160,37,20,189,1,1,V,10,-4,-14,-65,8,8,73,-1,-1,2005
914,914,10/29/2005,Troy,28,46,183,27,11,137,1,0,UL-Lafayette,31,52,265,20,9,134,0,2,V,-3.5,-3,-6,-82,7,2,3,1,-2,2005
915,915,10/29/2005,Tulane,26,33,40,22,9,146,1,0,Marshall,27,38,134,32,17,152,3,0,H,-1,-1,-5,-94,-10,-8,-6,-2,0,2005
916,916,10/29/2005,U-C-F,30,48,249,25,10,181,0,0,East Carolina,20,41,272,46,24,270,3,3,V,-2.5,10,7,-23,-21,-14,-89,-3,-3,2005
917,917,10/29/2005,U.C.L.A.,30,28,79,35,24,293,0,2,Stanford,27,46,140,25,18,169,0,0,V,8,3,-18,-61,10,6,124,0,2,2005
918,918,10/29/2005,UL-Lafayette,31,52,265,20,9,134,0,2,Troy,28,46,183,27,11,137,1,0,H,3.5,3,6,82,-7,-2,-3,-1,2,2005
919,919,10/29/2005,UTEP,38,30,145,30,24,387,2,1,Rice,31,65,272,19,9,108,0,1,V,19,7,-35,-127,11,15,279,2,0,2005
920,920,10/29/2005,Utah State,3,41,150,30,13,159,1,0,Alabama,35,32,205,36,23,288,0,1,V,-34.5,-32,9,-55,-6,-10,-129,1,-1,2005
921,921,10/29/2005,Wake Forest,44,51,419,23,11,138,1,0,Duke,6,31,50,29,17,153,2,0,V,14.5,38,20,369,-6,-6,-15,-1,0,2005
922,922,10/29/2005,Washington,20,40,213,26,10,185,2,2,Arizona State,44,43,77,34,27,401,0,0,V,-16,-24,-3,136,-8,-17,-216,2,2,2005
923,923,10/29/2005,Washington State,13,33,195,25,13,89,0,2,Southern Cal,55,50,312,43,29,433,1,1,V,-30,-42,-17,-117,-18,-16,-344,-1,1,2005
924,924,10/29/2005,Western Michigan,44,39,158,31,20,249,2,0,Kent State,14,28,1,50,27,373,2,1,H,5.5,30,11,157,-19,-7,-124,0,-1,2005
925,925,10/29/2005,Wisconsin,41,50,239,23,14,225,0,0,Illinois,24,38,261,40,20,277,1,0,V,19,17,12,-22,-17,-6,-52,-1,0,2005
926,926,11/01/2005,Memphis,20,44,218,22,16,187,2,1,U-A-B,37,37,217,42,25,334,1,0,H,3,-17,7,1,-20,-9,-147,1,1,2005
927,927,11/01/2005,U-A-B,37,37,217,42,25,334,1,0,Memphis,20,44,218,22,16,187,2,1,V,-3,17,-7,-1,20,9,147,-1,-1,2005
928,928,11/02/2005,Connecticut,13,38,12,21,11,117,1,1,West Virginia,45,57,228,18,9,144,1,1,V,-14.5,-32,-19,-216,3,2,-27,0,0,2005
929,929,11/02/2005,West Virginia,45,57,228,18,9,144,1,1,Connecticut,13,38,12,21,11,117,1,1,H,14.5,32,19,216,-3,-2,27,0,0,2005
930,930,11/03/2005,Louisville,42,49,220,31,21,247,0,2,Pittsburgh,20,28,62,30,17,198,0,2,H,18,22,21,158,1,4,49,0,0,2005
931,931,11/03/2005,Pittsburgh,20,28,62,30,17,198,0,2,Louisville,42,49,220,31,21,247,0,2,V,-18,-22,-21,-158,-1,-4,-49,0,0,2005
932,932,11/04/2005,Ohio,21,38,146,23,13,148,2,0,Toledo,30,44,293,31,22,236,1,0,H,-12.5,-9,-6,-147,-8,-9,-88,1,0,2005
933,933,11/04/2005,Toledo,30,44,293,31,22,236,1,0,Ohio,21,38,146,23,13,148,2,0,V,12.5,9,6,147,8,9,88,-1,0,2005
934,934,11/05/2005,Air Force,24,47,230,23,17,203,0,2,Army,27,50,217,23,13,143,0,0,H,13,-3,-3,13,0,4,60,0,2,2005
935,935,11/05/2005,Akron,17,28,84,44,22,285,1,0,Ball State,23,43,106,29,18,145,0,0,V,2.5,-6,-15,-22,15,4,140,1,0,2005
936,936,11/05/2005,Alabama,17,47,182,22,14,116,2,1,Mississippi State,0,25,26,30,10,77,3,1,V,17,17,22,156,-8,4,39,-1,0,2005
937,937,11/05/2005,Arizona,52,43,315,24,14,204,0,0,U.C.L.A.,14,35,85,41,25,243,0,1,H,-8.5,38,8,230,-17,-11,-39,0,-1,2005
938,938,11/05/2005,Arizona State,27,39,124,44,29,424,1,1,Washington State,24,42,223,35,21,283,1,1,V,2.5,3,-3,-99,9,8,141,0,0,2005
939,939,11/05/2005,Arkansas,10,48,219,24,12,137,1,0,South Carolina,14,33,45,25,12,142,0,1,H,5,-4,15,174,-1,0,-5,1,-1,2005
940,940,11/05/2005,Arkansas State,7,35,146,28,16,119,1,0,Middle Tennessee,45,43,146,28,18,266,1,0,V,-6,-38,-8,0,0,-2,-147,0,0,2005
941,941,11/05/2005,Army,27,50,217,23,13,143,0,0,Air Force,24,47,230,23,17,203,0,2,V,-13,3,3,-13,0,-4,-60,0,-2,2005
942,942,11/05/2005,Auburn,49,49,388,21,13,201,0,2,Kentucky,27,27,115,43,26,335,1,0,V,22.5,22,22,273,-22,-13,-134,-1,2,2005
943,943,11/05/2005,Ball State,23,43,106,29,18,145,0,0,Akron,17,28,84,44,22,285,1,0,H,-2.5,6,15,22,-15,-4,-140,-1,0,2005
944,944,11/05/2005,Baylor,0,30,112,23,10,89,2,0,Texas,62,54,347,27,16,298,0,0,H,-28,-62,-24,-235,-4,-6,-209,2,0,2005
945,945,11/05/2005,Boise State,56,58,303,33,19,221,1,1,New Mexico State,6,28,61,38,14,115,3,1,H,35,50,30,242,-5,5,106,-2,0,2005
946,946,11/05/2005,Boston College,14,30,100,41,26,237,0,0,North Carolina,16,40,99,32,20,211,1,0,V,4.5,-2,-10,1,9,6,26,-1,0,2005
947,947,11/05/2005,Bowling Green,24,50,169,18,11,113,0,0,Kent State,14,23,25,39,27,222,1,1,V,11.5,10,27,144,-21,-16,-109,-1,-1,2005
948,948,11/05/2005,Brigham Young,55,46,224,35,24,279,0,0,Nevada-Las Vegas,14,20,2,53,31,329,3,0,V,12,41,26,222,-18,-7,-50,-3,0,2005
949,949,11/05/2005,Buffalo,13,31,79,24,12,143,3,5,Miami-Ohio,54,45,149,45,26,298,1,0,V,-27,-41,-14,-70,-21,-14,-155,2,5,2005
950,950,11/05/2005,California,20,39,213,26,10,88,3,1,Oregon,27,37,143,39,24,232,1,0,V,1,-7,2,70,-13,-14,-144,2,1,2005
951,951,11/05/2005,Central Michigan,28,46,206,51,33,382,0,1,Northern Illinois,31,22,6,43,31,435,1,0,H,-4,-3,24,200,8,2,-53,-1,1,2005
952,952,11/05/2005,Clemson,49,41,234,24,14,216,0,0,Duke,20,28,79,42,26,328,1,1,H,31,29,13,155,-18,-12,-112,-1,-1,2005
953,953,11/05/2005,Colorado,41,42,136,32,24,260,0,1,Missouri,12,30,59,44,27,217,1,1,H,11.5,29,12,77,-12,-3,43,-1,0,2005
954,954,11/05/2005,Colorado State,6,30,59,39,22,194,4,0,Texas Christian,33,46,241,25,13,160,0,1,V,-6.5,-27,-16,-182,14,9,34,4,-1,2005
955,955,11/05/2005,Duke,20,28,79,43,26,328,1,1,Clemson,49,41,234,24,14,216,0,0,V,-31,-29,-13,-155,19,12,112,1,1,2005
956,956,11/05/2005,Eastern Michigan,36,17,36,58,39,398,1,1,Western Michigan,44,41,189,31,23,243,0,1,N,-3.5,-8,-24,-153,27,16,155,1,0,2005
957,957,11/05/2005,Florida,49,42,191,41,32,257,0,0,Vanderbilt,42,25,58,42,28,361,2,2,H,19.5,7,17,133,-1,4,-104,-2,-2,2005
958,958,11/05/2005,Florida Atlantic,14,27,114,37,21,216,1,0,Troy,28,38,112,27,17,271,0,0,V,-3,-14,-11,2,10,4,-55,1,0,2005
959,959,11/05/2005,Florida Intl,31,25,60,35,21,235,0,1,UL-Monroe,29,31,100,49,31,384,1,2,V,-10.5,2,-6,-40,-14,-10,-149,-1,-1,2005
960,960,11/05/2005,Florida State,15,23,43,45,20,184,3,0,No Carolina State,20,44,196,17,9,85,0,0,H,14,-5,-21,-153,28,11,99,3,0,2005
961,961,11/05/2005,Fresno State,45,51,161,36,23,370,0,0,San Jose State,7,31,211,23,5,48,1,0,H,33,38,20,-50,13,18,322,-1,0,2005
962,962,11/05/2005,Georgia Tech,30,42,187,26,12,200,0,0,Wake Forest,17,35,100,33,19,160,1,1,H,9.5,13,7,87,-7,-7,40,-1,-1,2005
963,963,11/05/2005,Hawaii,28,19,46,46,30,415,1,1,Nevada-Reno,38,50,236,36,20,204,0,0,V,-6.5,-10,-31,-190,10,10,211,1,1,2005
964,964,11/05/2005,Houston,29,27,138,30,19,313,1,1,U-C-F,31,54,220,30,21,275,1,0,V,2.5,-2,-27,-82,0,-2,38,0,1,2005
965,965,11/05/2005,Illinois,2,33,68,24,18,92,0,0,Ohio State,40,46,202,25,16,324,0,1,V,-34.5,-38,-13,-134,-1,2,-232,0,-1,2005
966,966,11/05/2005,Indiana,21,37,112,43,26,253,1,0,Minnesota,42,49,347,26,16,225,0,0,H,-12.5,-21,-12,-235,17,10,28,1,0,2005
967,967,11/05/2005,Iowa,27,43,216,38,23,276,0,0,Northwestern,28,31,115,51,31,338,2,0,V,1.5,-1,12,101,-13,-8,-62,-2,0,2005
968,968,11/05/2005,Iowa State,45,53,221,23,16,194,0,1,Kansas State,17,29,12,30,17,221,2,1,H,7.5,28,24,209,-7,-1,-27,-2,0,2005
969,969,11/05/2005,Kansas,40,44,213,27,16,215,1,1,Nebraska,15,22,21,27,14,117,1,0,H,-1,25,22,192,0,2,98,0,1,2005
970,970,11/05/2005,Kansas State,17,29,12,30,17,221,2,1,Iowa State,45,53,221,23,16,194,0,1,V,-7.5,-28,-24,-209,7,1,27,2,0,2005
971,971,11/05/2005,Kent State,14,23,25,39,27,222,1,1,Bowling Green,24,50,169,18,11,113,0,0,H,-11.5,-10,-27,-144,21,16,109,1,1,2005
972,972,11/05/2005,Kentucky,27,27,115,43,26,335,1,0,Auburn,49,49,388,21,13,201,0,2,H,-22.5,-22,-22,-273,22,13,134,1,-2,2005
973,973,11/05/2005,Louisiana State,24,32,163,22,16,208,0,0,Appalachian State,0,36,176,22,10,80,0,0,H, ,24,-4,-13,0,6,128,0,0,2005
974,974,11/05/2005,Louisiana Tech,27,38,126,26,16,150,0,1,Utah State,17,38,106,44,27,372,0,4,V,8,10,0,20,-18,-11,-222,0,-3,2005
975,975,11/05/2005,Miami-Florida,27,43,152,25,15,152,1,0,Virginia Tech,7,34,77,22,8,90,2,4,V,-6,20,9,75,3,7,62,-1,-4,2005
976,976,11/05/2005,Miami-Ohio,54,45,149,45,26,298,1,0,Buffalo,13,31,79,24,12,143,3,5,H,27,41,14,70,21,14,155,-2,-5,2005
977,977,11/05/2005,Michigan State,21,33,103,31,22,248,1,0,Purdue,28,44,221,32,20,226,0,1,V,5,-7,-11,-118,-1,2,22,1,-1,2005
978,978,11/05/2005,Middle Tennessee,45,43,146,28,18,266,1,0,Arkansas State,7,35,146,28,16,119,1,0,H,6,38,8,0,0,2,147,0,0,2005
979,979,11/05/2005,Minnesota,42,49,347,26,16,225,0,0,Indiana,21,37,112,43,26,253,1,0,V,12.5,21,12,235,-17,-10,-28,-1,0,2005
980,980,11/05/2005,Mississippi State,0,25,26,30,10,77,3,1,Alabama,17,47,182,22,14,116,2,1,H,-17,-17,-22,-156,8,-4,-39,1,0,2005
981,981,11/05/2005,Missouri,12,30,59,44,27,217,1,1,Colorado,41,42,136,32,24,260,0,1,V,-11.5,-29,-12,-77,12,3,-43,1,0,2005
982,982,11/05/2005,Navy,49,70,410,3,1,29,1,1,Tulane,21,26,109,33,15,136,3,1,H,11.5,28,44,301,-30,-14,-107,-2,0,2005
983,983,11/05/2005,Nebraska,15,22,21,27,14,117,1,0,Kansas,40,44,213,27,16,215,1,1,V,1,-25,-22,-192,0,-2,-98,0,-1,2005
984,984,11/05/2005,Nevada-Las Vegas,14,20,2,53,31,329,3,0,Brigham Young,55,46,224,35,24,279,0,0,H,-12,-41,-26,-222,18,7,50,3,0,2005
985,985,11/05/2005,Nevada-Reno,38,50,236,36,20,204,0,0,Hawaii,28,19,46,46,30,415,1,1,H,6.5,10,31,190,-10,-10,-211,-1,-1,2005
986,986,11/05/2005,New Mexico State,6,28,61,38,14,115,3,1,Boise State,56,58,303,33,19,221,1,1,V,-35,-50,-30,-242,5,-5,-106,2,0,2005
987,987,11/05/2005,No Carolina State,20,44,196,17,9,85,0,0,Florida State,15,23,43,45,20,184,3,0,V,-14,5,21,153,-28,-11,-99,-3,0,2005
988,988,11/05/2005,North Carolina,16,40,99,32,20,211,1,0,Boston College,14,30,100,41,26,237,0,0,H,-4.5,2,10,-1,-9,-6,-26,1,0,2005
989,989,11/05/2005,North Texas,28,33,263,14,8,112,1,1,UL-Lafayette,31,61,327,11,8,109,1,0,H,-3.5,-3,-28,-64,3,0,3,0,1,2005
990,990,11/05/2005,Northern Illinois,31,22,6,43,31,435,1,0,Central Michigan,28,46,206,51,33,382,0,1,V,4,3,-24,-200,-8,-2,53,1,-1,2005
991,991,11/05/2005,Northwestern,28,31,115,51,31,338,2,0,Iowa,27,43,216,38,23,276,0,0,H,-1.5,1,-12,-101,13,8,62,2,0,2005
992,992,11/05/2005,Notre Dame,41,34,48,33,20,295,0,1,Tennessee,21,39,109,32,13,187,2,1,H,8,20,-5,-61,1,7,108,-2,0,2005
993,993,11/05/2005,Ohio State,40,46,202,25,16,324,0,1,Illinois,2,33,68,24,18,92,0,0,H,34.5,38,13,134,1,-2,232,0,1,2005
994,994,11/05/2005,Oregon,27,37,143,39,24,232,1,0,California,20,39,213,26,10,88,3,1,H,-1,7,-2,-70,13,14,144,-2,-1,2005
995,995,11/05/2005,Oregon State,18,42,127,27,17,136,0,1,Washington,10,27,19,42,16,207,1,2,V,4,8,15,108,-15,1,-71,-1,-1,2005
996,996,11/05/2005,Penn State,35,47,282,28,13,238,2,0,Wisconsin,14,34,-11,34,19,313,2,0,H,10,21,13,293,-6,-6,-75,0,0,2005
997,997,11/05/2005,Purdue,28,44,221,32,20,226,0,1,Michigan State,21,33,103,31,22,248,1,0,H,-5,7,11,118,1,-2,-22,-1,1,2005
998,998,11/05/2005,Rice,7,50,166,31,10,64,1,2,S-M-U,27,49,280,17,9,111,0,2,V,-7.5,-20,1,-114,14,1,-47,1,0,2005
999,999,11/05/2005,Rutgers,31,40,165,27,16,233,4,2,South Florida,45,57,242,22,13,135,0,0,H,3.5,-14,-17,-77,5,3,98,4,2,2005
1000,1000,11/05/2005,S-M-U,27,49,280,17,9,111,0,2,Rice,7,50,166,31,10,64,1,2,H,7.5,20,-1,114,-14,-1,47,-1,0,2005
1001,1001,11/05/2005,San Jose State,7,31,211,23,5,48,1,0,Fresno State,45,51,161,36,23,370,0,0,V,-33,-38,-20,50,-13,-18,-322,1,0,2005
1002,1002,11/05/2005,South Carolina,14,33,45,25,12,142,0,1,Arkansas,10,48,219,24,12,137,1,0,V,-5,4,-15,-174,1,0,5,-1,1,2005
1003,1003,11/05/2005,South Florida,45,57,242,22,13,135,0,0,Rutgers,31,40,165,27,16,233,4,2,V,-3.5,14,17,77,-5,-3,-98,-4,-2,2005
1004,1004,11/05/2005,Southern Cal,51,28,184,38,29,345,0,0,Stanford,21,35,141,41,25,279,3,2,H,32.5,30,-7,43,-3,4,66,-3,-2,2005
1005,1005,11/05/2005,Stanford,21,35,141,41,25,279,3,2,Southern Cal,51,28,184,38,29,345,0,0,V,-32.5,-30,7,-43,3,-4,-66,3,2,2005
1006,1006,11/05/2005,Temple,3,27,10,37,16,160,1,2,Virginia,51,45,262,29,17,187,2,0,V,-35,-48,-18,-252,8,-1,-27,-1,2,2005
1007,1007,11/05/2005,Tennessee,21,39,109,32,13,187,2,1,Notre Dame,41,34,48,33,20,295,0,1,V,-8,-20,5,61,-1,-7,-108,2,0,2005
1008,1008,11/05/2005,Texas,62,54,347,27,16,298,0,0,Baylor,0,30,112,23,10,89,2,0,V,28,62,24,235,4,6,209,-2,0,2005
1009,1009,11/05/2005,Texas A+M,17,40,222,25,15,131,1,2,Texas Tech,56,37,194,48,32,433,1,0,V,-14.5,-39,3,28,-23,-17,-302,0,2,2005
1010,1010,11/05/2005,Texas Christian,33,46,241,25,13,160,0,1,Colorado State,6,30,59,39,22,194,4,0,H,6.5,27,16,182,-14,-9,-34,-4,1,2005
1011,1011,11/05/2005,Texas Tech,56,37,194,48,32,433,1,0,Texas A+M,17,40,222,25,15,131,1,2,H,14.5,39,-3,-28,23,17,302,0,-2,2005
1012,1012,11/05/2005,Troy,28,38,112,27,17,271,0,0,Florida Atlantic,14,27,114,37,21,216,1,0,H,3,14,11,-2,-10,-4,55,-1,0,2005
1013,1013,11/05/2005,Tulane,21,26,109,33,15,136,3,1,Navy,49,70,410,3,1,29,1,1,V,-11.5,-28,-44,-301,30,14,107,2,0,2005
1014,1014,11/05/2005,Tulsa,38,38,139,40,23,263,1,1,UTEP,41,30,95,34,25,340,2,1,V,-9,-3,8,44,6,-2,-77,-1,0,2005
1015,1015,11/05/2005,U-C-F,31,54,220,30,21,275,1,0,Houston,29,27,138,30,19,313,1,1,H,-2.5,2,27,82,0,2,-38,0,-1,2005
1016,1016,11/05/2005,U.C.L.A.,14,35,85,41,25,243,0,1,Arizona,52,43,315,24,14,204,0,0,V,8.5,-38,-8,-230,17,11,39,0,1,2005
1017,1017,11/05/2005,UL-Lafayette,31,61,327,11,8,109,1,0,North Texas,28,33,263,14,8,112,1,1,V,3.5,3,28,64,-3,0,-3,0,-1,2005
1018,1018,11/05/2005,UL-Monroe,29,31,100,49,32,384,1,2,Florida Intl,31,25,60,35,21,235,0,1,H,10.5,-2,6,40,14,11,149,1,1,2005
1019,1019,11/05/2005,UTEP,41,30,95,34,25,340,2,1,Tulsa,38,38,139,40,23,263,1,1,H,9,3,-8,-44,-6,2,77,1,0,2005
1020,1020,11/05/2005,Utah,43,41,179,45,32,384,0,0,Wyoming,13,32,146,30,15,133,1,2,H,3,30,9,33,15,17,251,-1,-2,2005
1021,1021,11/05/2005,Utah State,17,38,106,44,27,372,0,4,Louisiana Tech,27,38,126,26,16,150,0,1,H,-8,-10,0,-20,18,11,222,0,3,2005
1022,1022,11/05/2005,Vanderbilt,42,25,58,42,28,361,2,2,Florida,49,42,191,41,32,257,0,0,V,-19.5,-7,-17,-133,1,-4,104,2,2,2005
1023,1023,11/05/2005,Virginia,51,45,262,29,17,187,2,0,Temple,3,27,10,37,16,160,1,2,H,35,48,18,252,-8,1,27,1,-2,2005
1024,1024,11/05/2005,Virginia Tech,7,34,77,22,8,90,2,4,Miami-Florida,27,43,152,25,15,152,1,0,H,6,-20,-9,-75,-3,-7,-62,1,4,2005
1025,1025,11/05/2005,Wake Forest,17,35,100,33,19,160,1,1,Georgia Tech,30,42,187,27,12,200,0,0,V,-9.5,-13,-7,-87,6,7,-40,1,1,2005
1026,1026,11/05/2005,Washington,10,27,19,42,16,207,1,2,Oregon State,18,42,127,27,17,136,0,1,H,-4,-8,-15,-108,15,-1,71,1,1,2005
1027,1027,11/05/2005,Washington State,24,42,223,35,21,283,1,1,Arizona State,27,39,124,44,29,424,1,1,H,-2.5,-3,3,99,-9,-8,-141,0,0,2005
1028,1028,11/05/2005,Western Michigan,44,41,189,31,23,243,0,1,Eastern Michigan,36,17,36,58,39,398,1,1,N,3.5,8,24,153,-27,-16,-155,-1,0,2005
1029,1029,11/05/2005,Wisconsin,14,34,-11,34,19,313,2,0,Penn State,35,47,282,28,13,238,2,0,V,-10,-21,-13,-293,6,6,75,0,0,2005
1030,1030,11/05/2005,Wyoming,13,32,146,30,15,133,1,2,Utah,43,41,179,45,32,384,0,0,V,-3,-30,-9,-33,-15,-17,-251,1,2,2005
1031,1031,11/08/2005,Marshall,24,41,191,35,18,218,1,0,Southern Miss,27,40,159,28,17,224,1,1,H,-7,-3,1,32,7,1,-6,0,-1,2005
1032,1032,11/08/2005,Southern Miss,27,40,159,28,17,224,1,1,Marshall,24,41,191,35,18,218,1,0,V,7,3,-1,-32,-7,-1,6,0,1,2005
1033,1033,11/09/2005,Cincinnati,0,33,62,29,21,207,2,2,West Virginia,38,50,297,13,8,109,0,0,H,-14,-38,-17,-235,16,13,98,2,2,2005
1034,1034,11/09/2005,West Virginia,38,50,297,13,8,109,0,0,Cincinnati,0,33,62,29,21,207,2,2,V,14,38,17,235,-16,-13,-98,-2,-2,2005
1035,1035,11/10/2005,Boise State,7,22,104,32,15,190,2,1,Fresno State,27,46,206,37,22,307,1,0,V,-7,-20,-24,-102,-5,-7,-117,1,1,2005
1036,1036,11/10/2005,Fresno State,27,46,206,37,22,307,1,0,Boise State,7,22,104,32,15,190,2,1,H,7,20,24,102,5,7,117,-1,-1,2005
1037,1037,11/11/2005,Louisville,56,43,161,31,23,339,0,1,Rutgers,5,26,96,24,12,91,2,0,H,21,51,17,65,7,11,248,-2,1,2005
1038,1038,11/11/2005,Rutgers,5,26,96,24,12,91,2,0,Louisville,56,43,161,31,23,339,0,1,V,-21,-51,-17,-65,-7,-11,-248,2,-1,2005
1039,1039,11/12/2005,Alabama,13,32,97,40,19,187,0,0,Louisiana State,16,33,46,30,16,229,0,0,H,-2.5,-3,-1,51,10,3,-42,0,0,2005
1040,1040,11/12/2005,Arizona,14,30,87,41,22,235,3,2,Washington,38,52,333,19,10,157,1,0,H,12.5,-24,-22,-246,22,12,78,2,2,2005
1041,1041,11/12/2005,Arizona State,35,45,181,37,27,334,0,3,U.C.L.A.,45,39,150,27,22,510,0,2,V,-4.5,-10,6,31,10,5,-176,0,1,2005
1042,1042,11/12/2005,Arkansas,28,40,89,24,17,175,0,2,Mississippi,17,34,10,40,21,316,2,0,V,1,11,6,79,-16,-4,-141,-2,2,2005
1043,1043,11/12/2005,Arkansas State,9,44,127,20,9,117,0,0,Troy,3,32,69,23,12,98,1,0,H,3,6,12,58,-3,-3,19,-1,0,2005
1044,1044,11/12/2005,Army,34,40,120,27,22,224,1,2,Massachusetts,27,23,62,34,21,213,3,0,H, ,7,17,58,-7,1,11,-2,2,2005
1045,1045,11/12/2005,Auburn,31,46,227,28,16,279,1,1,Georgia,30,31,142,36,20,304,0,2,V,-3.5,1,15,85,-8,-4,-25,1,-1,2005
1046,1046,11/12/2005,Ball State,26,22,33,33,17,204,0,2,Eastern Michigan,25,49,167,36,25,326,1,0,V,-6.5,1,-27,-134,-3,-8,-122,-1,2,2005
1047,1047,11/12/2005,Baylor,16,33,77,50,27,270,1,0,Missouri,31,50,298,23,9,72,1,1,V,-9,-15,-17,-221,27,18,198,0,-1,2005
1048,1048,11/12/2005,Boston College,30,42,150,16,8,185,0,1,No Carolina State,10,40,59,30,13,247,1,0,H,4.5,20,2,91,-14,-5,-62,-1,1,2005
1049,1049,11/12/2005,Brigham Young,35,50,267,29,20,179,0,0,Wyoming,21,33,166,25,20,241,2,3,V,4,14,17,101,4,0,-62,-2,-3,2005
1050,1050,11/12/2005,Buffalo,10,39,107,23,16,97,0,0,Kent State,6,20,-37,40,23,175,2,2,V,-8.5,4,19,144,-17,-7,-78,-2,-2,2005
1051,1051,11/12/2005,California,10,31,167,23,13,132,4,2,Southern Cal,35,47,188,32,20,246,1,0,H,-18.5,-25,-16,-21,-9,-7,-114,3,2,2005
1052,1052,11/12/2005,Central Michigan,24,39,115,71,46,460,3,1,Western Michigan,31,35,126,29,16,239,0,1,V,-1.5,-7,4,-11,42,30,221,3,0,2005
1053,1053,11/12/2005,Clemson,35,41,85,33,21,269,1,0,Florida State,14,32,102,34,13,124,2,0,H,-2,21,9,-17,-1,8,145,-1,0,2005
1054,1054,11/12/2005,Colorado,16,38,79,42,25,284,2,1,Iowa State,30,25,36,38,20,251,0,1,V,2.5,-14,13,43,4,5,33,2,0,2005
1055,1055,11/12/2005,Colorado State,10,37,187,37,19,165,3,0,San Diego State,30,42,196,24,14,179,0,1,H,7,-20,-5,-9,13,5,-14,3,-1,2005
1056,1056,11/12/2005,Connecticut,0,37,143,35,18,156,3,0,Pittsburgh,24,34,76,21,12,116,0,0,V,-11,-24,3,67,14,6,40,3,0,2005
1057,1057,11/12/2005,East Carolina,13,32,120,34,21,229,1,1,Tulsa,45,35,238,31,21,257,0,0,V,-11,-32,-3,-118,3,0,-28,1,1,2005
1058,1058,11/12/2005,Eastern Michigan,25,48,166,37,26,327,1,0,Ball State,26,22,33,33,17,204,0,2,H,6.5,-1,26,133,4,9,123,1,-2,2005
1059,1059,11/12/2005,Florida,22,37,149,31,18,210,1,0,South Carolina,30,36,120,17,7,126,0,0,V,5.5,-8,1,29,14,11,84,1,0,2005
1060,1060,11/12/2005,Florida Atlantic,26,48,227,22,13,51,0,0,North Texas,23,38,161,35,15,187,1,0,H,7,3,10,66,-13,-2,-136,-1,0,2005
1061,1061,11/12/2005,Florida Intl,7,20,64,34,18,162,0,0,UL-Lafayette,28,65,308,13,11,105,0,1,V,-8.5,-21,-45,-244,21,7,57,0,-1,2005
1062,1062,11/12/2005,Florida State,14,32,102,34,13,124,2,0,Clemson,35,41,85,33,21,269,1,0,V,2,-21,-9,17,1,-8,-145,1,0,2005
1063,1063,11/12/2005,Georgia,30,31,142,36,20,304,0,2,Auburn,31,46,227,28,16,279,1,1,H,3.5,-1,-15,-85,8,4,25,-1,1,2005
1064,1064,11/12/2005,Georgia Tech,17,27,136,39,20,207,1,0,Virginia,27,45,161,29,21,205,1,0,V,-4.5,-10,-18,-25,10,-1,2,0,0,2005
1065,1065,11/12/2005,Hawaii,50,24,115,45,30,464,2,0,Utah State,23,44,153,24,17,218,0,1,H,15.5,27,-20,-38,21,13,246,2,-1,2005
1066,1066,11/12/2005,Idaho,38,27,81,51,27,343,3,1,Louisiana Tech,41,40,215,32,18,284,1,2,H,-13,-3,-13,-134,19,9,59,2,-1,2005
1067,1067,11/12/2005,Illinois,3,42,168,28,11,97,3,1,Purdue,37,47,190,26,18,201,1,0,V,-22,-34,-5,-22,2,-7,-104,2,1,2005
1068,1068,11/12/2005,Indiana,14,28,63,30,13,147,1,0,Michigan,41,49,216,37,23,209,0,1,V,-24,-27,-21,-153,-7,-10,-62,1,-1,2005
1069,1069,11/12/2005,Iowa,20,37,166,34,21,224,1,1,Wisconsin,10,31,19,38,21,257,0,0,V,-2.5,10,6,147,-4,0,-33,1,1,2005
1070,1070,11/12/2005,Iowa State,30,25,36,38,20,251,0,1,Colorado,16,38,79,42,25,284,2,1,H,-2.5,14,-13,-43,-4,-5,-33,-2,0,2005
1071,1071,11/12/2005,Kansas,14,22,119,35,17,148,1,1,Texas,66,53,336,28,19,281,1,0,V,-34.5,-52,-31,-217,7,-2,-133,0,1,2005
1072,1072,11/12/2005,Kansas State,25,50,248,30,6,103,1,1,Nebraska,27,35,93,38,22,241,1,2,V,-5,-2,15,155,-8,-16,-138,0,-1,2005
1073,1073,11/12/2005,Kent State,6,20,-37,40,23,175,2,2,Buffalo,10,39,107,23,16,97,0,0,H,8.5,-4,-19,-144,17,7,78,2,2,2005
1074,1074,11/12/2005,Kentucky,48,43,210,20,12,155,1,1,Vanderbilt,43,27,119,67,39,395,0,3,V,-13,5,16,91,-47,-27,-240,1,-2,2005
1075,1075,11/12/2005,Louisiana State,16,33,46,30,16,229,0,0,Alabama,13,32,97,40,19,187,0,0,V,2.5,3,1,-51,-10,-3,42,0,0,2005
1076,1076,11/12/2005,Louisiana Tech,41,40,215,32,18,284,1,2,Idaho,38,27,81,51,27,343,3,1,V,13,3,13,134,-19,-9,-59,-2,1,2005
1077,1077,11/12/2005,Maryland,33,49,150,31,19,374,2,0,North Carolina,30,28,89,40,25,335,0,1,V,-3,3,21,61,-9,-6,39,2,-1,2005
1078,1078,11/12/2005,Memphis,16,38,165,30,13,128,0,1,Tennessee,20,37,126,27,15,215,1,1,V,-19,-4,1,39,3,-2,-87,-1,0,2005
1079,1079,11/12/2005,Miami-Florida,47,37,194,31,18,321,1,1,Wake Forest,17,48,133,31,15,236,3,3,V,16,30,-11,61,0,3,85,-2,-2,2005
1080,1080,11/12/2005,Michigan,41,49,216,37,23,209,0,1,Indiana,14,28,63,30,13,147,1,0,H,24,27,21,153,7,10,62,-1,1,2005
1081,1081,11/12/2005,Michigan State,18,21,145,46,29,312,0,0,Minnesota,41,63,327,13,8,123,0,0,V,-5.5,-23,-42,-182,33,21,189,0,0,2005
1082,1082,11/12/2005,Middle Tennessee,31,36,126,33,20,272,1,0,UL-Monroe,34,41,232,44,28,227,0,1,H,10,-3,-5,-106,-11,-8,45,1,-1,2005
1083,1083,11/12/2005,Minnesota,41,63,327,13,8,123,0,0,Michigan State,18,21,145,46,29,312,0,0,H,5.5,23,42,182,-33,-21,-189,0,0,2005
1084,1084,11/12/2005,Mississippi,17,34,10,40,21,316,2,0,Arkansas,28,40,89,24,17,175,0,2,H,-1,-11,-6,-79,16,4,141,2,-2,2005
1085,1085,11/12/2005,Missouri,31,50,298,23,9,72,1,1,Baylor,16,33,77,50,27,270,1,0,H,9,15,17,221,-27,-18,-198,0,1,2005
1086,1086,11/12/2005,Navy,21,58,239,10,4,75,1,1,Notre Dame,42,39,221,31,22,284,1,0,V,-24,-21,19,18,-21,-18,-209,0,1,2005
1087,1087,11/12/2005,Nebraska,27,35,93,38,22,241,1,2,Kansas State,25,50,248,30,6,103,1,1,H,5,2,-15,-155,8,16,138,0,1,2005
1088,1088,11/12/2005,Nevada-Las Vegas,3,25,5,31,12,152,1,1,Texas Christian,51,60,286,35,21,301,1,0,V,-29,-48,-35,-281,-4,-9,-149,0,1,2005
1089,1089,11/12/2005,Nevada-Reno,48,50,289,34,22,271,1,2,New Mexico State,24,19,41,47,33,357,0,3,V,10.5,24,31,248,-13,-11,-86,1,-1,2005
1090,1090,11/12/2005,New Mexico,31,44,88,30,16,197,2,0,Utah,27,32,60,41,18,381,2,3,V,-4,4,12,28,-11,-2,-184,0,-3,2005
1091,1091,11/12/2005,New Mexico State,24,19,41,47,33,357,0,3,Nevada-Reno,48,50,289,34,22,271,1,2,H,-10.5,-24,-31,-248,13,11,86,-1,1,2005
1092,1092,11/12/2005,No Carolina State,10,40,59,30,13,247,1,0,Boston College,30,42,150,16,8,185,0,1,V,-4.5,-20,-2,-91,14,5,62,1,-1,2005
1093,1093,11/12/2005,North Carolina,30,28,89,40,25,335,0,1,Maryland,33,49,150,31,19,374,2,0,H,3,-3,-21,-61,9,6,-39,-2,1,2005
1094,1094,11/12/2005,North Texas,23,38,161,35,15,187,1,0,Florida Atlantic,26,48,227,22,13,151,0,0,V,-7,-3,-10,-66,13,2,36,1,0,2005
1095,1095,11/12/2005,Northwestern,7,29,98,40,18,153,1,1,Ohio State,48,54,317,15,9,105,1,0,V,-16,-41,-25,-219,25,9,48,0,1,2005
1096,1096,11/12/2005,Notre Dame,42,39,221,31,22,284,1,0,Navy,21,58,239,10,4,75,1,1,H,24,21,-19,-18,21,18,209,0,-1,2005
1097,1097,11/12/2005,Ohio State,48,54,317,15,9,105,1,0,Northwestern,7,29,98,40,18,153,1,1,H,16,41,25,219,-25,-9,-48,0,-1,2005
1098,1098,11/12/2005,Oklahoma,36,48,211,29,20,298,1,2,Texas A+M,30,44,292,35,12,158,1,0,H,12.5,6,4,-81,-6,8,140,0,2,2005
1099,1099,11/12/2005,Oklahoma State,24,52,303,23,11,94,1,1,Texas Tech,17,19,30,42,29,308,1,2,H,-24,7,33,273,-19,-18,-214,0,-1,2005
1100,1100,11/12/2005,Oregon,34,37,148,39,28,296,1,2,Washington State,31,37,172,33,22,283,2,1,V,4.5,3,0,-24,6,6,13,-1,1,2005
1101,1101,11/12/2005,Oregon State,17,30,62,40,16,250,1,0,Stanford,20,40,68,33,18,234,2,1,H,3.5,-3,-10,-6,7,-2,16,-1,-1,2005
1102,1102,11/12/2005,Pittsburgh,24,34,76,21,12,116,0,0,Connecticut,0,37,143,35,18,156,3,0,H,11,24,-3,-67,-14,-6,-40,-3,0,2005
1103,1103,11/12/2005,Purdue,37,47,190,26,18,201,1,0,Illinois,3,42,168,28,11,97,3,1,H,22,34,5,22,-2,7,104,-2,-1,2005
1104,1104,11/12/2005,Rice,42,59,392,13,5,114,1,1,Tulane,34,38,154,38,22,298,1,1,H,1,8,21,238,-25,-17,-184,0,0,2005
1105,1105,11/12/2005,San Diego State,30,42,196,24,14,179,0,1,Colorado State,10,37,187,37,19,165,3,0,V,-7,20,5,9,-13,-5,14,-3,1,2005
1106,1106,11/12/2005,South Carolina,30,36,120,17,7,126,0,0,Florida,22,37,149,31,18,210,1,0,H,-5.5,8,-1,-29,-14,-11,-84,-1,0,2005
1107,1107,11/12/2005,South Florida,27,51,338,14,5,89,1,0,Syracuse,0,37,117,26,8,65,3,0,V,8,27,14,221,-12,-3,24,-2,0,2005
1108,1108,11/12/2005,Southern Cal,35,47,188,32,20,246,1,0,California,10,31,167,23,13,132,4,2,V,18.5,25,16,21,9,7,114,-3,-2,2005
1109,1109,11/12/2005,Stanford,20,40,68,33,18,234,2,1,Oregon State,17,30,62,40,16,250,1,0,V,-3.5,3,10,6,-7,2,-16,1,1,2005
1110,1110,11/12/2005,Syracuse,0,37,117,26,8,65,3,0,South Florida,27,51,338,14,5,89,1,0,H,-8,-27,-14,-221,12,3,-24,2,0,2005
1111,1111,11/12/2005,Tennessee,20,37,126,27,15,215,1,1,Memphis,16,38,165,30,13,128,0,1,H,19,4,-1,-39,-3,2,87,1,0,2005
1112,1112,11/12/2005,Texas,66,53,336,28,19,281,1,0,Kansas,14,22,119,35,17,148,1,1,H,34.5,52,31,217,-7,2,133,0,-1,2005
1113,1113,11/12/2005,Texas A+M,30,44,292,35,12,158,1,0,Oklahoma,36,48,211,29,20,298,1,2,V,-12.5,-6,-4,81,6,-8,-140,0,-2,2005
1114,1114,11/12/2005,Texas Christian,51,60,286,35,21,301,1,0,Nevada-Las Vegas,3,25,5,31,12,152,1,1,H,29,48,35,281,4,9,149,0,-1,2005
1115,1115,11/12/2005,Texas Tech,17,19,30,42,29,308,1,2,Oklahoma State,24,52,303,23,11,94,1,1,V,24,-7,-33,-273,19,18,214,0,1,2005
1116,1116,11/12/2005,Troy,3,32,69,23,12,98,1,0,Arkansas State,9,44,127,20,9,117,0,0,V,-3,-6,-12,-58,3,3,-19,1,0,2005
1117,1117,11/12/2005,Tulane,34,38,154,38,22,298,1,1,Rice,42,59,392,13,5,114,1,1,V,-1,-8,-21,-238,25,17,184,0,0,2005
1118,1118,11/12/2005,Tulsa,45,35,238,31,21,257,0,1,East Carolina,13,32,120,34,21,229,1,1,H,11,32,3,118,-3,0,28,-1,0,2005
1119,1119,11/12/2005,U-A-B,21,30,190,39,20,240,2,2,U-C-F,27,44,175,24,15,183,0,1,H,7,-6,-14,15,15,5,57,2,1,2005
1120,1120,11/12/2005,U-C-F,27,44,175,24,15,183,0,1,U-A-B,21,30,190,39,20,240,2,2,V,-7,6,14,-15,-15,-5,-57,-2,-1,2005
1121,1121,11/12/2005,U.C.L.A.,45,39,150,27,22,510,0,2,Arizona State,35,45,181,37,27,334,0,3,H,4.5,10,-6,-31,-10,-5,176,0,-1,2005
1122,1122,11/12/2005,UL-Lafayette,28,65,308,13,11,105,0,1,Florida Intl,7,20,64,34,18,162,0,0,H,8.5,21,45,244,-21,-7,-57,0,1,2005
1123,1123,11/12/2005,UL-Monroe,34,41,232,44,28,227,0,1,Middle Tennessee,31,36,126,33,20,272,1,0,V,-10,3,5,106,11,8,-45,-1,1,2005
1124,1124,11/12/2005,UTEP,45,36,162,29,21,306,0,0,Texas Southern,0,39,105,16,7,41,0,1,H, ,45,-3,57,13,14,265,0,-1,2005
1125,1125,11/12/2005,Utah,27,32,60,41,18,381,2,3,New Mexico,31,44,88,30,16,197,2,0,H,4,-4,-12,-28,11,2,184,0,3,2005
1126,1126,11/12/2005,Utah State,23,44,153,24,17,218,0,1,Hawaii,50,24,115,45,30,464,2,0,V,-15.5,-27,20,38,-21,-13,-246,-2,1,2005
1127,1127,11/12/2005,Vanderbilt,43,27,119,67,39,395,0,3,Kentucky,48,43,210,20,12,155,1,1,H,13,-5,-16,-91,47,27,240,-1,2,2005
1128,1128,11/12/2005,Virginia,27,45,161,29,21,205,1,0,Georgia Tech,17,27,136,39,20,207,1,0,H,4.5,10,18,25,-10,1,-2,0,0,2005
1129,1129,11/12/2005,Wake Forest,17,48,133,31,15,236,3,3,Miami-Florida,47,37,194,31,18,321,1,1,H,-16,-30,11,-61,0,-3,-85,2,2,2005
1130,1130,11/12/2005,Washington,38,52,333,19,10,157,1,0,Arizona,14,30,87,41,22,235,3,2,V,-12.5,24,22,246,-22,-12,-78,-2,-2,2005
1131,1131,11/12/2005,Washington State,31,37,172,33,22,283,2,1,Oregon,34,37,148,39,28,296,1,2,H,-4.5,-3,0,24,-6,-6,-13,1,-1,2005
1132,1132,11/12/2005,Western Michigan,31,35,126,29,16,239,0,1,Central Michigan,24,38,114,72,47,461,3,1,H,1.5,7,-3,12,-43,-31,-222,-3,0,2005
1133,1133,11/12/2005,Wisconsin,10,31,19,38,21,257,0,0,Iowa,20,37,166,34,21,224,1,1,H,2.5,-10,-6,-147,4,0,33,-1,-1,2005
1134,1134,11/12/2005,Wyoming,21,33,166,25,20,241,2,3,Brigham Young,35,50,267,29,20,179,0,0,H,-4,-14,-17,-101,-4,0,62,2,3,2005
1135,1135,11/13/2005,Houston,24,47,155,36,24,315,0,3,Southern Miss,27,26,24,45,23,295,1,1,H,0,-3,21,131,-9,1,20,-1,2,2005
1136,1136,11/13/2005,Southern Miss,24,26,24,45,23,295,1,1,Houston,27,47,155,36,24,315,0,3,V,0,-3,-21,-131,9,-1,-20,1,-2,2005
1137,1137,11/15/2005,Akron,27,44,228,32,22,270,1,1,Ohio,3,27,11,19,10,99,1,0,H,3.5,24,17,217,13,12,171,0,1,2005
1138,1138,11/15/2005,Bowling Green,42,42,123,35,22,183,2,1,Miami-Ohio,14,27,-64,37,17,254,5,2,V,-8.5,28,15,187,-2,5,-71,-3,-1,2005
1139,1139,11/15/2005,Miami-Ohio,14,27,-64,37,17,254,5,2,Bowling Green,42,42,123,35,22,183,2,1,H,8.5,-28,-15,-187,2,-5,71,3,1,2005
1140,1140,11/15/2005,Ohio,3,27,11,19,10,99,1,0,Akron,27,44,228,32,22,270,1,1,V,-3.5,-24,-17,-217,-13,-12,-171,0,-1,2005
1141,1141,11/16/2005,Northern Illinois,35,43,162,30,21,176,1,0,Toledo,17,37,147,35,15,166,3,2,V,-7.5,18,6,15,-5,6,10,-2,-2,2005
1142,1142,11/16/2005,Toledo,17,37,147,35,15,166,3,2,Northern Illinois,35,43,162,30,21,176,1,0,H,7.5,-18,-6,-15,5,-6,-10,2,2,2005
1143,1143,11/19/2005,Air Force,42,59,278,15,11,186,0,0,New Mexico,24,46,227,29,16,162,2,0,V,-13,18,13,51,-14,-5,24,-2,0,2005
1144,1144,11/19/2005,Alabama,18,37,33,29,16,155,0,0,Auburn,28,35,139,21,14,118,0,1,V,-7,-10,2,-106,8,2,37,0,-1,2005
1145,1145,11/19/2005,Arkansas,44,45,247,26,14,132,2,0,Mississippi State,10,33,106,27,11,77,1,2,H,14,34,12,141,-1,3,55,1,-2,2005
1146,1146,11/19/2005,Arkansas State,10,39,165,30,17,125,2,1,Army,38,55,300,10,5,77,0,1,V,-7,-28,-16,-135,20,12,48,2,0,2005
1147,1147,11/19/2005,Army,38,55,300,10,5,77,0,1,Arkansas State,10,39,165,30,17,125,2,1,H,7,28,16,135,-20,-12,-48,-2,0,2005
1148,1148,11/19/2005,Auburn,28,35,139,21,14,118,0,1,Alabama,18,37,33,29,16,155,0,0,H,7,10,-2,106,-8,-2,-37,0,1,2005
1149,1149,11/19/2005,Ball State,24,43,74,38,23,281,1,0,Central Michigan,31,33,110,42,23,327,0,0,H,-5,-7,10,-36,-4,0,-46,1,0,2005
1150,1150,11/19/2005,Baylor,44,40,46,35,22,272,0,1,Oklahoma State,34,31,90,50,29,383,4,4,H,4,10,9,-44,-15,-7,-111,-4,-3,2005
1151,1151,11/19/2005,Boise State,70,34,254,25,9,203,3,1,Idaho,35,30,72,62,34,357,3,1,H,29.5,35,4,182,-37,-25,-154,0,0,2005
1152,1152,11/19/2005,Boston College,31,44,221,24,16,230,1,3,Maryland,16,39,133,46,25,230,3,1,V,2,15,5,88,-22,-9,0,-2,2,2005
1153,1153,11/19/2005,Brigham Young,34,31,176,48,27,309,0,1,Utah,41,44,251,35,17,240,0,0,H,11.5,-7,-13,-75,13,10,69,0,1,2005
1154,1154,11/19/2005,Buffalo,14,39,172,41,25,269,5,0,Eastern Michigan,38,31,169,28,15,147,0,0,H,-5,-24,8,3,13,10,122,5,0,2005
1155,1155,11/19/2005,California,27,43,226,19,11,139,1,0,Stanford,3,37,16,37,24,228,0,1,V,4.5,24,6,210,-18,-13,-89,1,-1,2005
1156,1156,11/19/2005,Central Michigan,31,33,110,42,23,327,0,0,Ball State,24,43,74,38,23,281,1,0,V,5,7,-10,36,4,0,46,-1,0,2005
1157,1157,11/19/2005,Cincinnati,16,30,89,31,20,273,1,1,South Florida,31,52,190,21,12,155,0,0,V,-17,-15,-22,-101,10,8,118,1,1,2005
1158,1158,11/19/2005,Clemson,13,40,175,26,17,172,2,2,South Carolina,9,33,167,29,16,180,3,2,V,-1,4,7,8,-3,1,-8,-1,0,2005
1159,1159,11/19/2005,Colorado State,31,41,135,27,17,194,0,2,Nevada-Las Vegas,27,41,190,28,16,167,1,0,V,15.5,4,0,-55,-1,1,27,-1,2,2005
1160,1160,11/19/2005,Duke,21,38,81,30,11,163,3,0,North Carolina,24,46,163,34,15,238,0,2,V,-26,-3,-8,-82,-4,-4,-75,3,-2,2005
1161,1161,11/19/2005,East Carolina,34,45,245,25,17,219,1,1,Marshall,29,34,199,35,26,191,1,1,V,-6.5,5,11,46,-10,-9,28,0,0,2005
1162,1162,11/19/2005,Eastern Michigan,38,31,169,28,15,147,0,0,Buffalo,14,39,172,41,25,269,5,0,V,5,24,-8,-3,-13,-10,-122,-5,0,2005
1163,1163,11/19/2005,Florida Intl,38,36,168,36,22,324,0,1,Western Kentucky,35,44,222,14,11,125,0,1,H, ,3,-8,-54,22,11,199,0,0,2005
1164,1164,11/19/2005,Fresno State,42,32,110,45,27,317,4,1,Southern Cal,50,36,308,33,22,200,0,1,V,-25,-8,-4,-198,12,5,117,4,0,2005
1165,1165,11/19/2005,Georgia,45,31,169,38,22,226,0,0,Kentucky,13,31,99,33,18,100,0,1,H,27,32,0,70,5,4,126,0,-1,2005
1166,1166,11/19/2005,Georgia Tech,14,44,120,30,11,159,0,1,Miami-Florida,10,30,30,31,14,207,1,0,V,-18.5,4,14,90,-1,-3,-48,-1,1,2005
1167,1167,11/19/2005,Houston,24,40,119,36,25,273,2,1,S-M-U,29,36,124,27,12,117,1,1,H,12.5,-5,4,-5,9,13,156,1,0,2005
1168,1168,11/19/2005,Idaho,35,30,72,62,34,357,3,1,Boise State,70,34,254,25,9,203,3,1,V,-29.5,-35,-4,-182,37,25,154,0,0,2005
1169,1169,11/19/2005,Illinois,21,43,199,35,20,241,1,0,Northwestern,38,61,356,31,25,240,0,0,H,-15,-17,-18,-157,4,-5,1,1,0,2005
1170,1170,11/19/2005,Indiana,14,39,145,27,12,169,3,2,Purdue,41,51,299,27,14,124,1,0,H,-11.5,-27,-12,-154,0,-2,45,2,2,2005
1171,1171,11/19/2005,Iowa,52,40,236,34,20,377,1,0,Minnesota,28,34,129,46,26,315,2,0,H,4,24,6,107,-12,-6,62,-1,0,2005
1172,1172,11/19/2005,Kansas State,36,47,224,24,12,118,1,1,Missouri,28,40,178,39,23,268,1,1,H,0,8,7,46,-15,-11,-150,0,0,2005
1173,1173,11/19/2005,Kentucky,13,31,99,33,18,100,0,1,Georgia,45,31,169,38,22,226,0,0,V,-27,-32,0,-70,-5,-4,-126,0,1,2005
1174,1174,11/19/2005,Louisiana State,40,41,177,26,15,203,1,1,Mississippi,7,22,7,38,20,168,2,0,V,17,33,19,170,-12,-5,35,-1,1,2005
1175,1175,11/19/2005,Marshall,29,34,199,35,26,191,1,1,East Carolina,34,45,245,25,17,219,1,1,H,6.5,-5,-11,-46,10,9,-28,0,0,2005
1176,1176,11/19/2005,Maryland,16,39,133,46,25,230,3,1,Boston College,31,44,221,24,16,230,1,3,H,-2,-15,-5,-88,22,9,0,2,-2,2005
1177,1177,11/19/2005,Memphis,24,61,263,19,12,157,1,1,Southern Miss,22,26,94,40,22,297,2,0,V,-7.5,2,35,169,-21,-10,-140,-1,1,2005
1178,1178,11/19/2005,Miami-Florida,10,30,30,31,14,207,1,1,Georgia Tech,14,44,120,30,11,159,0,1,H,18.5,-4,-14,-90,1,3,48,1,0,2005
1179,1179,11/19/2005,Michigan,21,24,32,37,25,223,0,0,Ohio State,25,35,118,37,27,300,0,2,H,-2.5,-4,-11,-86,0,-2,-77,0,-2,2005
1180,1180,11/19/2005,Michigan State,22,42,168,36,23,233,4,0,Penn State,31,39,188,20,10,105,0,1,H,-7,-9,3,-20,16,13,128,4,-1,2005
1181,1181,11/19/2005,Middle Tennessee,3,39,50,37,23,228,1,0,No Carolina State,24,31,153,11,6,85,1,0,V,-18,-21,8,-103,26,17,143,0,0,2005
1182,1182,11/19/2005,Minnesota,28,34,129,46,26,315,2,0,Iowa,52,40,236,34,20,377,1,0,V,-4,-24,-6,-107,12,6,-62,1,0,2005
1183,1183,11/19/2005,Mississippi,7,22,7,38,20,168,2,0,Louisiana State,40,41,177,26,15,203,1,1,H,-17,-33,-19,-170,12,5,-35,1,-1,2005
1184,1184,11/19/2005,Mississippi State,10,33,106,27,11,77,1,2,Arkansas,44,45,247,26,14,132,2,0,V,-14,-34,-12,-141,1,-3,-55,-1,2,2005
1185,1185,11/19/2005,Missouri,28,40,178,39,23,268,1,1,Kansas State,36,47,224,24,12,118,1,1,V,0,-8,-7,-46,15,11,150,0,0,2005
1186,1186,11/19/2005,Navy,38,63,375,11,4,120,0,1,Temple,17,34,136,39,24,245,0,1,H,27,21,29,239,-28,-20,-125,0,0,2005
1187,1187,11/19/2005,Nevada-Las Vegas,27,41,190,28,16,167,1,0,Colorado State,31,41,135,27,17,194,0,2,H,-15.5,-4,0,55,1,-1,-27,1,-2,2005
1188,1188,11/19/2005,Nevada-Reno,30,45,195,19,12,146,0,1,Utah State,24,39,93,27,19,226,1,0,V,9.5,6,6,102,-8,-7,-80,-1,1,2005
1189,1189,11/19/2005,New Mexico,24,46,227,29,16,162,2,0,Air Force,42,59,278,15,11,186,0,0,H,13,-18,-13,-51,14,5,-24,2,0,2005
1190,1190,11/19/2005,New Mexico State,10,17,10,64,40,366,2,0,San Jose State,27,49,257,34,20,222,0,0,V,-6,-17,-32,-247,30,20,144,2,0,2005
1191,1191,11/19/2005,No Carolina State,24,31,153,11,6,85,1,0,Middle Tennessee,3,39,50,37,23,228,1,0,H,18,21,-8,103,-26,-17,-143,0,0,2005
1192,1192,11/19/2005,North Carolina,24,46,163,34,15,238,0,2,Duke,21,38,81,30,11,163,3,0,H,26,3,8,82,4,4,75,-3,2,2005
1193,1193,11/19/2005,North Texas,19,35,125,38,19,242,2,1,UL-Monroe,24,46,181,33,16,218,1,2,H,-4.5,-5,-11,-56,5,3,24,1,-1,2005
1194,1194,11/19/2005,Northwestern,38,61,356,31,25,240,0,0,Illinois,21,43,199,35,20,241,1,0,V,15,17,18,157,-4,5,-1,-1,0,2005
1195,1195,11/19/2005,Notre Dame,34,36,134,38,22,286,0,0,Syracuse,10,38,143,22,9,78,1,0,H,35,24,-2,-9,16,13,208,-1,0,2005
1196,1196,11/19/2005,Ohio State,25,35,118,37,27,300,0,2,Michigan,21,24,32,37,25,223,0,0,V,2.5,4,11,86,0,2,77,0,2,2005
1197,1197,11/19/2005,Oklahoma,21,45,162,26,12,118,0,0,Texas Tech,23,31,144,37,24,232,2,0,V,-7.5,-2,14,18,-11,-12,-114,-2,0,2005
1198,1198,11/19/2005,Oklahoma State,34,31,90,50,29,383,4,4,Baylor,44,40,46,35,22,272,0,1,V,-4,-10,-9,44,15,7,111,4,3,2005
1199,1199,11/19/2005,Oregon,56,36,140,30,18,262,0,0,Oregon State,14,41,119,44,23,178,4,1,H,13,42,-5,21,-14,-5,84,-4,-1,2005
1200,1200,11/19/2005,Oregon State,14,41,119,44,23,178,4,1,Oregon,56,36,140,30,18,262,0,0,V,-13,-42,5,-21,14,5,-84,4,1,2005
1201,1201,11/19/2005,Penn State,31,39,188,20,10,105,0,1,Michigan State,22,42,168,36,23,233,4,0,V,7,9,-3,20,-16,-13,-128,-4,1,2005
1202,1202,11/19/2005,Purdue,41,51,299,27,14,124,1,0,Indiana,14,39,145,27,12,169,3,2,V,11.5,27,12,154,0,2,-45,-2,-2,2005
1203,1203,11/19/2005,Rice,28,49,237,16,8,214,2,0,U-C-F,31,40,149,29,19,205,1,0,H,-10,-3,9,88,-13,-11,9,1,0,2005
1204,1204,11/19/2005,S-M-U,29,36,124,27,12,117,1,1,Houston,24,40,119,36,25,273,2,1,V,-12.5,5,-4,5,-9,-13,-156,-1,0,2005
1205,1205,11/19/2005,San Diego State,34,42,214,29,17,211,2,1,Wyoming,21,28,51,55,37,346,3,0,H,6.5,13,14,163,-26,-20,-135,-1,1,2005
1206,1206,11/19/2005,San Jose State,27,49,257,34,20,222,0,0,New Mexico State,10,17,10,64,40,366,2,0,H,6,17,32,247,-30,-20,-144,-2,0,2005
1207,1207,11/19/2005,South Carolina,9,33,167,29,16,180,3,1,Clemson,13,40,175,26,17,172,2,2,H,1,-4,-7,-8,3,-1,8,1,-1,2005
1208,1208,11/19/2005,South Florida,31,52,190,21,12,155,0,0,Cincinnati,16,30,89,31,20,273,1,1,H,17,15,22,101,-10,-8,-118,-1,-1,2005
1209,1209,11/19/2005,Southern Cal,50,36,308,33,22,200,0,1,Fresno State,42,32,110,45,27,317,4,1,H,25,8,4,198,-12,-5,-117,-4,0,2005
1210,1210,11/19/2005,Southern Miss,22,26,94,40,22,297,2,0,Memphis,24,61,263,19,12,157,1,1,H,7.5,-2,-35,-169,21,10,140,1,-1,2005
1211,1211,11/19/2005,Stanford,3,37,16,37,24,228,0,1,California,27,43,226,19,11,139,1,0,H,-4.5,-24,-6,-210,18,13,89,-1,1,2005
1212,1212,11/19/2005,Syracuse,10,38,143,22,9,78,1,0,Notre Dame,34,36,134,38,22,286,0,0,V,-35,-24,2,9,-16,-13,-208,1,0,2005
1213,1213,11/19/2005,Temple,17,34,136,39,24,245,0,1,Navy,38,63,375,11,4,120,0,1,V,-27,-21,-29,-239,28,20,125,0,0,2005
1214,1214,11/19/2005,Tennessee,24,47,251,26,11,125,2,0,Vanderbilt,28,28,49,39,27,315,0,0,H,11.5,-4,19,202,-13,-16,-190,2,0,2005
1215,1215,11/19/2005,Texas Tech,23,31,144,37,24,232,2,0,Oklahoma,21,45,162,26,12,118,0,0,H,7.5,2,-14,-18,11,12,114,2,0,2005
1216,1216,11/19/2005,Tulane,14,28,58,35,18,212,2,1,Tulsa,38,40,145,25,16,281,0,1,H,-14,-24,-12,-87,10,2,-69,2,0,2005
1217,1217,11/19/2005,Tulsa,38,40,145,25,16,281,0,1,Tulane,14,28,58,35,18,212,2,1,V,14,24,12,87,-10,-2,69,-2,0,2005
1218,1218,11/19/2005,U-A-B,35,45,189,17,11,184,1,1,UTEP,23,43,148,52,33,337,3,1,V,-7.5,12,2,41,-35,-22,-153,-2,0,2005
1219,1219,11/19/2005,U-C-F,31,40,149,29,19,205,1,0,Rice,28,49,237,16,8,214,2,0,V,10,3,-9,-88,13,11,-9,-1,0,2005
1220,1220,11/19/2005,UL-Monroe,24,46,181,33,16,218,1,2,North Texas,19,35,125,38,19,242,2,1,V,4.5,5,11,56,-5,-3,-24,-1,1,2005
1221,1221,11/19/2005,UTEP,23,43,148,52,33,337,3,1,U-A-B,35,45,189,17,11,184,1,1,H,7.5,-12,-2,-41,35,22,153,2,0,2005
1222,1222,11/19/2005,Utah,41,44,251,35,17,240,0,0,Brigham Young,34,31,176,48,27,309,0,1,V,-11.5,7,13,75,-13,-10,-69,0,-1,2005
1223,1223,11/19/2005,Utah State,24,39,93,27,19,226,1,0,Nevada-Reno,30,45,195,19,12,146,0,1,H,-9.5,-6,-6,-102,8,7,80,1,-1,2005
1224,1224,11/19/2005,Vanderbilt,28,28,49,39,27,315,0,0,Tennessee,24,47,251,26,11,125,2,0,V,-11.5,4,-19,-202,13,16,190,-2,0,2005
1225,1225,11/19/2005,Virginia,14,30,114,30,17,140,2,1,Virginia Tech,52,55,333,21,15,170,1,0,H,-8.5,-38,-25,-219,9,2,-30,1,1,2005
1226,1226,11/19/2005,Virginia Tech,52,55,333,21,15,170,1,0,Virginia,14,30,114,30,17,140,2,1,V,8.5,38,25,219,-9,-2,30,-1,-1,2005
1227,1227,11/19/2005,Washington,22,28,99,28,14,228,0,1,Washington State,26,47,224,35,21,283,0,1,H,-3,-4,-19,-125,-7,-7,-55,0,0,2005
1228,1228,11/19/2005,Washington State,26,47,224,35,21,283,0,1,Washington,22,28,99,28,14,228,0,1,V,3,4,19,125,7,7,55,0,0,2005
1229,1229,11/19/2005,Wyoming,21,28,51,55,37,346,3,0,San Diego State,34,42,214,29,17,211,2,1,V,-6.5,-13,-14,-163,26,20,135,1,-1,2005
1230,1230,11/21/2005,Miami-Ohio,38,41,124,44,22,297,1,0,Ohio,7,37,157,22,5,28,1,1,V,8,31,4,-33,22,17,269,0,-1,2005
1231,1231,11/21/2005,Ohio,7,37,157,22,5,28,1,1,Miami-Ohio,38,41,124,44,22,297,1,0,H,-8,-31,-4,33,-22,-17,-269,0,1,2005
1232,1232,11/22/2005,Bowling Green,41,34,180,43,25,315,0,0,Toledo,44,52,284,36,23,298,0,1,H,6,-3,-18,-104,7,2,17,0,-1,2005
1233,1233,11/22/2005,Toledo,44,52,284,36,23,298,0,1,Bowling Green,41,34,180,43,25,315,0,0,V,-6,3,18,104,-7,-2,-17,0,1,2005
1234,1234,11/23/2005,Northern Illinois,42,50,366,13,8,160,0,1,Western Michigan,7,32,104,42,26,185,2,0,H,9.5,35,18,262,-29,-18,-25,-2,1,2005
1235,1235,11/23/2005,Western Michigan,7,32,104,42,26,185,2,0,Northern Illinois,42,50,366,13,8,160,0,1,V,-9.5,-35,-18,-262,29,18,25,2,-1,2005
1236,1236,11/24/2005,Akron,35,46,161,18,7,66,0,0,Kent State,3,45,109,12,4,7,1,1,H,12,32,1,52,6,3,59,-1,-1,2005
1237,1237,11/24/2005,Kent State,3,45,109,12,4,7,1,1,Akron,35,46,161,18,7,66,0,0,V,-12,-32,-1,-52,-6,-3,-59,1,1,2005
1238,1238,11/24/2005,Pittsburgh,13,31,122,43,24,308,2,3,West Virginia,45,62,451,10,4,41,1,0,V,-13,-32,-31,-329,33,20,267,1,3,2005
1239,1239,11/24/2005,West Virginia,45,62,451,10,4,41,1,0,Pittsburgh,13,31,122,43,24,308,2,3,H,13,32,31,329,-33,-20,-267,-1,-3,2005
1240,1240,11/25/2005,Arizona,20,50,164,27,18,213,1,0,Arizona State,23,30,123,37,18,246,0,0,V,-9,-3,20,41,-10,0,-33,1,0,2005
1241,1241,11/25/2005,Arizona State,23,30,123,37,18,246,0,0,Arizona,20,50,164,27,18,213,1,0,H,9,3,-20,-41,10,0,33,-1,0,2005
1242,1242,11/25/2005,Arkansas,17,34,35,30,14,206,1,0,Louisiana State,19,37,108,29,13,194,2,1,V,-16.5,-2,-3,-73,1,1,12,-1,-1,2005
1243,1243,11/25/2005,Colorado,3,20,53,40,20,159,1,0,Nebraska,30,42,105,48,27,392,0,0,H,14,-27,-22,-52,-8,-7,-233,1,0,2005
1244,1244,11/25/2005,Hawaii,24,17,43,54,33,403,1,1,Wisconsin,41,53,249,16,12,191,0,0,H,-6.5,-17,-36,-206,38,21,212,1,1,2005
1245,1245,11/25/2005,Louisiana State,19,37,108,29,13,194,2,1,Arkansas,17,34,35,30,14,206,1,0,H,16.5,2,3,73,-1,-1,-12,1,1,2005
1246,1246,11/25/2005,Nebraska,30,42,105,48,27,392,0,0,Colorado,3,20,53,40,20,159,1,0,V,-14,27,22,52,8,7,233,-1,0,2005
1247,1247,11/25/2005,Texas,40,42,174,24,13,162,1,2,Texas A+M,29,52,277,24,10,118,1,2,V,26,11,-10,-103,0,3,44,0,0,2005
1248,1248,11/25/2005,Texas A+M,29,52,277,24,10,118,1,2,Texas,40,42,174,24,13,162,1,2,H,-26,-11,10,103,0,-3,-44,0,0,2005
1249,1249,11/25/2005,Wisconsin,41,53,249,16,12,191,0,0,Hawaii,24,17,43,54,33,403,1,1,V,6.5,17,36,206,-38,-21,-212,-1,-1,2005
1250,1250,11/26/2005,Arkansas State,31,39,237,31,13,205,0,0,North Texas,24,48,175,38,22,218,2,0,V,2.5,7,-9,62,-7,-9,-13,-2,0,2005
1251,1251,11/26/2005,Boise State,30,54,260,17,10,137,0,0,Louisiana Tech,13,25,56,32,17,180,0,1,V,6.5,17,29,204,-15,-7,-43,0,-1,2005
1252,1252,11/26/2005,Cincinnati,9,28,-23,24,15,169,0,1,Rutgers,44,50,337,26,16,237,1,0,V,-14.5,-35,-22,-360,-2,-1,-68,-1,1,2005
1253,1253,11/26/2005,Connecticut,15,41,160,26,8,81,0,2,South Florida,10,40,83,26,10,168,3,2,H,-8.5,5,1,77,0,-2,-87,-3,0,2005
1254,1254,11/26/2005,East Carolina,31,41,135,33,21,286,0,0,U-A-B,23,31,130,43,23,278,3,0,H,-6,8,10,5,-10,-2,8,-3,0,2005
1255,1255,11/26/2005,Florida,34,33,73,28,19,211,1,1,Florida State,7,28,49,42,24,285,2,2,H,6,27,5,24,-14,-5,-74,-1,-1,2005
1256,1256,11/26/2005,Florida Atlantic,6,34,82,28,14,172,5,0,Florida Intl,52,52,266,20,10,114,1,0,V,0,-46,-18,-184,8,4,58,4,0,2005
1257,1257,11/26/2005,Florida Intl,52,52,266,20,10,114,1,0,Florida Atlantic,6,34,82,28,14,172,5,0,H,0,46,18,184,-8,-4,-58,-4,0,2005
1258,1258,11/26/2005,Florida State,7,28,49,42,24,285,2,2,Florida,34,33,73,28,19,211,1,1,V,-6,-27,-5,-24,14,5,74,1,1,2005
1259,1259,11/26/2005,Fresno State,35,28,133,45,30,405,1,1,Nevada-Reno,38,47,235,22,15,189,0,0,V,15.5,-3,-19,-102,23,15,216,1,1,2005
1260,1260,11/26/2005,Georgia,14,30,68,34,15,198,1,0,Georgia Tech,7,37,172,35,18,155,2,1,V,3,7,-7,-104,-1,-3,43,-1,-1,2005
1261,1261,11/26/2005,Georgia Tech,7,37,172,35,18,155,2,1,Georgia,14,30,68,34,15,198,1,0,H,-3,-7,7,104,1,3,-43,1,1,2005
1262,1262,11/26/2005,Houston,35,50,273,25,16,222,0,1,Rice,18,58,289,17,8,110,3,3,H,16.5,17,-8,-16,8,8,112,-3,-2,2005
1263,1263,11/26/2005,Idaho,18,38,165,34,14,135,4,0,San Jose State,26,51,204,17,8,138,1,0,V,-5,-8,-13,-39,17,6,-3,3,0,2005
1264,1264,11/26/2005,Iowa State,21,36,56,34,18,257,1,0,Kansas,24,38,123,43,24,254,3,0,V,3,-3,-2,-67,-9,-6,3,-2,0,2005
1265,1265,11/26/2005,Kansas,24,38,123,43,24,254,3,0,Iowa State,21,36,56,34,18,257,1,0,H,-3,3,2,67,9,6,-3,2,0,2005
1266,1266,11/26/2005,Kentucky,8,33,46,41,27,177,3,1,Tennessee,27,38,150,25,17,221,0,3,H,-10,-19,-5,-104,16,10,-44,3,-2,2005
1267,1267,11/26/2005,Louisiana Tech,13,25,56,32,17,180,0,1,Boise State,30,54,260,17,10,137,0,0,H,-6.5,-17,-29,-204,15,7,43,0,1,2005
1268,1268,11/26/2005,Louisville,41,40,220,29,17,285,2,2,Syracuse,17,28,43,41,19,259,2,1,H,35.5,24,12,177,-12,-2,26,0,1,2005
1269,1269,11/26/2005,Marshall,3,36,57,23,11,97,0,3,Memphis,26,54,243,8,1,-3,0,0,V,-11.5,-23,-18,-186,15,10,100,0,3,2005
1270,1270,11/26/2005,Maryland,14,33,30,35,20,235,2,2,No Carolina State,20,42,73,19,12,113,1,0,V,-2.5,-6,-9,-43,16,8,122,1,2,2005
1271,1271,11/26/2005,Memphis,26,54,243,8,1,-3,0,0,Marshall,3,36,57,23,11,97,0,3,H,11.5,23,18,186,-15,-10,-100,0,-3,2005
1272,1272,11/26/2005,Miami-Florida,25,34,151,30,23,248,0,1,Virginia,17,41,111,29,16,296,0,0,H,18.5,8,-7,40,1,7,-48,0,1,2005
1273,1273,11/26/2005,Middle Tennessee,17,45,125,27,18,146,0,0,Troy,7,29,74,32,18,230,2,0,V,6,10,16,51,-5,0,-84,-2,0,2005
1274,1274,11/26/2005,Mississippi,14,25,31,24,15,158,4,0,Mississippi State,35,56,304,20,11,105,1,0,V,3,-21,-31,-273,4,4,53,3,0,2005
1275,1275,11/26/2005,Mississippi State,35,56,304,20,11,105,1,0,Mississippi,14,25,31,24,15,158,4,0,H,-3,21,31,273,-4,-4,-53,-3,0,2005
1276,1276,11/26/2005,Nevada-Reno,38,47,235,22,15,189,0,0,Fresno State,35,28,133,45,30,405,1,1,H,-15.5,3,19,102,-23,-15,-216,-1,-1,2005
1277,1277,11/26/2005,New Mexico State,21,37,117,49,30,306,1,2,Utah State,24,50,213,20,14,182,1,0,H,-2,-3,-13,-96,29,16,124,0,2,2005
1278,1278,11/26/2005,No Carolina State,20,42,73,19,12,113,1,0,Maryland,14,33,30,35,20,235,2,2,H,2.5,6,9,43,-16,-8,-122,-1,-2,2005
1279,1279,11/26/2005,North Carolina,3,22,36,41,15,160,1,0,Virginia Tech,30,53,277,15,8,61,1,1,V,-22.5,-27,-31,-241,26,7,99,0,-1,2005
1280,1280,11/26/2005,North Texas,24,48,171,38,22,218,2,0,Arkansas State,31,40,217,31,13,205,0,0,H,-2.5,-7,8,-46,7,9,13,2,0,2005
1281,1281,11/26/2005,Notre Dame,38,50,231,38,25,432,2,0,Stanford,31,25,-11,36,23,347,0,0,V,17.5,7,25,242,2,2,85,2,0,2005
1282,1282,11/26/2005,Oklahoma,42,43,354,21,13,206,1,0,Oklahoma State,14,32,13,27,10,126,1,1,H,19.5,28,11,341,-6,3,80,0,-1,2005
1283,1283,11/26/2005,Oklahoma State,14,32,13,27,10,126,1,1,Oklahoma,42,43,354,21,13,206,1,0,V,-19.5,-28,-11,-341,6,-3,-80,0,1,2005
1284,1284,11/26/2005,Rice,18,58,289,17,8,110,3,3,Houston,35,50,273,25,16,222,0,1,V,-16.5,-17,8,16,-8,-8,-112,3,2,2005
1285,1285,11/26/2005,Rutgers,44,50,337,26,16,237,1,0,Cincinnati,9,28,-23,24,15,169,0,1,H,14.5,35,22,360,2,1,68,1,-1,2005
1286,1286,11/26/2005,S-M-U,40,46,229,32,18,211,0,0,UTEP,27,32,95,46,27,360,4,3,H,-7,13,14,134,-14,-9,-149,-4,-3,2005
1287,1287,11/26/2005,San Jose State,26,51,204,17,8,138,1,0,Idaho,18,38,165,34,14,135,4,0,H,5,8,13,39,-17,-6,3,-3,0,2005
1288,1288,11/26/2005,South Florida,10,40,83,26,10,168,3,2,Connecticut,15,41,160,26,8,81,0,2,V,8.5,-5,-1,-77,0,2,87,3,0,2005
1289,1289,11/26/2005,Southern Miss,26,38,136,30,18,276,0,0,Tulane,7,32,111,27,11,155,2,0,H,21.5,19,6,25,3,7,121,-2,0,2005
1290,1290,11/26/2005,Stanford,31,25,-11,36,23,347,0,0,Notre Dame,38,50,231,38,25,432,2,0,H,-17.5,-7,-25,-242,-2,-2,-85,-2,0,2005
1291,1291,11/26/2005,Syracuse,17,28,43,41,19,259,2,1,Louisville,41,40,220,29,17,285,2,2,V,-35.5,-24,-12,-177,12,2,-26,0,-1,2005
1292,1292,11/26/2005,Tennessee,27,38,150,25,17,221,0,3,Kentucky,8,33,46,41,27,177,3,1,V,10,19,5,104,-16,-10,44,-3,2,2005
1293,1293,11/26/2005,Troy,7,29,74,32,18,230,2,0,Middle Tennessee,17,45,125,27,18,146,0,0,H,-6,-10,-16,-51,5,0,84,2,0,2005
1294,1294,11/26/2005,Tulane,7,32,111,27,11,155,2,0,Southern Miss,26,38,136,30,18,276,0,0,V,-21.5,-19,-6,-25,-3,-7,-121,2,0,2005
1295,1295,11/26/2005,U-A-B,23,31,130,43,23,278,3,0,East Carolina,31,41,135,33,21,286,0,0,V,6,-8,-10,-5,10,2,-8,3,0,2005
1296,1296,11/26/2005,UL-Lafayette,54,57,343,14,8,82,0,1,UL-Monroe,21,29,66,37,17,136,1,1,V,-4,33,28,277,-23,-9,-54,-1,0,2005
1297,1297,11/26/2005,UL-Monroe,21,30,46,37,17,136,1,1,UL-Lafayette,54,57,339,14,8,82,0,1,H,4,-33,-27,-293,23,9,54,1,0,2005
1298,1298,11/26/2005,UTEP,27,32,95,46,27,360,4,3,S-M-U,40,46,229,32,18,211,0,0,V,7,-13,-14,-134,14,9,149,4,3,2005
1299,1299,11/26/2005,Utah State,24,50,213,20,14,182,1,0,New Mexico State,21,37,117,49,30,306,1,2,V,2,3,13,96,-29,-16,-124,0,-2,2005
1300,1300,11/26/2005,Virginia,17,41,111,29,16,296,0,0,Miami-Florida,25,34,151,30,23,248,0,1,V,-18.5,-8,7,-40,-1,-7,48,0,-1,2005
1301,1301,11/26/2005,Virginia Tech,30,53,277,15,8,61,1,1,North Carolina,3,22,36,41,15,160,1,0,H,22.5,27,31,241,-26,-7,-99,0,1,2005
1302,1302,12/01/2005,Akron,31,32,105,52,30,413,1,1,Northern Illinois,30,52,250,17,7,110,0,0,N,-13,1,-20,-145,35,23,303,1,1,2005
1303,1303,12/01/2005,Northern Illinois,30,52,250,17,7,110,0,0,Akron,31,32,105,52,30,413,1,1,N,13,-1,20,145,-35,-23,-303,-1,-1,2005
1304,1304,12/02/2005,Fresno State,28,24,86,54,33,358,3,2,Louisiana Tech,40,53,147,22,13,251,0,1,H,22,-12,-29,-61,32,20,107,3,1,2005
1305,1305,12/02/2005,Louisiana Tech,40,53,147,22,13,251,0,1,Fresno State,28,24,86,54,33,358,3,2,V,-22,12,29,61,-32,-20,-107,-3,-1,2005
1306,1306,12/03/2005,Army,23,34,82,35,23,255,0,0,Navy,42,58,490,6,3,41,0,1,N,-7,-19,-24,-408,29,20,214,0,-1,2005
1307,1307,12/03/2005,Colorado,3,26,82,32,15,109,1,3,Texas,70,57,268,19,16,218,1,0,N,-27.5,-67,-31,-186,13,-1,-109,0,3,2005
1308,1308,12/03/2005,Connecticut,20,38,87,32,18,255,0,4,Louisville,30,51,200,25,16,271,1,1,H,-19.5,-10,-13,-113,7,2,-16,-1,3,2005
1309,1309,12/03/2005,Florida Intl,35,24,124,32,22,314,2,0,Middle Tennessee,31,38,107,38,27,316,0,0,H,-8,4,-14,17,-6,-5,-2,2,0,2005
1310,1310,12/03/2005,Florida State,27,24,47,35,21,225,0,0,Virginia Tech,22,31,41,52,26,335,1,1,N,-14,5,-7,6,-17,-5,-110,-1,-1,2005
1311,1311,12/03/2005,Georgia,34,42,138,12,6,112,0,0,Louisiana State,14,36,74,30,14,156,2,0,N,-2,20,6,64,-18,-8,-44,-2,0,2005
1312,1312,12/03/2005,Hawaii,49,39,262,39,25,326,1,3,San Diego State,38,37,133,51,33,421,1,3,H,2.5,11,2,129,-12,-8,-95,0,0,2005
1313,1313,12/03/2005,Louisiana State,14,36,74,30,14,156,2,0,Georgia,34,42,138,12,6,112,0,0,N,2,-20,-6,-64,18,8,44,2,0,2005
1314,1314,12/03/2005,Louisville,30,51,200,25,16,271,1,1,Connecticut,20,38,87,32,18,255,0,4,V,19.5,10,13,113,-7,-2,16,1,-3,2005
1315,1315,12/03/2005,Middle Tennessee,31,38,107,38,27,316,0,0,Florida Intl,35,24,124,32,22,314,2,0,V,8,-4,14,-17,6,5,2,-2,0,2005
1316,1316,12/03/2005,Navy,42,58,490,6,3,41,0,1,Army,23,34,82,35,23,255,0,0,N,7,19,24,408,-29,-20,-214,0,1,2005
1317,1317,12/03/2005,San Diego State,38,37,133,51,33,421,1,3,Hawaii,49,39,262,39,25,326,1,3,V,-2.5,-11,-2,-129,12,8,95,0,0,2005
1318,1318,12/03/2005,South Florida,13,43,149,38,19,221,3,0,West Virginia,28,44,305,10,5,89,1,1,H,-8,-15,-1,-156,28,14,132,2,-1,2005
1319,1319,12/03/2005,Southern Cal,66,51,430,44,23,249,1,1,U.C.L.A.,19,33,129,32,14,146,0,3,H,22,47,18,301,12,9,103,1,-2,2005
1320,1320,12/03/2005,Texas,70,57,268,19,16,218,1,0,Colorado,3,26,82,32,15,109,1,3,N,27.5,67,31,186,-13,1,109,0,-3,2005
1321,1321,12/03/2005,Tulsa,44,48,196,20,13,205,0,0,U-C-F,27,35,149,27,13,190,2,2,V,-2,17,13,47,-7,0,15,-2,-2,2005
1322,1322,12/03/2005,U-C-F,27,35,149,27,13,190,2,2,Tulsa,44,48,196,20,13,205,0,0,H,2,-17,-13,-47,7,0,-15,2,2,2005
1323,1323,12/03/2005,U.C.L.A.,19,33,129,32,14,146,0,3,Southern Cal,66,51,430,44,23,249,1,1,V,-22,-47,-18,-301,-12,-9,-103,-1,2,2005
1324,1324,12/03/2005,Virginia Tech,22,31,41,52,26,335,1,1,Florida State,27,24,47,35,21,225,0,0,N,14,-5,7,-6,17,5,110,1,1,2005
1325,1325,12/03/2005,West Virginia,28,44,305,10,5,89,1,1,South Florida,13,43,149,38,19,221,3,0,V,8,15,1,156,-28,-14,-132,-2,1,2005
