,Unnamed: 0,Date,TeamName,ScoreOff,RushAttOff,RushYdsOff,PassAttOff,PassCompOff,PassYdsOff,PassIntOff,FumblesOff,Opponent,ScoreDef,RushAttDef,RushYdsDef,PassAttDef,PassCompDef,PassYdsDef,PassIntDef,FumblesDef,Site,Line,ScoreDiff,RushAttDiff,RushYdsDiff,PassAttDiff,PassCompDiff,PassYdsDiff,PassIntDiff,FumblesDiff,season
0,0,08/23/2003,California,28,27,62,42,25,378,1,0,Kansas State,42,46,330,18,9,205,0,0,N,-27.5,-14,-19,-268,24,16,173,1,0,2003
1,1,08/23/2003,Kansas State,42,46,330,18,9,205,0,0,California,28,27,62,42,25,378,1,0,N,27.5,14,19,268,-24,-16,-173,-1,0,2003
2,2,08/23/2003,San Jose State,29,40,128,42,27,335,0,2,Grambling,0,21,50,47,23,210,1,2,H, ,29,19,78,-5,4,125,-1,0,2003
3,3,08/28/2003,Akron,38,30,40,47,36,407,0,0,Kent State,41,44,181,44,25,340,1,0,H,12.5,-3,-14,-141,3,11,67,-1,0,2003
4,4,08/28/2003,Ball State,31,31,91,30,14,204,1,0,Indiana State,7,50,113,26,14,70,2,3,H, ,24,-19,-22,4,0,134,-1,-3,2003
5,5,08/28/2003,Bowling Green,63,44,222,37,26,422,1,1,Eastern Kentucky,13,31,139,32,19,170,0,2,H, ,50,13,83,5,7,252,1,-1,2003
6,6,08/28/2003,Brigham Young,24,32,86,47,31,276,2,0,Georgia Tech,13,23,96,24,15,147,1,3,H,4,11,9,-10,23,16,129,1,-3,2003
7,7,08/28/2003,Eastern Michigan,28,35,134,26,15,223,1,0,East Tennessee St,21,41,167,23,14,120,1,0,H, ,7,-6,-33,3,1,103,0,0,2003
8,8,08/28/2003,Georgia Tech,13,23,96,24,15,147,1,3,Brigham Young,24,32,86,47,31,276,2,0,V,-4,-11,-9,10,-23,-16,-129,-1,3,2003
9,9,08/28/2003,Kent State,41,44,181,44,25,340,1,0,Akron,38,30,40,47,36,407,0,0,V,-12.5,3,14,141,-3,-11,-67,1,0,2003
10,10,08/28/2003,Louisiana Tech,9,19,98,34,19,212,2,1,Miami-Florida,48,43,192,35,18,275,1,0,H,-28,-39,-24,-94,-1,1,-63,1,1,2003
11,11,08/28/2003,Maryland,13,35,112,24,12,110,1,1,Northern Illinois,20,43,59,35,21,266,1,0,V,8,-7,-8,53,-11,-9,-156,0,1,2003
12,12,08/28/2003,Miami-Florida,48,43,192,35,18,275,1,0,Louisiana Tech,9,19,98,34,19,212,2,1,V,28,39,24,94,1,-1,63,-1,-1,2003
13,13,08/28/2003,Mid Tennessee St,19,44,183,35,19,160,0,0,Florida Atlantic,20,32,42,29,18,215,2,2,H, ,-1,12,141,6,1,-55,-2,-2,2003
14,14,08/28/2003,Northern Illinois,20,43,59,35,21,266,1,0,Maryland,13,35,112,24,12,110,1,1,H,-8,7,8,-53,11,9,156,0,-1,2003
15,15,08/28/2003,Ohio,17,53,204,18,10,81,0,4,S E Missouri St,3,33,58,41,18,233,3,2,H, ,14,20,146,-23,-8,-152,-3,2,2003
16,16,08/28/2003,Oregon State,40,44,226,37,19,301,0,1,Sacramento State,7,35,61,31,14,193,0,0,H, ,33,9,165,6,5,108,0,1,2003
17,17,08/28/2003,Utah,40,53,202,26,16,180,2,0,Utah State,20,26,77,41,19,280,1,1,H,18,20,27,125,-15,-3,-100,1,-1,2003
18,18,08/28/2003,Utah State,20,26,77,41,19,280,1,1,Utah,40,53,202,26,16,180,2,0,V,-18,-20,-27,-125,15,3,100,-1,1,2003
19,19,08/29/2003,Nevada-Las Vegas,28,39,150,41,27,308,1,2,Toledo,18,29,94,34,17,145,0,2,H,-1.5,10,10,56,7,10,163,1,0,2003
20,20,08/29/2003,Toledo,18,29,94,34,17,145,0,2,Nevada-Las Vegas,28,39,150,41,27,308,1,2,V,1.5,-10,-10,-56,-7,-10,-163,-1,0,2003
21,21,08/30/2003,Air Force,49,74,380,11,7,89,0,0,Wofford,0,40,88,14,9,87,2,0,H, ,49,34,292,-3,-2,2,-2,0,2003
22,22,08/30/2003,Alabama,40,48,188,27,14,203,0,1,South Florida,17,22,51,34,18,205,1,2,H,14.5,23,26,137,-7,-4,-2,-1,-1,2003
23,23,08/30/2003,Alabama-Birmingham,24,35,149,31,14,254,0,1,Baylor,19,37,166,38,20,227,0,1,V,8.5,5,-2,-17,-7,-6,27,0,0,2003
24,24,08/30/2003,Arizona,42,43,217,26,14,229,2,0,Texas-El Paso,7,33,71,43,21,204,1,2,H,21.5,35,10,146,-17,-7,25,1,-2,2003
25,25,08/30/2003,Arkansas State,11,38,114,20,11,94,1,1,Texas A & M,26,34,131,20,12,126,2,1,V,-29,-15,4,-17,0,-1,-32,-1,0,2003
26,26,08/30/2003,Auburn,0,36,43,26,12,121,1,2,Southern Cal,23,36,123,30,17,192,0,0,H,4,-23,0,-80,-4,-5,-71,1,2,2003
27,27,08/30/2003,Baylor,19,37,166,38,20,227,0,1,Alabama-Birmingham,24,35,149,31,14,254,0,1,H,-8.5,-5,2,17,7,6,-27,0,0,2003
28,28,08/30/2003,Boston College,28,46,155,44,26,292,0,3,Wake Forest,32,40,160,23,13,149,2,1,H,10.5,-4,6,-5,21,13,143,-2,2,2003
29,29,08/30/2003,Buffalo,10,41,232,21,7,60,0,1,Rutgers,24,43,181,31,21,225,0,0,V,-10,-14,-2,51,-10,-14,-165,0,1,2003
30,30,08/30/2003,California,34,48,260,18,11,157,0,1,Southern Miss,2,36,65,34,20,212,1,0,H,3.5,32,12,195,-16,-9,-55,-1,1,2003
31,31,08/30/2003,Central Michigan,7,45,218,29,18,150,1,1,Michigan,45,46,342,36,22,273,1,0,V,-34,-38,-1,-124,-7,-4,-123,0,1,2003
32,32,08/30/2003,Clemson,0,24,35,37,20,164,1,2,Georgia,30,49,197,21,13,214,0,0,H,-3.5,-30,-25,-162,16,7,-50,1,2,2003
33,33,08/30/2003,Colorado,42,43,102,34,21,402,0,1,Colorado State,35,39,246,40,18,339,1,2,N,-2,7,4,-144,-6,3,63,-1,-1,2003
34,34,08/30/2003,Colorado State,35,39,246,40,18,339,1,2,Colorado,42,43,102,34,21,402,0,1,N,2,-7,-4,144,6,-3,-63,1,1,2003
35,35,08/30/2003,Connecticut,34,38,200,42,26,307,1,0,Indiana,10,42,110,29,13,211,0,3,H,6,24,-4,90,13,13,96,1,-3,2003
36,36,08/30/2003,Duke,0,35,152,29,11,120,0,0,Virginia,27,41,204,22,12,169,0,0,V,-14,-27,-6,-52,7,-1,-49,0,0,2003
37,37,08/30/2003,Florida,65,32,167,41,27,357,1,1,San Jose State,3,27,87,37,19,98,2,1,H,23.5,62,5,80,4,8,259,-1,0,2003
38,38,08/30/2003,Florida State,37,42,236,37,24,317,0,2,North Carolina,0,27,72,47,27,223,2,1,V,16.5,37,15,164,-10,-3,94,-2,1,2003
39,39,08/30/2003,Fresno State,6,24,-1,24,13,118,0,0,Tennessee,24,44,274,31,18,159,2,0,V,-19,-18,-20,-275,-7,-5,-41,-2,0,2003
40,40,08/30/2003,Georgia,30,49,197,21,13,214,0,0,Clemson,0,24,35,37,20,164,1,2,V,3.5,30,25,162,-16,-7,50,-1,-2,2003
41,41,08/30/2003,Hawaii,40,27,91,38,22,359,3,0,Appalachian State,17,36,122,23,13,137,1,0,H, ,23,-9,-31,15,9,222,2,0,2003
42,42,08/30/2003,Houston,48,49,194,23,17,246,0,0,Rice,14,46,206,13,6,36,2,0,H,3,34,3,-12,10,11,210,-2,0,2003
43,43,08/30/2003,Idaho,0,26,83,36,16,167,3,0,Washington State,25,50,339,23,13,127,1,1,N,-26,-25,-24,-256,13,3,40,2,-1,2003
44,44,08/30/2003,Illinois,15,34,127,45,31,284,0,1,Missouri,22,41,121,18,12,102,0,0,N,-4,-7,-7,6,27,19,182,0,1,2003
45,45,08/30/2003,Indiana,10,42,110,29,13,211,0,3,Connecticut,34,38,200,42,26,307,1,0,V,-6,-24,4,-90,-13,-13,-96,-1,3,2003
46,46,08/30/2003,Iowa,21,40,232,19,12,129,0,1,Miami-Ohio,3,29,54,42,27,250,4,0,H,9,18,11,178,-23,-15,-121,-4,1,2003
47,47,08/30/2003,Iowa State,17,45,169,18,9,158,1,0,Northern Iowa,10,37,119,33,21,142,0,0,H, ,7,8,50,-15,-12,16,1,0,2003
48,48,08/30/2003,Kansas,20,27,100,30,13,255,2,3,Northwestern,28,52,235,36,23,219,1,1,H,-7,-8,-25,-135,-6,-10,36,1,2,2003
49,49,08/30/2003,Kansas State,41,43,147,24,10,245,2,1,Troy State,5,37,39,30,11,99,2,1,H,37.5,36,6,108,-6,-1,146,0,0,2003
50,50,08/30/2003,Louisiana State,49,43,168,35,18,306,1,0,UL-Monroe,7,26,59,34,15,181,1,1,H,34.5,42,17,109,1,3,125,0,-1,2003
51,51,08/30/2003,Marshall,45,50,261,38,26,347,3,2,Hofstra,21,27,116,31,15,125,0,1,H, ,24,23,145,7,11,222,3,1,2003
52,52,08/30/2003,Memphis,40,44,177,38,24,390,0,0,Tennessee Tech,10,25,138,30,16,183,0,2,H, ,30,19,39,8,8,207,0,-2,2003
53,53,08/30/2003,Miami-Ohio,3,29,54,42,27,250,4,0,Iowa,21,40,232,19,12,129,0,1,V,-9,-18,-11,-178,23,15,121,4,-1,2003
54,54,08/30/2003,Michigan,45,46,342,36,22,273,1,0,Central Michigan,7,45,218,29,18,150,1,1,H,34,38,1,124,7,4,123,0,-1,2003
55,55,08/30/2003,Michigan State,26,30,97,34,21,324,2,0,Western Michigan,21,24,6,50,30,333,2,0,H,14,5,6,91,-16,-9,-9,0,0,2003
56,56,08/30/2003,Minnesota,49,49,254,26,16,277,0,0,Tulsa,10,37,94,32,18,171,0,0,H,33,39,12,160,-6,-2,106,0,0,2003
57,57,08/30/2003,Mississippi,20,33,95,33,22,275,0,1,Vanderbilt,14,38,101,33,21,298,1,1,V,13,6,-5,-6,0,1,-23,-1,0,2003
58,58,08/30/2003,Mississippi State,34,22,124,40,23,285,1,2,Oregon,42,51,198,29,22,358,0,2,H,-2.5,-8,-29,-74,11,1,-73,1,0,2003
59,59,08/30/2003,Missouri,22,41,121,18,12,102,0,0,Illinois,15,34,127,45,31,284,0,1,N,4,7,7,-6,-27,-19,-182,0,-1,2003
60,60,08/30/2003,Navy,37,53,370,23,11,228,1,1,Virginia Military,10,40,131,29,16,165,1,2,H, ,27,13,239,-6,-5,63,0,-1,2003
61,61,08/30/2003,Nebraska,17,65,268,16,8,78,1,1,Oklahoma State,7,30,86,28,13,97,3,2,H,7.5,10,35,182,-12,-5,-19,-2,-1,2003
62,62,08/30/2003,Nevada-Reno,24,46,203,32,19,195,0,3,Southern Utah,23,24,73,50,28,265,3,1,H, ,1,22,130,-18,-9,-70,-3,2,2003
63,63,08/30/2003,New Mexico,72,54,299,23,15,257,1,0,S W Texas State,8,24,59,60,27,321,2,1,H, ,64,30,240,-37,-12,-64,-1,-1,2003
64,64,08/30/2003,No Carolina State,59,34,91,39,34,403,0,1,Western Carolina,20,24,43,41,22,192,0,0,H, ,39,10,48,-2,12,211,0,1,2003
65,65,08/30/2003,North Carolina,0,27,72,47,27,223,2,1,Florida State,37,42,236,37,24,317,0,2,H,-16.5,-37,-15,-164,10,3,-94,2,-1,2003
66,66,08/30/2003,North Texas,3,35,75,25,7,79,1,1,Oklahoma,37,32,105,41,28,286,1,0,V,-30,-34,3,-30,-16,-21,-207,0,1,2003
67,67,08/30/2003,Northwestern,28,52,235,36,23,219,1,1,Kansas,20,27,100,30,13,255,2,3,V,7,8,25,135,6,10,-36,-1,-2,2003
68,68,08/30/2003,Ohio State,28,43,142,28,15,203,0,2,Washington,9,24,7,49,26,255,0,0,H,9,19,19,135,-21,-11,-52,0,2,2003
69,69,08/30/2003,Oklahoma,37,32,105,41,28,286,1,0,North Texas,3,35,75,25,7,79,1,1,H,30,34,-3,30,16,21,207,0,-1,2003
70,70,08/30/2003,Oklahoma State,7,30,86,28,13,97,3,2,Nebraska,17,65,268,16,8,78,1,1,V,-7.5,-10,-35,-182,12,5,19,2,1,2003
71,71,08/30/2003,Oregon,42,51,198,29,22,358,0,2,Mississippi State,34,22,124,40,23,285,1,2,V,2.5,8,29,74,-11,-1,73,-1,0,2003
72,72,08/30/2003,Penn State,23,41,231,19,6,79,1,0,Temple,10,40,162,37,17,195,0,0,H,23,13,1,69,-18,-11,-116,1,0,2003
73,73,08/30/2003,Rice,14,46,206,13,6,36,2,0,Houston,48,49,194,23,17,246,0,0,V,-3,-34,-3,12,-10,-11,-210,2,0,2003
74,74,08/30/2003,Rutgers,24,43,181,31,21,225,0,0,Buffalo,10,41,232,21,7,60,0,1,H,10,14,2,-51,10,14,165,0,-1,2003
75,75,08/30/2003,San Diego State,19,34,167,33,17,151,1,1,Eastern Washington,9,43,117,33,17,100,0,0,H, ,10,-9,50,0,0,51,1,1,2003
76,76,08/30/2003,San Jose State,3,28,77,36,19,98,2,1,Florida,65,32,167,41,27,357,1,1,V,-23.5,-62,-4,-90,-5,-8,-259,1,0,2003
77,77,08/30/2003,South Carolina,14,36,141,34,16,185,0,1,UL-Lafayette,7,35,138,27,12,134,1,2,H,23.5,7,1,3,7,4,51,-1,-1,2003
78,78,08/30/2003,South Florida,17,22,51,34,18,205,1,2,Alabama,40,48,188,27,14,203,0,1,V,-14.5,-23,-26,-137,7,4,2,1,1,2003
79,79,08/30/2003,Southern Cal,23,36,123,30,17,192,0,0,Auburn,0,36,43,26,12,121,1,2,V,-4,23,0,80,4,5,71,-1,-2,2003
80,80,08/30/2003,Southern Methodist,10,40,85,44,21,195,3,1,Texas Tech,58,23,123,41,26,314,1,1,V,-23,-48,17,-38,3,-5,-119,2,0,2003
81,81,08/30/2003,Southern Miss,2,36,65,34,20,212,1,0,California,34,48,260,18,11,157,0,1,V,-3.5,-32,-12,-195,16,9,55,1,-1,2003
82,82,08/30/2003,Temple,10,40,162,37,17,195,0,0,Penn State,23,41,231,19,6,79,1,0,V,-23,-13,-1,-69,18,11,116,-1,0,2003
83,83,08/30/2003,Tennessee,24,44,274,31,18,159,2,0,Fresno State,6,24,-1,24,13,118,0,0,H,19,18,20,275,7,5,41,2,0,2003
84,84,08/30/2003,Texas A & M,26,34,131,20,12,126,2,1,Arkansas State,11,38,114,20,11,94,1,1,H,29,15,-4,17,0,1,32,1,0,2003
85,85,08/30/2003,Texas Tech,58,23,123,41,26,314,1,1,Southern Methodist,10,40,85,44,21,195,3,1,H,23,48,-17,38,-3,5,119,-2,0,2003
86,86,08/30/2003,Texas-El Paso,7,33,71,43,21,204,1,2,Arizona,42,43,217,26,14,229,2,0,V,-21.5,-35,-10,-146,17,7,-25,-1,2,2003
87,87,08/30/2003,Troy State,5,37,39,30,11,99,2,1,Kansas State,41,43,147,24,10,245,2,1,V,-37.5,-36,-6,-108,6,1,-146,0,0,2003
88,88,08/30/2003,Tulsa,10,37,94,32,18,171,0,0,Minnesota,49,49,254,26,16,277,0,0,V,-33,-39,-12,-160,6,2,-106,0,0,2003
89,89,08/30/2003,UL-Lafayette,7,35,138,27,12,134,1,2,South Carolina,14,36,141,34,16,185,0,1,V,-23.5,-7,-1,-3,-7,-4,-51,1,1,2003
90,90,08/30/2003,UL-Monroe,7,26,59,34,15,181,1,1,Louisiana State,49,43,168,35,18,306,1,0,V,-34.5,-42,-17,-109,-1,-3,-125,0,1,2003
91,91,08/30/2003,Vanderbilt,14,38,101,33,21,298,1,1,Mississippi,20,33,95,33,22,275,0,1,H,-13,-6,5,6,0,-1,23,1,0,2003
92,92,08/30/2003,Virginia,27,41,204,22,12,169,0,0,Duke,0,35,152,29,11,120,0,0,H,14,27,6,52,-7,1,49,0,0,2003
93,93,08/30/2003,Wake Forest,32,40,160,23,13,149,2,1,Boston College,28,46,155,44,26,292,0,3,V,-10.5,4,-6,5,-21,-13,-143,2,-2,2003
94,94,08/30/2003,Washington,9,24,7,49,26,255,0,0,Ohio State,28,43,142,28,15,203,0,2,V,-9,-19,-19,-135,21,11,52,0,-2,2003
95,95,08/30/2003,Washington State,25,50,339,23,13,127,1,1,Idaho,0,26,83,36,16,167,3,0,N,26,25,24,256,-13,-3,-40,-2,1,2003
96,96,08/30/2003,West Virginia,17,38,162,26,15,138,0,0,Wisconsin,24,45,223,34,20,215,0,0,H,-5.5,-7,-7,-61,-8,-5,-77,0,0,2003
97,97,08/30/2003,Western Michigan,21,24,6,50,30,333,2,0,Michigan State,26,30,97,34,21,324,2,0,V,-14,-5,-6,-91,16,9,9,0,0,2003
98,98,08/30/2003,Wisconsin,24,45,223,34,20,215,0,0,West Virginia,17,38,162,26,15,138,0,0,V,5.5,7,7,61,8,5,77,0,0,2003
99,99,08/30/2003,Wyoming,21,30,31,28,17,202,0,1,Montana State,10,33,130,40,18,223,4,1,H, ,11,-3,-99,-12,-1,-21,-4,0,2003
100,100,08/31/2003,Kentucky,24,36,108,32,18,236,2,0,Louisville,40,44,240,23,14,180,1,0,H,7,-16,-8,-132,9,4,56,1,0,2003
101,101,08/31/2003,Louisville,40,44,240,23,14,180,1,0,Kentucky,24,36,108,32,18,236,2,0,V,-7,16,8,132,-9,-4,-56,-1,0,2003
102,102,08/31/2003,New Mexico State,7,55,150,15,8,75,3,2,Texas,66,33,168,16,8,216,0,1,V,-29,-59,22,-18,-1,0,-141,3,1,2003
103,103,08/31/2003,Texas,66,33,168,16,8,216,0,1,New Mexico State,7,55,150,15,8,75,3,2,H,29,59,-22,18,1,0,141,-3,-1,2003
104,104,08/31/2003,U-C-F,28,19,76,36,24,259,1,1,Virginia Tech,49,43,152,38,29,380,0,1,V,-20.5,-21,-24,-76,-2,-5,-121,1,0,2003
105,105,08/31/2003,Virginia Tech,49,43,152,38,29,380,0,1,U-C-F,28,19,76,36,24,259,1,1,H,20.5,21,24,76,2,5,121,-1,0,2003
106,106,09/01/2003,Cincinnati,40,56,361,27,14,128,0,2,East Carolina,3,32,57,26,16,146,1,0,H,8,37,24,304,1,-2,-18,-1,2,2003
107,107,09/01/2003,East Carolina,3,32,57,26,16,146,1,0,Cincinnati,40,56,361,27,14,128,0,2,V,-8,-37,-24,-304,-1,2,18,1,-2,2003
108,108,09/01/2003,Texas Christian,38,61,221,27,17,243,1,2,Tulane,35,26,66,43,25,303,2,0,V,5.5,3,35,155,-16,-8,-60,-1,2,2003
109,109,09/01/2003,Tulane,35,26,66,43,25,303,2,0,Texas Christian,38,61,221,27,17,243,1,2,H,-5.5,-3,-35,-155,16,8,60,1,-2,2003
110,110,09/04/2003,Alabama-Birmingham,12,32,114,37,23,262,0,4,Southern Miss,17,48,117,20,14,197,1,1,H,-2.5,-5,-16,-3,17,9,65,-1,3,2003
111,111,09/04/2003,Eastern Michigan,12,21,-2,44,26,252,0,1,Western Illinois,34,48,203,21,9,201,0,2,H, ,-22,-27,-205,23,17,51,0,-1,2003
112,112,09/04/2003,Southern Miss,17,48,117,20,14,197,1,1,Alabama-Birmingham,12,32,114,37,23,262,0,4,V,2.5,5,16,3,-17,-9,-65,1,-3,2003
113,113,09/05/2003,Fresno State,16,32,60,49,22,276,3,0,Oregon State,14,38,121,44,15,285,5,0,H,-8.5,2,-6,-61,5,7,-9,-2,0,2003
114,114,09/05/2003,Oregon State,14,38,121,44,15,285,5,0,Fresno State,16,32,60,49,22,276,3,0,V,8.5,-2,6,61,-5,-7,9,2,0,2003
115,115,09/06/2003,Air Force,22,53,270,12,6,139,0,2,Northwestern,21,41,218,38,15,234,4,0,V,7,1,12,52,-26,-9,-95,-4,2,2003
116,116,09/06/2003,Akron,31,40,162,52,31,372,2,0,Wisconsin,48,44,310,25,14,281,1,1,V,-24,-17,-4,-148,27,17,91,1,-1,2003
117,117,09/06/2003,Alabama,13,32,108,42,24,195,2,0,Oklahoma,20,27,74,36,22,281,0,0,H,-7.5,-7,5,34,6,2,-86,2,0,2003
118,118,09/06/2003,Arizona,13,27,91,32,10,91,2,1,Louisiana State,59,56,182,25,19,299,1,3,H,-11.5,-46,-29,-91,7,-9,-208,1,-2,2003
119,119,09/06/2003,Arizona State,34,31,137,26,16,234,0,1,Northern Arizona,14,36,57,40,25,315,1,0,H, ,20,-5,80,-14,-9,-81,-1,1,2003
120,120,09/06/2003,Arkansas,45,37,294,20,11,188,0,0,Tulsa,13,39,212,36,16,159,1,0,H,36.5,32,-2,82,-16,-5,29,-1,0,2003
121,121,09/06/2003,Arkansas State,63,44,437,19,8,90,0,2,Tennessee-Martin,6,32,73,34,20,180,0,2,H, ,57,12,364,-15,-12,-90,0,0,2003
122,122,09/06/2003,Army,21,37,44,51,26,200,1,0,Connecticut,48,31,164,36,26,317,2,0,H,-16.5,-27,6,-120,15,0,-117,-1,0,2003
123,123,09/06/2003,Auburn,3,38,40,33,20,190,1,1,Georgia Tech,17,39,102,21,9,149,0,1,V,9,-14,-1,-62,12,11,41,1,0,2003
124,124,09/06/2003,Ball State,7,28,41,34,23,203,0,0,Missouri,35,47,290,29,18,171,0,0,H,-15,-28,-19,-249,5,5,32,0,0,2003
125,125,09/06/2003,Baylor,14,33,85,29,19,183,3,3,North Texas,52,47,327,15,9,124,1,1,V,-14,-38,-14,-242,14,10,59,2,2,2003
126,126,09/06/2003,Boise State,62,47,259,39,20,328,0,2,Idaho State,0,17,6,53,23,146,2,1,H, ,62,30,253,-14,-3,182,-2,1,2003
127,127,09/06/2003,Boston College,27,46,238,22,10,145,1,0,Penn State,14,38,133,39,19,185,1,2,V,-9,13,8,105,-17,-9,-40,0,-2,2003
128,128,09/06/2003,Bowling Green,27,41,50,40,22,357,1,0,Purdue,26,28,95,42,26,255,0,1,V,-12,1,13,-45,-2,-4,102,1,-1,2003
129,129,09/06/2003,Brigham Young,18,26,46,46,29,313,3,2,Southern Cal,35,33,71,34,19,235,3,0,V,-21.5,-17,-7,-25,12,10,78,0,2,2003
130,130,09/06/2003,Buffalo,7,56,227,19,7,58,1,2,Iowa,56,45,292,19,12,150,0,0,V,-34,-49,11,-65,0,-5,-92,1,2,2003
131,131,09/06/2003,California,21,31,51,35,23,248,2,0,Colorado State,23,39,131,24,15,317,1,1,H,2.5,-2,-8,-80,11,8,-69,1,-1,2003
132,132,09/06/2003,Central Michigan,40,60,352,28,19,172,0,2,New Hampshire,33,38,149,44,25,212,1,1,H, ,7,22,203,-16,-6,-40,-1,1,2003
133,133,09/06/2003,Clemson,28,40,124,31,23,301,1,0,Furman,17,48,94,15,10,80,0,1,H, ,11,-8,30,16,13,221,1,-1,2003
134,134,09/06/2003,Colorado,16,47,88,31,21,157,0,1,U.C.L.A.,14,26,38,30,17,205,0,1,H,2.5,2,21,50,1,4,-48,0,0,2003
135,135,09/06/2003,Colorado State,23,39,131,24,15,317,1,1,California,21,31,51,35,23,248,2,0,V,-2.5,2,8,80,-11,-8,69,-1,1,2003
136,136,09/06/2003,Connecticut,48,31,164,36,26,317,2,0,Army,21,37,44,51,26,200,1,0,V,16.5,27,-6,120,-15,0,117,1,0,2003
137,137,09/06/2003,Duke,29,57,215,29,18,181,0,0,Western Carolina,3,19,4,33,18,181,3,1,H, ,26,38,211,-4,0,0,-3,-1,2003
138,138,09/06/2003,East Carolina,7,36,102,38,25,226,2,3,West Virginia,48,48,361,18,11,194,0,0,H,-10,-41,-12,-259,20,14,32,2,3,2003
139,139,09/06/2003,Florida,33,39,178,27,18,219,1,0,Miami-Florida,38,30,114,41,27,340,2,2,V,-14,-5,9,64,-14,-9,-121,-1,-2,2003
140,140,09/06/2003,Florida State,35,46,196,30,17,231,1,0,Maryland,10,31,73,31,14,124,1,2,H,15,25,15,123,-1,3,107,0,-2,2003
141,141,09/06/2003,Georgia,29,36,150,35,25,317,0,0,Mid Tennessee St,10,27,67,25,18,173,0,1,H,29,19,9,83,10,7,144,0,-1,2003
142,142,09/06/2003,Georgia Tech,17,39,102,21,9,149,0,1,Auburn,3,38,40,33,20,190,1,1,H,-9,14,1,62,-12,-11,-41,-1,0,2003
143,143,09/06/2003,Houston,3,28,74,31,15,64,0,1,Michigan,50,51,392,31,14,144,0,0,V,-27.5,-47,-23,-318,0,1,-80,0,1,2003
144,144,09/06/2003,Idaho,5,37,142,39,17,153,0,2,Eastern Washington,8,29,31,34,20,193,0,2,H, ,-3,8,111,5,-3,-40,0,0,2003
145,145,09/06/2003,Illinois,49,41,254,24,16,207,1,0,Illinois State,22,29,126,56,33,385,0,2,H, ,27,12,128,-32,-17,-178,1,-2,2003
146,146,09/06/2003,Indiana,13,40,85,30,16,199,1,1,Washington,38,52,195,27,19,295,1,2,V,-25.5,-25,-12,-110,3,-3,-96,0,-1,2003
147,147,09/06/2003,Iowa,56,45,292,19,12,150,0,0,Buffalo,7,56,227,19,7,58,1,2,H,34,49,-11,65,0,5,92,-1,-2,2003
148,148,09/06/2003,Iowa State,48,51,271,27,14,252,0,0,Ohio,20,38,167,22,12,237,0,2,H,18.5,28,13,104,5,2,15,0,-2,2003
149,149,09/06/2003,Kansas,46,48,276,31,22,270,1,1,Nevada-Las Vegas,24,34,257,30,17,177,2,-1,H,-10,22,14,19,1,5,93,-1,2,2003
150,150,09/06/2003,Kansas State,55,44,254,21,8,146,1,0,McNeese State,14,45,122,31,11,145,2,1,H, ,41,-1,132,-10,-3,1,-1,-1,2003
151,151,09/06/2003,Kent State,3,36,73,28,12,88,1,1,Pittsburgh,43,45,202,36,20,320,0,1,V,-28.5,-40,-9,-129,-8,-8,-232,1,0,2003
152,152,09/06/2003,Kentucky,37,29,103,24,15,205,1,0,Murray State,6,40,85,30,14,104,1,1,H, ,31,-11,18,-6,1,101,0,-1,2003
153,153,09/06/2003,Louisiana State,59,56,182,25,19,299,1,3,Arizona,13,27,91,32,10,91,2,1,V,11.5,46,29,91,-7,9,208,-1,2,2003
154,154,09/06/2003,Louisiana Tech,34,39,149,35,21,300,1,1,UL-Lafayette,3,23,95,39,24,197,1,2,V,4,31,16,54,-4,-3,103,0,-1,2003
155,155,09/06/2003,Marshall,24,31,88,34,23,294,1,0,Tennessee,34,40,223,33,21,235,1,0,V,-20.5,-10,-9,-135,1,2,59,0,0,2003
156,156,09/06/2003,Maryland,10,31,73,31,14,124,1,2,Florida State,35,46,196,30,17,231,1,0,V,-15,-25,-15,-123,1,-3,-107,0,2,2003
157,157,09/06/2003,Memphis,44,36,117,34,19,389,0,2,Mississippi,34,30,116,48,26,292,2,1,H,-8,10,6,1,-14,-7,97,-2,1,2003
158,158,09/06/2003,Miami-Florida,38,30,114,41,27,340,2,2,Florida,33,39,144,27,18,253,1,0,H,14,5,-9,-30,14,9,87,1,2,2003
159,159,09/06/2003,Michigan,50,51,392,31,14,144,0,0,Houston,3,28,74,31,15,64,0,1,H,27.5,47,23,318,0,-1,80,0,-1,2003
160,160,09/06/2003,Michigan State,44,40,134,34,21,351,2,1,Rutgers,28,36,-2,31,14,266,2,0,H,19,16,4,136,3,7,85,0,1,2003
161,161,09/06/2003,Mid Tennessee St,10,27,67,25,18,173,0,1,Georgia,29,36,150,35,25,317,0,0,V,-29,-19,-9,-83,-10,-7,-144,0,1,2003
162,162,09/06/2003,Minnesota,48,55,292,18,11,176,2,0,Troy State,7,40,125,31,10,64,0,2,H,27,41,15,167,-13,1,112,2,-2,2003
163,163,09/06/2003,Mississippi,34,30,116,48,26,292,2,1,Memphis,44,36,117,34,19,389,0,2,V,8,-10,-6,-1,14,7,-97,2,-1,2003
164,164,09/06/2003,Missouri,35,47,290,29,18,171,0,0,Ball State,7,28,41,34,23,203,0,0,V,15,28,19,249,-5,-5,-32,0,0,2003
165,165,09/06/2003,Navy,3,54,132,15,7,75,1,1,Texas Christian,17,45,161,20,14,173,1,2,V,-21.5,-14,9,-29,-5,-7,-98,0,-1,2003
166,166,09/06/2003,Nebraska,31,64,273,17,12,132,0,2,Utah State,7,23,60,35,17,178,1,2,H,32,24,41,213,-18,-5,-46,-1,0,2003
167,167,09/06/2003,Nevada-Las Vegas,24,35,244,30,17,177,2,0,Kansas,46,48,276,31,22,270,1,1,V,10,-22,-13,-32,-1,-5,-93,1,-1,2003
168,168,09/06/2003,Nevada-Reno,23,30,57,42,17,244,2,0,Oregon,31,42,192,27,12,207,0,2,V,-22,-8,-12,-135,15,5,37,2,-2,2003
169,169,09/06/2003,New Mexico,28,51,235,42,22,349,3,1,Texas Tech,42,19,38,54,37,418,1,2,V,-13.5,-14,32,197,-12,-15,-69,2,-1,2003
170,170,09/06/2003,New Mexico State,48,58,290,17,12,175,1,1,Western New Mexico,3,23,58,28,13,120,1,0,H, ,45,35,232,-11,-1,55,0,1,2003
171,171,09/06/2003,No Carolina State,24,25,78,49,38,433,2,0,Wake Forest,38,50,202,11,9,173,0,0,V,9,-14,-25,-124,38,29,260,2,0,2003
172,172,09/06/2003,North Carolina,47,42,165,45,32,340,1,1,Syracuse,49,47,230,33,20,288,0,0,H,-1,-2,-5,-65,12,12,52,1,1,2003
173,173,09/06/2003,North Texas,52,47,327,15,9,124,1,1,Baylor,14,33,85,29,19,183,3,3,H,14,38,14,242,-14,-10,-59,-2,-2,2003
174,174,09/06/2003,Northern Illinois,42,40,160,29,18,261,0,1,Tennessee Tech,17,34,92,42,23,353,2,1,H, ,25,6,68,-13,-5,-92,-2,0,2003
175,175,09/06/2003,Northwestern,21,40,231,38,15,234,4,-1,Air Force,22,53,270,12,6,139,0,2,H,-7,-1,-13,-39,26,9,95,4,-3,2003
176,176,09/06/2003,Notre Dame,29,45,163,34,21,149,1,3,Washington State,26,31,55,39,22,274,1,2,H,6,3,14,108,-5,-1,-125,0,1,2003
177,177,09/06/2003,Ohio,20,38,167,22,12,237,0,2,Iowa State,48,51,271,27,14,252,0,0,V,-18.5,-28,-13,-104,-5,-2,-15,0,2,2003
178,178,09/06/2003,Ohio State,16,37,120,20,5,76,1,1,San Diego State,13,26,28,41,24,188,2,2,H,30.5,3,11,92,-21,-19,-112,-1,-1,2003
179,179,09/06/2003,Oklahoma,20,27,74,36,22,281,0,0,Alabama,13,32,108,42,24,195,2,0,V,7.5,7,-5,-34,-6,-2,86,-2,0,2003
180,180,09/06/2003,Oklahoma State,48,50,334,33,19,260,0,0,Wyoming,24,29,75,38,17,306,0,0,H,22,24,21,259,-5,2,-46,0,0,2003
181,181,09/06/2003,Oregon,31,41,188,28,13,211,0,2,Nevada-Reno,23,30,57,42,17,244,2,0,H,22,8,11,131,-14,-4,-33,-2,2,2003
182,182,09/06/2003,Penn State,14,38,133,39,19,185,1,2,Boston College,27,46,238,22,10,145,1,0,H,9,-13,-8,-105,17,9,40,0,2,2003
183,183,09/06/2003,Pittsburgh,43,45,202,36,20,320,0,1,Kent State,3,36,73,28,12,88,1,1,H,28.5,40,9,129,8,8,232,-1,0,2003
184,184,09/06/2003,Purdue,26,28,95,42,26,255,0,1,Bowling Green,27,41,50,40,22,357,1,0,H,12,-1,-13,45,2,4,-102,-1,1,2003
185,185,09/06/2003,Rutgers,28,36,-2,31,14,266,2,0,Michigan State,44,40,134,34,21,351,2,1,V,-19,-16,-4,-136,-3,-7,-85,0,-1,2003
186,186,09/06/2003,San Diego State,13,26,28,41,24,188,2,2,Ohio State,16,37,120,20,5,76,1,1,V,-30.5,-3,-11,-92,21,19,112,1,1,2003
187,187,09/06/2003,San Jose State,10,16,9,67,28,261,1,1,Stanford,31,41,164,45,24,293,2,1,V,-10,-21,-25,-155,22,4,-32,-1,0,2003
188,188,09/06/2003,South Carolina,31,49,261,24,9,162,1,0,Virginia,7,38,112,20,10,54,2,1,H,-3,24,11,149,4,-1,108,-1,-1,2003
189,189,09/06/2003,South Florida,27,42,242,31,16,288,1,2,Nicholls State,17,56,267,12,5,48,0,0,H, ,10,-14,-25,19,11,240,1,2,2003
190,190,09/06/2003,Southern Cal,35,33,71,34,19,235,3,0,Brigham Young,18,26,46,46,29,313,3,2,H,21.5,17,7,25,-12,-10,-78,0,-2,2003
191,191,09/06/2003,Stanford,31,41,164,45,24,293,2,1,San Jose State,10,16,9,67,28,261,1,1,H,10,21,25,155,-22,-4,32,1,0,2003
192,192,09/06/2003,Syracuse,49,47,230,33,20,288,0,0,North Carolina,47,42,165,45,32,340,1,1,V,1,2,5,65,-12,-12,-52,-1,-1,2003
193,193,09/06/2003,Temple,20,46,94,28,18,264,0,1,Villanova,23,31,53,37,28,347,0,2,H, ,-3,15,41,-9,-10,-83,0,-1,2003
194,194,09/06/2003,Tennessee,34,40,223,33,21,235,1,0,Marshall,24,31,88,34,23,294,1,0,H,20.5,10,9,135,-1,-2,-59,0,0,2003
195,195,09/06/2003,Texas A & M,28,38,223,18,12,145,0,3,Utah,26,57,205,40,18,210,0,3,H,9.5,2,-19,18,-22,-6,-65,0,0,2003
196,196,09/06/2003,Texas Christian,17,45,161,20,14,173,1,2,Navy,3,54,132,15,7,75,1,1,H,21.5,14,-9,29,5,7,98,0,1,2003
197,197,09/06/2003,Texas Tech,42,19,38,54,37,418,1,2,New Mexico,28,51,235,42,22,349,3,1,H,13.5,14,-32,-197,12,15,69,-2,1,2003
198,198,09/06/2003,Texas-El Paso,13,36,115,25,13,141,2,3,Cal-San Luis Obispo,34,50,170,23,14,281,0,1,H, ,-21,-14,-55,2,-1,-140,2,2,2003
199,199,09/06/2003,Toledo,49,35,197,28,23,304,0,0,Liberty,3,39,132,33,16,165,2,0,H, ,46,-4,65,-5,7,139,-2,0,2003
200,200,09/06/2003,Troy State,7,40,125,31,10,64,0,2,Minnesota,48,55,292,18,11,176,2,0,V,-27,-41,-15,-167,13,-1,-112,-2,2,2003
201,201,09/06/2003,Tulane,27,24,83,48,29,353,1,2,Northwestern St(LA),24,50,229,40,20,261,1,0,H, ,3,-26,-146,8,9,92,0,2,2003
202,202,09/06/2003,Tulsa,13,39,212,36,16,159,1,0,Arkansas,45,37,294,20,11,188,0,0,V,-36.5,-32,2,-82,16,5,-29,1,0,2003
203,203,09/06/2003,U.C.L.A.,14,26,38,30,17,205,0,1,Colorado,16,47,88,31,21,157,0,1,V,-2.5,-2,-21,-50,-1,-4,48,0,0,2003
204,204,09/06/2003,UL-Lafayette,3,23,91,39,24,197,1,2,Louisiana Tech,34,39,183,35,21,266,1,1,H,-4,-31,-16,-92,4,3,-69,0,1,2003
205,205,09/06/2003,UL-Monroe,21,36,149,40,21,201,2,1,Stephen F Austin,23,39,184,23,9,162,0,1,H, ,-2,-3,-35,17,12,39,2,0,2003
206,206,09/06/2003,Utah,26,57,205,40,18,210,0,3,Texas A & M,28,38,223,18,12,145,0,3,V,-9.5,-2,19,-18,22,6,65,0,0,2003
207,207,09/06/2003,Utah State,7,23,60,35,17,178,1,2,Nebraska,31,64,273,17,12,132,0,2,V,-32,-24,-41,-213,18,5,46,1,0,2003
208,208,09/06/2003,Vanderbilt,51,58,284,23,14,255,1,1,Chattanooga,6,23,28,25,12,65,1,2,H, ,45,35,256,-2,2,190,0,-1,2003
209,209,09/06/2003,Virginia,7,38,116,20,10,54,2,1,South Carolina,31,49,261,24,9,162,1,0,V,3,-24,-11,-145,-4,1,-108,1,1,2003
210,210,09/06/2003,Virginia Tech,43,53,303,22,14,184,0,2,James Madison,0,36,18,16,8,125,1,2,H, ,43,17,285,6,6,59,-1,0,2003
211,211,09/06/2003,Wake Forest,38,50,202,11,9,173,0,0,No Carolina State,24,25,78,49,38,433,2,0,H,-9,14,25,124,-38,-29,-260,-2,0,2003
212,212,09/06/2003,Washington,38,52,195,27,19,295,1,2,Indiana,13,40,85,30,16,199,1,1,H,25.5,25,12,110,-3,3,96,0,1,2003
213,213,09/06/2003,Washington State,26,31,55,39,22,274,1,2,Notre Dame,29,45,163,34,21,149,1,3,V,-6,-3,-14,-108,5,1,125,0,-1,2003
214,214,09/06/2003,West Virginia,48,48,361,18,11,194,0,0,East Carolina,7,36,102,38,25,226,2,3,V,10,41,12,259,-20,-14,-32,-2,-3,2003
215,215,09/06/2003,Western Michigan,42,31,149,39,27,489,1,2,William & Mary,21,42,158,32,19,191,1,0,H, ,21,-11,-9,7,8,298,0,2,2003
216,216,09/06/2003,Wisconsin,48,44,310,25,14,281,1,1,Akron,31,40,162,52,31,372,2,0,H,24,17,4,148,-27,-17,-91,-1,1,2003
217,217,09/06/2003,Wyoming,24,29,75,38,17,307,0,0,Oklahoma State,48,50,334,32,19,260,0,0,V,-22,-24,-21,-259,6,-2,47,0,0,2003
218,218,09/11/2003,California,24,34,119,32,19,246,0,3,Utah,31,48,200,28,18,136,0,2,V,0,-7,-14,-81,4,1,110,0,1,2003
219,219,09/11/2003,Utah,31,48,200,28,18,136,0,2,California,24,34,119,32,19,246,0,3,H,0,7,14,81,-4,-1,-110,0,-1,2003
220,220,09/12/2003,Marshall,17,42,139,39,31,289,2,3,Toledo,24,47,269,20,10,147,0,0,H,6,-7,-5,-130,19,21,142,2,3,2003
221,221,09/12/2003,Toledo,24,47,269,20,10,147,0,0,Marshall,17,42,139,39,31,289,2,3,V,-6,7,5,130,-19,-21,-142,-2,-3,2003
222,222,09/13/2003,Air Force,34,60,271,16,10,156,1,3,North Texas,21,35,45,22,13,215,2,1,H,10,13,25,226,-6,-3,-59,-1,2,2003
223,223,09/13/2003,Akron,24,44,168,33,22,303,1,1,Eastern Michigan,17,27,59,47,25,225,1,0,H,20,7,17,109,-14,-3,78,0,1,2003
224,224,09/13/2003,Alabama,27,53,266,27,14,198,1,0,Kentucky,17,23,26,24,15,169,0,0,H,13.5,10,30,240,3,-1,29,1,0,2003
225,225,09/13/2003,Alabama-Birmingham,9,28,89,38,20,248,2,3,Troy State,20,51,256,18,11,131,2,1,H,10.5,-11,-23,-167,20,9,117,0,2,2003
226,226,09/13/2003,Arizona,10,25,34,36,16,146,0,1,Oregon,48,56,210,32,22,283,0,1,H,-12.5,-38,-31,-176,4,-6,-137,0,0,2003
227,227,09/13/2003,Arizona State,26,37,161,37,20,277,1,3,Utah State,16,35,65,54,26,308,3,0,H,26.5,10,2,96,-17,-6,-31,-2,3,2003
228,228,09/13/2003,Arkansas,38,60,265,18,9,173,0,1,Texas,28,29,62,40,21,264,0,3,V,-14,10,31,203,-22,-12,-91,0,-2,2003
229,229,09/13/2003,Arkansas State,21,40,101,22,13,211,1,0,S E Missouri St,3,23,59,40,24,200,2,0,H, ,18,17,42,-18,-11,11,-1,0,2003
230,230,09/13/2003,Army,21,30,55,48,24,251,1,3,Rutgers,36,45,177,26,17,250,1,1,H,-7.5,-15,-15,-122,22,7,1,0,2,2003
231,231,09/13/2003,Auburn,45,54,219,26,17,264,0,0,Vanderbilt,7,35,97,23,11,124,1,2,V,11.5,38,19,122,3,6,140,-1,-2,2003
232,232,09/13/2003,Ball State,21,37,92,30,19,192,0,0,Pittsburgh,42,36,188,33,19,285,0,0,V,-30.5,-21,1,-96,-3,0,-93,0,0,2003
233,233,09/13/2003,Baylor,10,39,80,27,12,102,1,1,Southern Methodist,7,34,98,26,12,106,1,1,H,-1,3,5,-18,1,0,-4,0,0,2003
234,234,09/13/2003,Boise State,24,43,263,25,15,165,0,2,Idaho,10,29,55,51,25,273,0,1,V,25.5,14,14,208,-26,-10,-108,0,1,2003
235,235,09/13/2003,Boston College,24,41,193,29,15,151,1,0,Connecticut,14,34,128,55,26,258,3,0,V,3.5,10,7,65,-26,-11,-107,-2,0,2003
236,236,09/13/2003,Bowling Green,62,49,367,25,18,308,0,0,Liberty,3,34,57,31,13,192,0,1,H, ,59,15,310,-6,5,116,0,-1,2003
237,237,09/13/2003,Brigham Young,10,29,136,37,20,172,0,0,New Mexico,7,48,171,24,11,141,0,1,V,1,3,-19,-35,13,9,31,0,-1,2003
238,238,09/13/2003,Buffalo,15,37,119,24,13,124,0,1,Colgate,38,54,358,29,19,263,0,0,H, ,-23,-17,-239,-5,-6,-139,0,1,2003
239,239,09/13/2003,Central Michigan,42,38,139,32,18,234,1,0,Eastern Kentucky,41,52,218,34,24,396,2,1,H, ,1,-14,-79,-2,-6,-162,-1,-1,2003
240,240,09/13/2003,Cincinnati,15,49,165,36,17,146,0,5,West Virginia,13,40,118,31,10,125,2,3,V,-6.5,2,9,47,5,7,21,-2,2,2003
241,241,09/13/2003,Clemson,37,44,183,28,23,298,0,0,Mid Tennessee St,14,38,194,26,15,170,1,0,H,14,23,6,-11,2,8,128,-1,0,2003
242,242,09/13/2003,Colorado,26,34,97,55,32,348,2,3,Washington State,47,33,153,33,17,310,1,0,H,4.5,-21,1,-56,22,15,38,1,3,2003
243,243,09/13/2003,Colorado State,31,50,261,32,21,233,1,2,Weber State,7,25,79,24,12,133,1,0,H, ,24,25,182,8,9,100,0,2,2003
244,244,09/13/2003,Connecticut,14,34,128,55,26,258,3,0,Boston College,24,41,193,29,15,151,1,0,H,-3.5,-10,-7,-65,26,11,107,2,0,2003
245,245,09/13/2003,Duke,27,43,222,32,16,188,1,1,Rice,24,64,346,20,6,61,0,2,H,13.5,3,-21,-124,12,10,127,1,-1,2003
246,246,09/13/2003,East Carolina,3,36,103,24,16,126,2,3,Miami-Florida,38,38,234,26,16,215,1,1,V,-41,-35,-2,-131,-2,0,-89,1,2,2003
247,247,09/13/2003,Eastern Michigan,17,27,59,47,25,225,1,0,Akron,24,44,168,33,22,303,1,1,V,-20,-7,-17,-109,14,3,-78,0,-1,2003
248,248,09/13/2003,Florida,63,45,309,22,17,227,1,1,Florida A & M,3,46,175,32,15,93,1,2,H, ,60,-1,134,-10,2,134,0,-1,2003
249,249,09/13/2003,Florida State,14,32,91,30,15,160,2,1,Georgia Tech,13,39,112,25,12,128,1,2,H,23.5,1,-7,-21,5,3,32,1,-1,2003
250,250,09/13/2003,Fresno State,28,22,123,31,20,142,1,0,Oklahoma,52,48,212,38,26,344,0,0,V,-28,-24,-26,-89,-7,-6,-202,1,0,2003
251,251,09/13/2003,Georgia,31,34,165,29,17,213,0,1,South Carolina,7,37,111,36,16,239,3,0,H,13,24,-3,54,-7,1,-26,-3,1,2003
252,252,09/13/2003,Georgia Tech,13,39,112,25,12,128,1,2,Florida State,14,32,91,30,15,160,2,1,V,-23.5,-1,7,21,-5,-3,-32,-1,1,2003
253,253,09/13/2003,Hawaii,32,16,63,67,40,399,2,1,Southern Cal,61,33,164,26,18,254,0,2,V,-20.5,-29,-17,-101,41,22,145,2,-1,2003
254,254,09/13/2003,Houston,21,51,256,18,8,157,1,4,UL-Lafayette,14,40,139,22,5,57,0,1,V,7,7,11,117,-4,3,100,1,3,2003
255,255,09/13/2003,Idaho,10,29,55,51,25,273,0,1,Boise State,24,43,263,25,15,165,0,2,H,-25.5,-14,-14,-208,26,10,108,0,-1,2003
256,256,09/13/2003,Illinois,3,26,67,42,26,216,3,1,U.C.L.A.,6,35,110,31,11,94,1,0,V,-9.5,-3,-9,-43,11,15,122,2,1,2003
257,257,09/13/2003,Indiana,33,49,196,20,12,146,0,1,Indiana State,3,37,105,27,17,189,1,2,H, ,30,12,91,-7,-5,-43,-1,-1,2003
258,258,09/13/2003,Iowa,40,37,171,14,7,72,0,1,Iowa State,21,40,71,45,26,319,1,1,V,5.5,19,-3,100,-31,-19,-247,-1,0,2003
259,259,09/13/2003,Iowa State,21,40,71,45,26,319,1,1,Iowa,40,37,171,14,7,72,0,1,H,-5.5,-19,3,-100,31,19,247,1,0,2003
260,260,09/13/2003,Kansas,42,40,162,16,13,295,0,1,Wyoming,35,36,179,46,33,328,0,2,V,-4.5,7,4,-17,-30,-20,-33,0,-1,2003
261,261,09/13/2003,Kansas State,38,50,235,28,18,255,3,1,Massachusetts,7,30,27,27,14,164,0,1,H, ,31,20,208,1,4,91,3,0,2003
262,262,09/13/2003,Kent State,16,65,282,23,11,124,2,1,Youngstown State,13,41,180,20,10,114,1,3,H, ,3,24,102,3,1,10,1,-2,2003
263,263,09/13/2003,Kentucky,17,23,26,24,15,169,0,0,Alabama,27,53,266,27,14,198,1,0,V,-13.5,-10,-30,-240,-3,1,-29,-1,0,2003
264,264,09/13/2003,Louisiana State,35,43,152,32,23,305,0,3,Western Illinois,7,25,13,39,17,195,3,0,H, ,28,18,139,-7,6,110,-3,3,2003
265,265,09/13/2003,Louisiana Tech,20,19,61,63,35,436,3,2,Michigan State,19,42,169,30,19,192,0,0,V,-12,1,-23,-108,33,16,244,3,2,2003
266,266,09/13/2003,Louisville,30,39,185,25,16,266,1,0,Syracuse,20,41,217,30,19,229,0,2,V,-3,10,-2,-32,-5,-3,37,1,-2,2003
267,267,09/13/2003,Maryland,61,53,282,27,17,283,0,0,The Citadel,0,31,90,20,3,47,1,0,H, ,61,22,192,7,14,236,-1,0,2003
268,268,09/13/2003,Memphis,6,39,192,36,16,182,3,3,Southern Miss,23,49,205,25,7,102,1,2,V,-4,-17,-10,-13,11,9,80,2,1,2003
269,269,09/13/2003,Miami-Florida,38,38,234,26,16,215,1,1,East Carolina,3,36,103,24,16,126,2,3,H,41,35,2,131,2,0,89,-1,-2,2003
270,270,09/13/2003,Miami-Ohio,44,38,147,41,29,368,0,0,Northwestern,14,27,41,44,22,273,1,0,V,2.5,30,11,106,-3,7,95,-1,0,2003
271,271,09/13/2003,Michigan,38,54,188,24,17,251,0,3,Notre Dame,0,25,49,24,8,91,2,0,H,10.5,38,29,139,0,9,160,-2,3,2003
272,272,09/13/2003,Michigan State,19,42,169,30,19,192,0,0,Louisiana Tech,20,19,61,63,35,436,3,2,H,12,-1,23,108,-33,-16,-244,-3,-2,2003
273,273,09/13/2003,Mid Tennessee St,14,38,194,26,15,170,1,0,Clemson,37,44,183,28,23,298,0,0,V,-14,-23,-6,11,-2,-8,-128,1,0,2003
274,274,09/13/2003,Minnesota,42,50,269,15,9,146,1,1,Ohio,20,52,222,22,14,123,1,1,V,20.5,22,-2,47,-7,-5,23,0,0,2003
275,275,09/13/2003,Mississippi,59,47,225,30,24,387,0,1,UL-Monroe,14,31,29,44,26,307,2,1,H,26.5,45,16,196,-14,-2,80,-2,0,2003
276,276,09/13/2003,Mississippi State,28,37,225,33,16,246,0,3,Tulane,31,31,112,47,29,349,0,0,V,3.5,-3,6,113,-14,-13,-103,0,3,2003
277,277,09/13/2003,Missouri,37,36,221,38,30,288,0,2,Eastern Illinois,0,32,67,36,23,154,1,3,H, ,37,4,154,2,7,134,-1,-1,2003
278,278,09/13/2003,Nebraska,18,72,337,6,4,60,1,1,Penn State,10,21,44,33,16,159,1,1,H,10.5,8,51,293,-27,-12,-99,0,0,2003
279,279,09/13/2003,Nevada-Las Vegas,23,37,94,25,12,93,0,1,Wisconsin,5,42,52,30,13,239,2,3,V,-20.5,18,-5,42,-5,-1,-146,-2,-2,2003
280,280,09/13/2003,New Mexico,7,48,171,24,11,141,0,1,Brigham Young,10,29,136,37,20,172,0,0,H,-1,-3,19,35,-13,-9,-31,0,1,2003
281,281,09/13/2003,New Mexico State,16,42,143,22,10,116,0,1,Oregon State,28,51,221,30,17,233,2,1,V,-24,-12,-9,-78,-8,-7,-117,-2,0,2003
282,282,09/13/2003,No Carolina State,38,30,21,52,36,315,2,1,Ohio State,44,32,44,36,26,273,3,2,V,-8.5,-6,-2,-23,16,10,42,-1,-1,2003
283,283,09/13/2003,North Texas,21,35,45,22,13,215,2,1,Air Force,34,60,271,16,10,156,1,3,V,-10,-13,-25,-226,6,3,59,1,-2,2003
284,284,09/13/2003,Northwestern,14,27,41,44,22,273,1,0,Miami-Ohio,44,38,147,41,29,368,0,0,H,-2.5,-30,-11,-106,3,-7,-95,1,0,2003
285,285,09/13/2003,Notre Dame,0,25,53,24,8,91,2,0,Michigan,38,54,188,24,17,251,0,3,V,-10.5,-38,-29,-135,0,-9,-160,2,-3,2003
286,286,09/13/2003,Ohio,20,52,222,22,14,123,1,1,Minnesota,42,50,269,15,9,146,1,1,H,-20.5,-22,2,-47,7,5,-23,0,0,2003
287,287,09/13/2003,Ohio State,44,32,44,36,26,273,3,2,No Carolina State,38,30,21,52,36,315,2,1,H,8.5,6,2,23,-16,-10,-42,1,1,2003
288,288,09/13/2003,Oklahoma,52,48,212,38,26,344,0,0,Fresno State,28,22,123,31,20,142,1,0,H,28,24,26,89,7,6,202,-1,0,2003
289,289,09/13/2003,Oklahoma State,42,34,264,26,14,153,2,1,S W Missouri St,3,46,102,26,14,117,2,0,H, ,39,-12,162,0,0,36,0,1,2003
290,290,09/13/2003,Oregon,48,56,210,32,22,283,0,1,Arizona,10,25,34,36,16,146,0,1,V,12.5,38,31,176,-4,6,137,0,0,2003
291,291,09/13/2003,Oregon State,28,51,221,30,17,233,2,1,New Mexico State,16,42,143,22,10,116,0,1,H,24,12,9,78,8,7,117,2,0,2003
292,292,09/13/2003,Penn State,10,21,44,33,16,159,1,1,Nebraska,18,72,337,6,4,60,1,1,V,-10.5,-8,-51,-293,27,12,99,0,0,2003
293,293,09/13/2003,Pittsburgh,42,36,188,33,19,285,0,0,Ball State,21,37,92,30,19,192,0,0,H,30.5,21,-1,96,3,0,93,0,0,2003
294,294,09/13/2003,Purdue,16,37,116,36,26,227,0,1,Wake Forest,10,34,56,30,18,188,1,0,V,2.5,6,3,60,6,8,39,-1,1,2003
295,295,09/13/2003,Rice,24,64,346,20,6,61,0,2,Duke,27,43,222,32,16,188,1,1,V,-13.5,-3,21,124,-12,-10,-127,-1,1,2003
296,296,09/13/2003,Rutgers,36,45,177,26,17,250,1,1,Army,21,30,55,48,24,251,1,3,V,7.5,15,15,122,-22,-7,-1,0,-2,2003
297,297,09/13/2003,San Diego State,34,34,137,29,18,180,0,2,Texas-El Paso,0,44,124,40,15,137,3,3,V,18.5,34,-10,13,-11,3,43,-3,-1,2003
298,298,09/13/2003,South Carolina,7,37,111,36,16,239,3,0,Georgia,31,34,165,29,17,213,0,1,V,-13,-24,3,-54,7,-1,26,3,-1,2003
299,299,09/13/2003,Southern Cal,61,33,164,26,18,254,0,2,Hawaii,32,16,63,67,40,399,2,1,H,20.5,29,17,101,-41,-22,-145,-2,1,2003
300,300,09/13/2003,Southern Methodist,7,34,98,26,12,106,1,1,Baylor,10,39,80,27,12,102,1,1,V,1,-3,-5,18,-1,0,4,0,0,2003
301,301,09/13/2003,Southern Miss,23,49,205,25,7,102,1,2,Memphis,6,39,192,36,16,182,3,3,H,4,17,10,13,-11,-9,-80,-2,-1,2003
302,302,09/13/2003,Syracuse,20,41,217,30,19,229,0,2,Louisville,30,39,185,25,16,266,1,0,H,3,-10,2,32,5,3,-37,-1,2,2003
303,303,09/13/2003,Texas,28,29,62,40,21,264,0,3,Arkansas,38,60,265,18,9,173,0,1,H,14,-10,-31,-203,22,12,91,0,2,2003
304,304,09/13/2003,Texas-El Paso,0,44,124,40,15,137,3,3,San Diego State,34,37,189,27,16,138,0,2,H,-18.5,-34,7,-65,13,-1,-1,3,1,2003
305,305,09/13/2003,Troy State,20,51,256,18,11,131,2,1,Alabama-Birmingham,9,28,89,38,20,248,2,3,V,-10.5,11,23,167,-20,-9,-117,0,-2,2003
306,306,09/13/2003,Tulane,31,31,112,47,29,349,0,0,Mississippi State,28,37,225,33,16,246,0,3,H,-3.5,3,-6,-113,14,13,103,0,-3,2003
307,307,09/13/2003,Tulsa,41,44,273,27,18,257,0,1,S W Texas State,15,43,168,47,24,213,3,0,H, ,26,1,105,-20,-6,44,-3,1,2003
308,308,09/13/2003,U-C-F,33,24,68,52,37,497,2,0,Florida Atlantic,29,31,102,40,26,352,0,0,H, ,4,-7,-34,12,11,145,2,0,2003
309,309,09/13/2003,U.C.L.A.,6,35,110,31,11,94,1,0,Illinois,3,26,67,42,26,216,3,1,H,9.5,3,9,43,-11,-15,-122,-2,-1,2003
310,310,09/13/2003,UL-Lafayette,14,40,139,22,5,57,0,1,Houston,21,51,256,18,8,157,1,4,H,-7,-7,-11,-117,4,-3,-100,-1,-3,2003
311,311,09/13/2003,UL-Monroe,14,31,29,44,26,307,2,1,Mississippi,59,46,144,31,25,468,0,1,V,-26.5,-45,-15,-115,13,1,-161,2,0,2003
312,312,09/13/2003,Utah State,16,35,65,54,26,308,3,0,Arizona State,26,37,161,37,20,277,1,3,V,-26.5,-10,-2,-96,17,6,31,2,-3,2003
313,313,09/13/2003,Vanderbilt,7,35,97,23,11,124,1,2,Auburn,45,54,219,26,17,264,0,0,H,-11.5,-38,-19,-122,-3,-6,-140,1,2,2003
314,314,09/13/2003,Virginia,58,48,217,22,14,186,0,0,Western Michigan,16,26,91,53,28,317,3,3,V,6.5,42,22,126,-31,-14,-131,-3,-3,2003
315,315,09/13/2003,Wake Forest,10,34,56,30,18,188,1,0,Purdue,16,37,116,36,26,227,0,1,H,-2.5,-6,-3,-60,-6,-8,-39,1,-1,2003
316,316,09/13/2003,Washington State,47,33,153,33,17,310,1,0,Colorado,26,34,101,55,32,348,2,3,V,-4.5,21,-1,52,-22,-15,-38,-1,-3,2003
317,317,09/13/2003,West Virginia,13,40,118,31,10,125,2,3,Cincinnati,15,49,165,36,17,146,0,5,H,6.5,-2,-9,-47,-5,-7,-21,2,-2,2003
318,318,09/13/2003,Western Michigan,16,26,91,53,28,317,3,3,Virginia,58,48,217,22,14,186,0,0,H,-6.5,-42,-22,-126,31,14,131,3,3,2003
319,319,09/13/2003,Wisconsin,5,42,52,30,13,239,2,3,Nevada-Las Vegas,23,37,94,25,12,93,0,1,H,20.5,-18,5,-42,5,1,146,2,2,2003
320,320,09/13/2003,Wyoming,35,36,179,46,33,328,0,2,Kansas,42,40,162,16,13,295,0,1,H,4.5,-7,-4,17,30,20,33,0,1,2003
321,321,09/18/2003,Nevada-Reno,42,60,272,24,17,291,1,0,San Jose State,30,29,133,27,15,209,1,0,V,1.5,12,31,139,-3,2,82,0,0,2003
322,322,09/18/2003,San Jose State,30,29,133,27,15,209,1,0,Nevada-Reno,42,60,272,24,17,291,1,0,H,-1.5,-12,-31,-139,3,-2,-82,0,0,2003
323,323,09/18/2003,Texas A & M,19,39,102,26,14,170,1,1,Virginia Tech,35,47,273,13,9,63,1,1,V,-13.5,-16,-8,-171,13,5,107,0,0,2003
324,324,09/18/2003,Virginia Tech,35,47,273,13,9,63,1,1,Texas A & M,19,39,102,26,14,170,1,1,H,13.5,16,8,171,-13,-5,-107,0,0,2003
325,325,09/19/2003,Hawaii,22,20,54,61,37,363,3,3,Nevada-Las Vegas,33,44,116,36,14,180,1,0,V,-1,-11,-24,-62,25,23,183,2,3,2003
326,326,09/19/2003,Nevada-Las Vegas,33,44,116,36,14,180,1,0,Hawaii,22,20,54,61,37,363,3,3,H,1,11,24,62,-25,-23,-183,-2,-3,2003
327,327,09/20/2003,Air Force,35,75,431,13,8,79,1,1,Wyoming,29,28,88,52,27,398,0,0,H,20,6,47,343,-39,-19,-319,1,1,2003
328,328,09/20/2003,Akron,65,47,340,44,30,352,0,2,Howard,7,24,106,33,18,127,2,2,H, ,58,23,234,11,12,225,-2,0,2003
329,329,09/20/2003,Alabama,16,26,118,39,22,276,0,0,Northern Illinois,19,40,118,24,16,149,0,0,H,13,-3,-14,0,15,6,127,0,0,2003
330,330,09/20/2003,Alabama-Birmingham,10,25,60,40,18,171,2,1,South Carolina,42,43,214,21,14,208,1,0,V,-14,-32,-18,-154,19,4,-37,1,1,2003
331,331,09/20/2003,Arizona,7,31,66,31,13,108,2,2,Purdue,59,52,292,31,19,288,1,1,V,-27,-52,-21,-226,0,-6,-180,1,1,2003
332,332,09/20/2003,Arizona State,2,21,24,44,25,160,1,0,Iowa,21,45,153,23,15,154,1,1,V,-6,-19,-24,-129,21,10,6,0,-1,2003
333,333,09/20/2003,Arkansas,31,38,143,23,14,183,0,0,North Texas,7,40,116,14,6,81,1,2,H,21,24,-2,27,9,8,102,-1,-2,2003
334,334,09/20/2003,Arkansas State,7,42,207,26,6,64,3,1,Tulsa,54,41,217,25,13,187,1,0,V,4,-47,1,-10,1,-7,-123,2,1,2003
335,335,09/20/2003,Army,33,42,142,48,29,339,5,3,Tulane,50,35,129,34,26,350,0,1,H,-17,-17,7,13,14,3,-11,5,2,2003
336,336,09/20/2003,Ball State,27,47,206,36,24,215,0,0,Central Michigan,14,36,121,26,10,142,1,0,H,5.5,13,11,85,10,14,73,-1,0,2003
337,337,09/20/2003,Baylor,27,50,147,20,11,188,1,1,Sam Houston State,6,39,165,34,13,122,1,2,H, ,21,11,-18,-14,-2,66,0,-1,2003
338,338,09/20/2003,Boise State,24,35,47,37,19,334,0,1,Oregon State,26,46,154,37,19,408,0,1,V,-5,-2,-11,-107,0,0,-74,0,0,2003
339,339,09/20/2003,Boston College,14,45,119,26,8,94,2,0,Miami-Florida,33,34,136,33,20,164,2,1,H,-10.5,-19,11,-17,-7,-12,-70,0,-1,2003
340,340,09/20/2003,Bowling Green,17,23,40,56,33,326,3,1,Ohio State,24,48,205,16,10,118,1,2,V,-11,-7,-25,-165,40,23,208,2,-1,2003
341,341,09/20/2003,Brigham Young,14,25,-5,46,23,310,2,3,Stanford,18,44,144,24,11,56,2,0,H,6.5,-4,-19,-149,22,12,254,0,3,2003
342,342,09/20/2003,Buffalo,7,36,145,30,13,96,0,0,Connecticut,38,50,287,30,19,326,0,1,H,-22.5,-31,-14,-142,0,-6,-230,0,-1,2003
343,343,09/20/2003,California,31,32,105,37,20,263,0,1,Illinois,24,35,66,57,35,430,1,0,V,-3.5,7,-3,39,-20,-15,-167,-1,1,2003
344,344,09/20/2003,Central Michigan,14,36,121,26,10,142,1,0,Ball State,27,47,206,36,24,215,0,0,V,-5.5,-13,-11,-85,-10,-14,-73,1,0,2003
345,345,09/20/2003,Cincinnati,30,38,136,44,29,321,0,1,Temple,24,31,107,48,28,415,2,0,H,13.5,6,7,29,-4,1,-94,-2,1,2003
346,346,09/20/2003,Clemson,39,30,138,39,23,298,1,0,Georgia Tech,3,33,45,42,19,248,1,1,V,-5.5,36,-3,93,-3,4,50,0,-1,2003
347,347,09/20/2003,Colorado,7,38,83,31,15,192,0,2,Florida State,47,24,93,47,35,458,0,0,V,-21,-40,14,-10,-16,-20,-266,0,2,2003
348,348,09/20/2003,Colorado State,21,29,39,28,17,349,1,1,Miami-Ohio,41,39,206,40,29,330,0,1,H,6,-20,-10,-167,-12,-12,19,1,0,2003
349,349,09/20/2003,Connecticut,38,50,287,30,19,326,0,1,Buffalo,7,36,145,30,13,96,0,0,V,22.5,31,14,142,0,6,230,0,1,2003
350,350,09/20/2003,Duke,10,32,90,39,20,208,1,1,Northwestern,28,45,286,23,15,177,0,1,H,3,-18,-13,-196,16,5,31,1,0,2003
351,351,09/20/2003,East Carolina,16,41,167,35,25,224,3,2,Wake Forest,34,54,182,15,8,142,0,1,V,-19.5,-18,-13,-15,20,17,82,3,1,2003
352,352,09/20/2003,Eastern Michigan,7,22,32,37,20,239,4,2,Navy,39,65,372,10,6,92,0,1,V,-15,-32,-43,-340,27,14,147,4,1,2003
353,353,09/20/2003,Florida,10,27,73,44,25,281,2,1,Tennessee,24,50,139,24,12,235,1,2,H,3.5,-14,-23,-66,20,13,46,1,-1,2003
354,354,09/20/2003,Florida State,47,24,93,47,35,458,0,0,Colorado,7,38,83,31,15,192,0,2,H,21,40,-14,10,16,20,266,0,-2,2003
355,355,09/20/2003,Fresno State,16,53,299,33,18,153,2,0,Louisiana Tech,6,21,91,33,21,165,1,1,H,9.5,10,32,208,0,-3,-12,1,-1,2003
356,356,09/20/2003,Georgia,10,31,97,46,20,314,2,1,Louisiana State,17,43,105,29,14,180,1,1,V,-2.5,-7,-12,-8,17,6,134,1,0,2003
357,357,09/20/2003,Georgia Tech,3,33,45,42,19,248,1,1,Clemson,39,30,138,39,23,298,1,0,H,5.5,-36,3,-93,3,-4,-50,0,1,2003
358,358,09/20/2003,Houston,42,49,198,29,20,321,0,3,Mississippi State,35,32,112,42,24,360,5,1,H,-5,7,17,86,-13,-4,-39,-5,2,2003
359,359,09/20/2003,Idaho,14,32,120,30,9,86,1,1,Washington,45,49,231,34,24,271,1,2,V,-26.5,-31,-17,-111,-4,-15,-185,0,-1,2003
360,360,09/20/2003,Illinois,24,35,66,57,35,430,1,0,California,31,32,105,37,20,263,0,1,H,3.5,-7,3,-39,20,15,167,1,-1,2003
361,361,09/20/2003,Indiana,17,46,183,33,17,266,1,0,Kentucky,34,41,167,21,12,187,0,1,H,-8,-17,5,16,12,5,79,1,-1,2003
362,362,09/20/2003,Iowa,21,45,153,23,15,154,1,1,Arizona State,2,21,24,44,25,160,1,0,H,6,19,24,129,-21,-10,-6,0,1,2003
363,363,09/20/2003,Kansas,41,42,245,39,24,396,1,0,Jacksonville St,6,35,73,25,10,161,1,0,H, ,35,7,172,14,14,235,0,0,2003
364,364,09/20/2003,Kansas State,20,39,128,26,14,241,1,3,Marshall,27,45,210,24,16,106,1,0,H,24,-7,-6,-82,2,-2,135,0,3,2003
365,365,09/20/2003,Kent State,10,41,79,23,9,105,1,0,Penn State,32,51,282,31,12,128,0,3,V,-25.5,-22,-10,-203,-8,-3,-23,1,-3,2003
366,366,09/20/2003,Kentucky,34,41,167,21,12,187,0,1,Indiana,17,46,183,33,17,266,1,0,V,8,17,-5,-16,-12,-5,-79,-1,1,2003
367,367,09/20/2003,Louisiana State,17,43,105,29,14,180,1,1,Georgia,10,31,97,46,20,314,2,1,H,2.5,7,12,8,-17,-6,-134,-1,0,2003
368,368,09/20/2003,Louisiana Tech,6,21,91,33,21,165,1,1,Fresno State,16,53,299,33,18,153,2,0,V,-9.5,-10,-32,-208,0,3,12,-1,1,2003
369,369,09/20/2003,Louisville,42,42,191,28,18,246,0,1,Texas-El Paso,14,43,189,27,10,111,2,1,H,36,28,-1,2,1,8,135,-2,0,2003
370,370,09/20/2003,Marshall,27,45,210,24,16,106,1,0,Kansas State,20,39,128,26,14,241,1,3,V,-24,7,6,82,-2,2,-135,0,-3,2003
371,371,09/20/2003,Maryland,34,49,260,26,15,238,1,1,West Virginia,7,39,120,12,3,36,0,0,H,10,27,10,140,14,12,202,1,1,2003
372,372,09/20/2003,Miami-Florida,33,33,125,34,21,175,2,1,Boston College,14,45,119,26,8,94,2,0,V,10.5,19,-12,6,8,13,81,0,1,2003
373,373,09/20/2003,Miami-Ohio,41,39,206,40,29,330,0,1,Colorado State,21,29,39,28,17,349,1,1,V,-6,20,10,167,12,12,-19,-1,0,2003
374,374,09/20/2003,Michigan,27,19,-3,55,28,360,2,1,Oregon,31,45,127,31,20,253,0,0,V,7,-4,-26,-130,24,8,107,2,1,2003
375,375,09/20/2003,Michigan State,22,39,181,27,13,119,2,1,Notre Dame,16,37,100,42,17,202,2,1,V,-9,6,2,81,-15,-4,-83,0,0,2003
376,376,09/20/2003,Mid Tennessee St,40,56,197,32,20,286,0,0,Missouri,41,43,296,32,22,192,0,0,V,-22,-1,13,-99,0,-2,94,0,0,2003
377,377,09/20/2003,Minnesota,48,61,356,22,12,174,1,1,UL-Lafayette,14,29,50,32,16,154,1,1,H,35,34,32,306,-10,-4,20,0,0,2003
378,378,09/20/2003,Mississippi State,35,32,112,42,24,360,5,1,Houston,42,49,198,29,20,321,0,3,V,5,-7,-17,-86,13,4,39,5,-2,2003
379,379,09/20/2003,Missouri,41,43,296,32,22,192,0,0,Mid Tennessee St,40,56,197,32,20,286,0,0,H,22,1,-13,99,0,2,-94,0,0,2003
380,380,09/20/2003,Navy,39,65,372,10,6,92,0,1,Eastern Michigan,7,22,32,37,20,239,4,2,H,15,32,43,340,-27,-14,-147,-4,-1,2003
381,381,09/20/2003,New Mexico,13,23,22,33,17,235,0,1,Washington State,23,44,87,42,29,346,0,0,V,-14.5,-10,-21,-65,-9,-12,-111,0,1,2003
382,382,09/20/2003,No Carolina State,49,39,217,22,18,257,0,2,Texas Tech,21,24,95,64,39,586,1,2,H,6,28,15,122,-42,-21,-329,-1,0,2003
383,383,09/20/2003,North Carolina,27,25,110,31,16,199,1,2,Wisconsin,38,50,209,20,12,193,2,0,V,-14.5,-11,-25,-99,11,4,6,-1,2,2003
384,384,09/20/2003,North Texas,7,40,116,14,6,81,1,2,Arkansas,31,38,143,23,14,183,0,0,V,-21,-24,2,-27,-9,-8,-102,1,2,2003
385,385,09/20/2003,Northern Illinois,19,40,118,24,16,149,0,0,Alabama,16,26,118,39,22,276,0,0,V,-13,3,14,0,-15,-6,-127,0,0,2003
386,386,09/20/2003,Northwestern,28,45,286,23,15,177,0,1,Duke,10,32,90,39,20,208,1,1,V,-3,18,13,196,-16,-5,-31,-1,0,2003
387,387,09/20/2003,Notre Dame,16,37,100,42,17,202,2,1,Michigan State,22,39,181,27,13,119,2,1,H,9,-6,-2,-81,15,4,83,0,0,2003
388,388,09/20/2003,Ohio State,24,48,205,16,10,118,1,2,Bowling Green,17,23,40,56,33,326,3,1,H,11,7,25,165,-40,-23,-208,-2,1,2003
389,389,09/20/2003,Oklahoma,59,35,111,25,17,243,2,0,U.C.L.A.,24,39,127,34,18,144,2,1,H,19.5,35,-4,-16,-9,-1,99,0,-1,2003
390,390,09/20/2003,Oklahoma State,52,29,123,31,19,275,0,0,Southern Methodist,6,44,108,26,9,125,2,0,V,25,46,-15,15,5,10,150,-2,0,2003
391,391,09/20/2003,Oregon,31,45,127,31,20,253,0,0,Michigan,27,19,-3,55,28,360,2,1,H,-7,4,26,130,-24,-8,-107,-2,-1,2003
392,392,09/20/2003,Oregon State,26,46,154,37,19,408,0,1,Boise State,24,35,47,37,19,334,0,1,H,5,2,11,107,0,0,74,0,0,2003
393,393,09/20/2003,Penn State,32,51,282,31,12,128,0,3,Kent State,10,41,79,23,9,105,1,0,H,25.5,22,10,203,8,3,23,-1,3,2003
394,394,09/20/2003,Pittsburgh,31,28,74,36,24,315,2,0,Toledo,35,29,90,62,49,461,1,1,V,9.5,-4,-1,-16,-26,-25,-146,1,-1,2003
395,395,09/20/2003,Purdue,59,52,292,31,19,288,1,1,Arizona,7,31,66,31,13,108,2,2,H,27,52,21,226,0,6,180,-1,-1,2003
396,396,09/20/2003,Rice,7,44,165,8,2,27,1,2,Texas,48,53,322,13,11,193,0,0,H,-31,-41,-9,-157,-5,-9,-166,1,2,2003
397,397,09/20/2003,San Diego State,37,47,294,39,20,234,1,1,Samford,17,26,106,37,18,138,0,0,H, ,20,21,188,2,2,96,1,1,2003
398,398,09/20/2003,South Carolina,42,43,214,21,14,208,1,0,Alabama-Birmingham,10,25,60,40,18,171,2,1,H,14,32,18,154,-19,-4,37,-1,-1,2003
399,399,09/20/2003,Southern Methodist,6,44,108,26,9,125,2,0,Oklahoma State,52,29,123,31,19,275,0,0,H,-25,-46,15,-15,-5,-10,-150,2,0,2003
400,400,09/20/2003,Stanford,18,44,144,24,11,56,2,0,Brigham Young,14,25,-5,46,23,310,2,3,V,-6.5,4,19,149,-22,-12,-254,0,-3,2003
401,401,09/20/2003,Syracuse,38,52,318,20,13,133,0,0,U-C-F,14,23,92,49,33,284,3,2,H,6,24,29,226,-29,-20,-151,-3,-2,2003
402,402,09/20/2003,Temple,24,31,107,48,28,415,2,0,Cincinnati,30,38,136,44,29,321,0,1,V,-13.5,-6,-7,-29,4,-1,94,2,-1,2003
403,403,09/20/2003,Tennessee,24,50,139,24,12,235,1,2,Florida,10,27,73,44,25,281,2,1,V,-3.5,14,23,66,-20,-13,-46,-1,1,2003
404,404,09/20/2003,Texas,48,53,322,13,11,193,0,0,Rice,7,44,165,8,2,27,1,2,V,31,41,9,157,5,9,166,-1,-2,2003
405,405,09/20/2003,Texas Christian,30,55,182,30,15,227,1,1,Vanderbilt,14,32,90,36,17,250,2,2,H,11,16,23,92,-6,-2,-23,-1,-1,2003
406,406,09/20/2003,Texas Tech,21,24,95,64,39,586,1,2,No Carolina State,49,39,217,22,18,257,0,2,V,-6,-28,-15,-122,42,21,329,1,0,2003
407,407,09/20/2003,Texas-El Paso,14,43,189,27,10,111,2,1,Louisville,42,42,191,28,18,246,0,1,V,-36,-28,1,-2,-1,-8,-135,2,0,2003
408,408,09/20/2003,Toledo,35,29,90,62,49,461,1,1,Pittsburgh,31,28,74,36,24,315,2,0,H,-9.5,4,1,16,26,25,146,-1,1,2003
409,409,09/20/2003,Troy State,28,37,217,22,12,237,2,2,S E Louisiana,0,22,-22,50,32,258,0,3,H, ,28,15,239,-28,-20,-21,2,-1,2003
410,410,09/20/2003,Tulane,50,35,129,34,26,350,0,1,Army,33,42,142,48,29,339,5,3,V,17,17,-7,-13,-14,-3,11,-5,-2,2003
411,411,09/20/2003,Tulsa,54,41,217,25,13,187,1,0,Arkansas State,7,42,207,26,6,64,3,1,H,-4,47,-1,10,-1,7,123,-2,-1,2003
412,412,09/20/2003,U-C-F,14,23,92,49,33,284,3,2,Syracuse,38,52,318,20,13,133,0,0,V,-6,-24,-29,-226,29,20,151,3,2,2003
413,413,09/20/2003,U.C.L.A.,24,39,127,34,18,144,2,1,Oklahoma,59,35,111,25,17,243,2,0,V,-19.5,-35,4,16,9,1,-99,0,1,2003
414,414,09/20/2003,UL-Lafayette,14,29,50,32,16,154,1,1,Minnesota,48,61,356,22,12,174,1,1,V,-35,-34,-32,-306,10,4,-20,0,0,2003
415,415,09/20/2003,UL-Monroe,10,39,164,29,12,102,3,1,Northwestern St(LA),14,46,170,20,13,139,1,2,H, ,-4,-7,-6,9,-1,-37,2,-1,2003
416,416,09/20/2003,Vanderbilt,14,32,90,36,17,250,2,2,Texas Christian,30,55,182,30,15,227,1,1,V,-11,-16,-23,-92,6,2,23,1,1,2003
417,417,09/20/2003,Wake Forest,34,55,193,14,7,131,0,1,East Carolina,16,41,167,35,25,224,3,2,H,19.5,18,14,26,-21,-18,-93,-3,-1,2003
418,418,09/20/2003,Washington,45,49,231,34,24,271,1,2,Idaho,14,32,120,30,9,86,1,1,H,26.5,31,17,111,4,15,185,0,1,2003
419,419,09/20/2003,Washington State,23,44,87,42,29,346,0,0,New Mexico,13,23,22,33,17,235,0,1,H,14.5,10,21,65,9,12,111,0,-1,2003
420,420,09/20/2003,West Virginia,7,39,120,12,3,36,0,0,Maryland,34,49,260,26,15,238,1,1,V,-10,-27,-10,-140,-14,-12,-202,-1,-1,2003
421,421,09/20/2003,Wisconsin,38,50,209,20,12,193,2,0,North Carolina,27,25,110,31,16,199,1,2,H,14.5,11,25,99,-11,-4,-6,1,-2,2003
422,422,09/20/2003,Wyoming,29,28,88,52,27,398,0,0,Air Force,35,75,431,13,8,79,1,0,V,-20,-6,-47,-343,39,19,319,-1,0,2003
423,423,09/25/2003,Nebraska,38,45,141,15,6,124,1,0,Southern Miss,14,36,108,42,18,211,2,3,V,11,24,9,33,-27,-12,-87,-1,-3,2003
424,424,09/25/2003,Southern Miss,14,36,108,42,18,211,2,3,Nebraska,38,45,141,15,6,124,1,0,H,-11,-24,-9,-33,27,12,87,1,3,2003
425,425,09/27/2003,Air Force,24,47,194,22,12,134,1,0,Brigham Young,10,36,113,36,19,193,0,1,V,1.5,14,11,81,-14,-7,-59,1,-1,2003
426,426,09/27/2003,Akron,38,31,165,41,26,362,1,1,Buffalo,21,41,108,18,13,119,0,2,V,16,17,-10,57,23,13,243,1,-1,2003
427,427,09/27/2003,Alabama,31,31,158,32,15,226,1,1,Arkansas,34,61,289,27,16,202,3,1,H,-2.5,-3,-30,-131,5,-1,24,-2,0,2003
428,428,09/27/2003,Arizona,10,29,33,30,14,276,4,0,Texas Christian,13,56,206,24,12,246,0,1,H,-14,-3,-27,-173,6,2,30,4,-1,2003
429,429,09/27/2003,Arizona State,17,33,97,50,20,284,4,2,Oregon State,45,44,151,29,15,246,3,0,V,-6,-28,-11,-54,21,5,38,1,2,2003
430,430,09/27/2003,Arkansas,34,61,289,27,16,202,3,1,Alabama,31,31,158,32,15,226,1,1,V,2.5,3,30,131,-5,1,-24,2,0,2003
431,431,09/27/2003,Arkansas State,16,34,105,29,16,171,1,2,Memphis,38,39,163,36,20,238,1,1,V,-16,-22,-5,-58,-7,-4,-67,0,1,2003
432,432,09/27/2003,Army,0,28,17,51,21,159,3,3,South Florida,28,35,145,42,23,225,2,1,H,-19.5,-28,-7,-128,9,-2,-66,1,2,2003
433,433,09/27/2003,Auburn,48,42,285,26,22,282,0,1,Western Kentucky,3,28,47,17,10,116,1,0,H, ,45,14,238,9,12,166,-1,1,2003
434,434,09/27/2003,Ball State,29,32,125,33,17,242,1,0,Boston College,53,46,259,30,22,209,0,1,V,-23.5,-24,-14,-134,3,-5,33,1,-1,2003
435,435,09/27/2003,Boise State,33,50,155,38,27,285,1,2,Wyoming,17,25,32,34,15,241,2,0,H,23.5,16,25,123,4,12,44,-1,2,2003
436,436,09/27/2003,Boston College,53,46,259,30,22,209,0,1,Ball State,29,32,125,33,17,242,1,0,H,23.5,24,14,134,-3,5,-33,-1,1,2003
437,437,09/27/2003,Brigham Young,10,36,113,36,19,193,0,1,Air Force,24,47,194,22,12,134,1,0,H,-1.5,-14,-11,-81,14,7,59,-1,1,2003
438,438,09/27/2003,Buffalo,21,41,108,18,13,119,0,2,Akron,38,31,165,41,26,362,1,1,H,-16,-17,10,-57,-23,-13,-243,-1,1,2003
439,439,09/27/2003,California,34,48,143,37,27,326,2,2,Southern Cal,31,24,99,39,21,277,3,1,H,-13.5,3,24,44,-2,6,49,-1,1,2003
440,440,09/27/2003,Cincinnati,37,33,152,40,17,226,1,4,Miami-Ohio,42,38,98,49,31,377,3,1,V,-7,-5,-5,54,-9,-14,-151,-2,3,2003
441,441,09/27/2003,Colorado State,21,41,102,32,22,267,2,4,Utah,28,35,126,21,17,158,0,1,H,6,-7,6,-24,11,5,109,2,3,2003
442,442,09/27/2003,Connecticut,13,44,127,40,25,316,1,0,Virginia Tech,47,28,245,19,10,123,0,0,V,-20.5,-34,16,-118,21,15,193,1,0,2003
443,443,09/27/2003,Duke,7,45,106,34,15,169,1,2,Florida State,56,31,96,34,22,328,0,2,H,-29.5,-49,14,10,0,-7,-159,1,0,2003
444,444,09/27/2003,Eastern Michigan,13,39,149,20,14,126,1,0,Maryland,37,41,199,21,16,268,0,2,H,-35.5,-24,-2,-50,-1,-2,-142,1,-2,2003
445,445,09/27/2003,Florida,24,29,93,35,20,268,2,1,Kentucky,21,44,175,29,18,179,2,0,V,12.5,3,-15,-82,6,2,89,0,1,2003
446,446,09/27/2003,Florida State,56,31,96,34,22,328,0,2,Duke,7,45,106,34,15,169,1,2,V,29.5,49,-14,-10,0,7,159,-1,0,2003
447,447,09/27/2003,Fresno State,42,39,198,26,14,181,0,1,Portland State,16,45,257,32,18,229,2,1,H, ,26,-6,-59,-6,-4,-48,-2,0,2003
448,448,09/27/2003,Georgia Tech,24,39,223,22,11,108,2,0,Vanderbilt,17,46,170,27,14,185,1,1,V,7,7,-7,53,-5,-3,-77,1,-1,2003
449,449,09/27/2003,Hawaii,41,27,119,70,42,397,0,2,Rice,21,42,186,14,7,173,3,2,H,20.5,20,-15,-67,56,35,224,-3,0,2003
450,450,09/27/2003,Idaho,28,26,83,50,23,332,0,3,Montana,41,56,344,14,7,92,1,2,V, ,-13,-30,-261,36,16,240,-1,1,2003
451,451,09/27/2003,Illinois,20,21,64,41,23,207,1,0,Wisconsin,38,63,307,13,7,131,0,0,H,-1,-18,-42,-243,28,16,76,1,0,2003
452,452,09/27/2003,Indiana,17,44,102,33,16,107,2,0,Michigan,31,36,168,26,16,170,2,2,V,-33.5,-14,8,-66,7,0,-63,0,-2,2003
453,453,09/27/2003,Iowa,10,39,107,23,11,158,1,3,Michigan State,20,32,45,44,28,218,0,0,V,7.5,-10,7,62,-21,-17,-60,1,3,2003
454,454,09/27/2003,Iowa State,16,47,173,33,16,182,2,0,Northern Illinois,24,43,167,22,15,167,1,1,V,-6.5,-8,4,6,11,1,15,1,-1,2003
455,455,09/27/2003,Kansas,35,48,207,23,14,111,0,1,Missouri,14,37,134,24,12,62,0,0,H,-9.5,21,11,73,-1,2,49,0,1,2003
456,456,09/27/2003,Kent State,36,56,121,23,16,141,0,1,U-C-F,16,23,68,40,27,235,4,4,H,-8.5,20,33,53,-17,-11,-94,-4,-3,2003
457,457,09/27/2003,Kentucky,21,44,175,29,18,179,2,0,Florida,24,29,93,35,20,268,2,1,H,-12.5,-3,15,82,-6,-2,-89,0,-1,2003
458,458,09/27/2003,Louisiana State,41,35,163,25,14,191,1,1,Mississippi State,6,30,31,39,21,208,2,2,V,14,35,5,132,-14,-7,-17,-1,-1,2003
459,459,09/27/2003,Louisville,21,43,187,24,13,197,2,1,Temple,12,30,53,54,27,362,0,2,H,13,9,13,134,-30,-14,-165,2,-1,2003
460,460,09/27/2003,Marshall,24,27,98,52,33,319,3,1,Troy State,33,48,254,17,6,95,0,1,V,11,-9,-21,-156,35,27,224,3,0,2003
461,461,09/27/2003,Maryland,37,41,199,21,16,268,0,2,Eastern Michigan,13,39,149,20,14,126,1,0,V,35.5,24,2,50,1,2,142,-1,2,2003
462,462,09/27/2003,Memphis,38,39,163,36,20,238,1,1,Arkansas State,16,34,105,29,16,171,1,2,H,16,22,5,58,7,4,67,0,-1,2003
463,463,09/27/2003,Miami-Ohio,42,38,98,49,31,377,3,1,Cincinnati,37,33,152,40,17,226,1,4,H,7,5,5,-54,9,14,151,2,-3,2003
464,464,09/27/2003,Michigan,31,36,168,26,16,170,2,2,Indiana,17,44,102,33,16,107,2,0,H,33.5,14,-8,66,-7,0,63,0,2,2003
465,465,09/27/2003,Michigan State,20,32,45,44,28,218,0,0,Iowa,10,39,107,23,11,158,1,3,H,-7.5,10,-7,-62,21,17,60,-1,-3,2003
466,466,09/27/2003,Minnesota,20,52,250,15,7,71,0,0,Penn State,14,43,226,35,19,193,2,0,V,1,6,9,24,-20,-12,-122,-2,0,2003
467,467,09/27/2003,Mississippi,45,34,169,49,29,409,2,0,Texas Tech,49,17,52,64,44,661,1,3,H,3,-4,17,117,-15,-15,-252,1,-3,2003
468,468,09/27/2003,Mississippi State,6,30,31,39,21,208,2,2,Louisiana State,41,35,163,25,14,191,1,1,H,-14,-35,-5,-132,14,7,17,1,1,2003
469,469,09/27/2003,Missouri,14,37,134,24,12,62,0,0,Kansas,35,48,207,23,14,111,0,1,V,9.5,-21,-11,-73,1,-2,-49,0,-1,2003
470,470,09/27/2003,Navy,27,55,373,15,5,117,0,3,Rutgers,48,53,249,22,15,155,1,1,V,2,-21,2,124,-7,-10,-38,-1,2,2003
471,471,09/27/2003,Nevada-Reno,12,33,164,25,11,96,2,1,Southern Methodist,9,52,148,18,9,97,2,1,H,18.5,3,-19,16,7,2,-1,0,0,2003
472,472,09/27/2003,New Mexico,24,49,145,18,10,83,2,1,New Mexico State,17,38,106,32,15,258,2,3,H,9.5,7,11,39,-14,-5,-175,0,-2,2003
473,473,09/27/2003,New Mexico State,17,38,106,32,15,258,2,3,New Mexico,24,49,145,18,10,83,2,1,V,-9.5,-7,-11,-39,14,5,175,0,2,2003
474,474,09/27/2003,No Carolina State,47,39,192,30,23,423,0,0,North Carolina,34,27,81,53,32,469,0,1,H,16.5,13,12,111,-23,-9,-46,0,-1,2003
475,475,09/27/2003,North Carolina,34,27,81,53,32,469,0,1,No Carolina State,47,39,192,30,23,423,0,0,V,-16.5,-13,-12,-111,23,9,46,0,1,2003
476,476,09/27/2003,North Texas,44,47,229,16,9,222,1,1,UL-Lafayette,23,31,27,38,22,200,3,0,H,19.5,21,16,202,-22,-13,22,-2,1,2003
477,477,09/27/2003,Northern Illinois,24,43,167,22,15,167,1,1,Iowa State,16,47,173,33,16,182,2,0,H,6.5,8,-4,-6,-11,-1,-15,-1,1,2003
478,478,09/27/2003,Northwestern,0,40,121,25,10,64,0,1,Ohio State,20,35,125,32,19,186,1,0,V,-20.5,-20,5,-4,-7,-9,-122,-1,1,2003
479,479,09/27/2003,Notre Dame,10,25,49,62,29,297,4,0,Purdue,23,41,96,24,12,127,0,0,V,-10.5,-13,-16,-47,38,17,170,4,0,2003
480,480,09/27/2003,Ohio,32,48,170,29,13,223,2,3,Western Michigan,39,38,128,39,22,315,2,2,H,-2,-7,10,42,-10,-9,-92,0,1,2003
481,481,09/27/2003,Ohio State,20,35,125,32,19,186,1,0,Northwestern,0,40,121,25,10,64,0,1,H,20.5,20,-5,4,7,9,122,1,-1,2003
482,482,09/27/2003,Oregon,16,29,54,58,24,360,7,2,Washington State,55,40,84,35,15,315,0,2,H,4,-39,-11,-30,23,9,45,7,0,2003
483,483,09/27/2003,Oregon State,45,44,151,29,15,246,3,0,Arizona State,17,33,97,50,20,284,4,2,H,6,28,11,54,-21,-5,-38,-1,-2,2003
484,484,09/27/2003,Penn State,14,43,226,35,19,193,2,0,Minnesota,20,52,250,15,7,71,0,0,H,-1,-6,-9,-24,20,12,122,2,0,2003
485,485,09/27/2003,Pittsburgh,37,44,195,28,14,283,1,0,Texas A & M,26,39,227,39,21,317,1,3,V,1.5,11,5,-32,-11,-7,-34,0,-3,2003
486,486,09/27/2003,Purdue,23,41,96,24,12,127,0,0,Notre Dame,10,25,49,62,29,297,4,0,H,10.5,13,16,47,-38,-17,-170,-4,0,2003
487,487,09/27/2003,Rice,21,42,186,14,7,173,3,2,Hawaii,41,27,119,70,42,397,0,2,V,-20.5,-20,15,67,-56,-35,-224,3,0,2003
488,488,09/27/2003,Rutgers,48,53,249,22,15,155,1,1,Navy,27,55,373,15,5,117,0,3,H,-2,21,-2,-124,7,10,38,1,-2,2003
489,489,09/27/2003,San Diego State,10,29,120,37,19,110,2,1,U.C.L.A.,20,36,65,28,18,258,0,4,V,-10,-10,-7,55,9,1,-148,2,-3,2003
490,490,09/27/2003,South Carolina,20,44,217,30,12,154,1,0,Tennessee,23,36,117,22,13,149,0,0,V,-15,-3,8,100,8,-1,5,1,0,2003
491,491,09/27/2003,South Florida,28,35,145,42,23,225,2,1,Army,0,28,17,51,21,159,3,3,V,19.5,28,7,128,-9,2,66,-1,-2,2003
492,492,09/27/2003,Southern Cal,31,24,99,39,21,277,3,1,California,34,48,143,37,27,326,2,2,V,13.5,-3,-24,-44,2,-6,-49,1,-1,2003
493,493,09/27/2003,Southern Methodist,9,52,148,18,9,97,2,1,Nevada-Reno,12,33,164,25,11,96,2,1,V,-18.5,-3,19,-16,-7,-2,1,0,0,2003
494,494,09/27/2003,Stanford,17,40,129,32,16,159,2,0,Washington,28,40,165,34,20,231,0,2,V,-13,-11,0,-36,-2,-4,-72,2,-2,2003
495,495,09/27/2003,Syracuse,34,47,303,23,17,147,0,2,Toledo,7,23,76,53,32,257,1,0,H,3.5,27,24,227,-30,-15,-110,-1,2,2003
496,496,09/27/2003,Temple,12,30,53,54,27,362,0,2,Louisville,21,43,187,24,13,197,2,1,V,-13,-9,-13,-134,30,14,165,-2,1,2003
497,497,09/27/2003,Tennessee,23,36,117,22,13,149,0,0,South Carolina,20,44,217,30,12,154,1,0,H,15,3,-8,-100,-8,1,-5,-1,0,2003
498,498,09/27/2003,Texas,63,52,302,24,14,213,0,1,Tulane,18,36,156,29,13,186,2,2,H,29,45,16,146,-5,1,27,-2,-1,2003
499,499,09/27/2003,Texas A & M,26,39,227,39,21,317,1,3,Pittsburgh,37,44,195,28,14,283,1,0,H,-1.5,-11,-5,32,11,7,34,0,3,2003
500,500,09/27/2003,Texas Christian,13,56,206,24,12,246,0,1,Arizona,10,29,33,30,14,276,4,0,V,14,3,27,173,-6,-2,-30,-4,1,2003
501,501,09/27/2003,Texas Tech,49,17,52,64,44,661,1,3,Mississippi,45,34,169,49,29,409,2,0,V,-3,4,-17,-117,15,15,252,-1,3,2003
502,502,09/27/2003,Texas-El Paso,59,52,226,25,14,176,2,1,Sam Houston State,14,38,116,30,13,147,2,4,H, ,45,14,110,-5,1,29,0,-3,2003
503,503,09/27/2003,Toledo,7,23,76,53,32,257,1,0,Syracuse,34,47,303,23,17,147,0,2,V,-3.5,-27,-24,-227,30,15,110,1,-2,2003
504,504,09/27/2003,Troy State,33,48,254,17,6,95,0,1,Marshall,24,27,98,52,33,319,3,1,H,-11,9,21,156,-35,-27,-224,-3,0,2003
505,505,09/27/2003,Tulane,18,36,156,29,13,186,2,2,Texas,63,52,302,24,14,213,0,1,V,-29,-45,-16,-146,5,-1,-27,2,1,2003
506,506,09/27/2003,U-C-F,16,23,68,40,27,235,4,4,Kent State,36,56,121,23,16,141,0,1,V,8.5,-20,-33,-53,17,11,94,4,3,2003
507,507,09/27/2003,U.C.L.A.,20,36,65,28,18,258,0,4,San Diego State,10,29,120,37,19,110,2,1,H,10,10,7,-55,-9,-1,148,-2,3,2003
508,508,09/27/2003,UL-Lafayette,23,31,27,38,22,200,3,0,North Texas,44,47,229,16,9,222,1,1,V,-19.5,-21,-16,-202,22,13,-22,2,-1,2003
509,509,09/27/2003,UL-Monroe,10,34,45,47,25,212,2,1,Utah State,28,40,201,22,15,121,0,1,V,-13,-18,-6,-156,25,10,91,2,0,2003
510,510,09/27/2003,Utah,28,35,126,21,17,158,0,1,Colorado State,21,41,102,32,22,267,2,4,V,-6,7,-6,24,-11,-5,-109,-2,-3,2003
511,511,09/27/2003,Utah State,28,40,201,22,15,121,0,1,UL-Monroe,10,34,45,47,25,212,2,1,H,13,18,6,156,-25,-10,-91,-2,0,2003
512,512,09/27/2003,Vanderbilt,17,46,170,27,14,185,1,1,Georgia Tech,24,39,223,22,11,108,2,0,H,-7,-7,7,-53,5,3,77,-1,1,2003
513,513,09/27/2003,Virginia,27,33,151,45,30,326,3,2,Wake Forest,24,49,174,31,17,218,2,1,H,7,3,-16,-23,14,13,108,1,1,2003
514,514,09/27/2003,Virginia Tech,47,28,245,19,10,123,0,0,Connecticut,13,44,127,40,25,316,1,0,H,20.5,34,-16,118,-21,-15,-193,-1,0,2003
515,515,09/27/2003,Wake Forest,24,49,174,31,17,218,2,1,Virginia,27,33,151,45,30,326,3,2,V,-7,-3,16,23,-14,-13,-108,-1,-1,2003
516,516,09/27/2003,Washington,28,40,165,34,20,231,0,2,Stanford,17,40,129,32,16,159,2,0,H,13,11,0,36,2,4,72,-2,2,2003
517,517,09/27/2003,Washington State,55,40,84,35,15,315,0,2,Oregon,16,29,54,58,24,360,7,2,V,-4,39,11,30,-23,-9,-45,-7,0,2003
518,518,09/27/2003,Western Michigan,39,38,128,39,22,315,2,2,Ohio,32,48,170,29,13,223,2,3,V,2,7,-10,-42,10,9,92,0,-1,2003
519,519,09/27/2003,Wisconsin,38,63,307,13,7,131,0,0,Illinois,20,21,64,41,23,207,1,0,V,1,18,42,243,-28,-16,-76,-1,0,2003
520,520,09/27/2003,Wyoming,17,25,32,34,15,241,2,0,Boise State,33,50,155,38,27,285,1,2,V,-23.5,-16,-25,-123,-4,-12,-44,1,-2,2003
521,521,09/30/2003,East Carolina,13,36,105,27,10,95,3,0,Houston,27,44,160,29,20,277,0,2,H,-1.5,-14,-8,-55,-2,-10,-182,3,-2,2003
522,522,09/30/2003,Houston,27,44,160,29,20,277,0,2,East Carolina,13,36,105,27,10,95,3,0,V,1.5,14,8,55,2,10,182,-3,2,2003
523,523,10/02/2003,Miami-Florida,22,28,88,54,37,352,2,1,West Virginia,20,37,170,19,9,200,1,2,H,25.5,2,-9,-82,35,28,152,1,-1,2003
524,524,10/02/2003,West Virginia,20,37,170,19,9,200,1,2,Miami-Florida,22,28,88,54,37,352,2,1,V,-25.5,-2,9,82,-35,-28,-152,-1,1,2003
525,525,10/03/2003,Oregon,13,32,80,34,16,277,1,1,Utah,17,44,126,38,25,340,0,1,V,3,-4,-12,-46,-4,-9,-63,1,0,2003
526,526,10/03/2003,Utah,17,44,126,38,25,340,0,1,Oregon,13,32,80,34,16,277,1,1,H,-3,4,12,46,4,9,63,-1,0,2003
527,527,10/04/2003,Air Force,25,61,275,16,7,87,1,0,Navy,28,65,294,6,3,32,1,1,V,14.5,-3,-4,-19,10,4,55,0,-1,2003
528,528,10/04/2003,Akron,20,20,47,44,23,258,3,0,Miami-Ohio,45,42,184,47,31,369,0,0,V,-17,-25,-22,-137,-3,-8,-111,3,0,2003
529,529,10/04/2003,Alabama,23,31,94,29,11,115,1,2,Georgia,37,44,96,43,24,274,2,1,V,-12.5,-14,-13,-2,-14,-13,-159,-1,1,2003
530,530,10/04/2003,Alabama-Birmingham,24,41,95,28,14,231,0,0,Memphis,10,28,89,42,32,257,0,2,V,-9,14,13,6,-14,-18,-26,0,-2,2003
531,531,10/04/2003,Arizona,7,21,65,36,19,133,1,1,Washington State,30,42,161,37,22,352,1,2,V,-31,-23,-21,-96,-1,-3,-219,0,-1,2003
532,532,10/04/2003,Arizona State,17,44,61,38,19,305,1,1,Southern Cal,37,36,198,34,17,331,1,2,H,-10.5,-20,8,-137,4,2,-26,0,-1,2003
533,533,10/04/2003,Arkansas State,44,37,227,22,12,138,0,0,UL-Monroe,41,42,208,41,24,330,2,2,H,7,3,-5,19,-19,-12,-192,-2,-2,2003
534,534,10/04/2003,Army,0,33,28,30,14,176,1,1,Texas Christian,27,41,182,31,19,265,0,1,V,-31,-27,-8,-154,-1,-5,-89,1,0,2003
535,535,10/04/2003,Auburn,28,57,264,18,11,157,0,1,Tennessee,21,16,4,47,30,355,1,1,H,1,7,41,260,-29,-19,-198,-1,0,2003
536,536,10/04/2003,Ball State,34,47,107,27,16,164,0,3,Kent State,17,40,160,41,17,205,1,3,V,-2.5,17,7,-53,-14,-1,-41,-1,0,2003
537,537,10/04/2003,Baylor,42,56,203,28,18,207,0,1,Colorado,30,27,57,37,19,399,2,3,H,-18.5,12,29,146,-9,-1,-192,-2,-2,2003
538,538,10/04/2003,Boise State,43,45,163,61,41,569,0,3,Louisiana Tech,37,13,103,57,30,456,1,1,V,7,6,32,60,4,11,113,-1,2,2003
539,539,10/04/2003,Bowling Green,23,46,210,36,25,298,0,1,Central Michigan,3,42,158,29,15,126,0,0,H,29,20,4,52,7,10,172,0,1,2003
540,540,10/04/2003,Brigham Young,44,45,238,27,17,180,0,3,San Diego State,36,34,40,35,18,352,1,2,V,-3,8,11,198,-8,-1,-172,-1,1,2003
541,541,10/04/2003,Buffalo,10,39,178,26,12,93,0,1,U-C-F,19,55,298,14,6,59,0,1,V,-22.5,-9,-16,-120,12,6,34,0,0,2003
542,542,10/04/2003,California,21,29,185,34,9,52,1,1,Oregon State,35,53,269,27,18,224,1,0,H,1,-14,-24,-84,7,-9,-172,0,1,2003
543,543,10/04/2003,Central Michigan,3,42,158,29,15,126,0,0,Bowling Green,23,46,210,36,25,298,0,1,V,-29,-20,-4,-52,-7,-10,-172,0,-1,2003
544,544,10/04/2003,Cincinnati,20,55,213,25,11,106,2,1,Southern Miss,22,32,44,24,12,156,1,1,H,7,-2,23,169,1,-1,-50,1,0,2003
545,545,10/04/2003,Clemson,7,29,10,45,22,320,2,0,Maryland,21,44,134,27,14,204,0,1,V,-8.5,-14,-15,-124,18,8,116,2,-1,2003
546,546,10/04/2003,Colorado,30,27,57,37,19,399,2,3,Baylor,42,56,203,28,18,207,0,1,V,18.5,-12,-29,-146,9,1,192,2,2,2003
547,547,10/04/2003,Colorado State,34,41,270,29,17,197,2,0,Fresno State,10,35,179,32,17,158,2,0,H,4,24,6,91,-3,0,39,0,0,2003
548,548,10/04/2003,Connecticut,35,35,149,40,22,282,1,0,Lehigh,17,35,133,42,21,221,2,2,H, ,18,0,16,-2,1,61,-1,-2,2003
549,549,10/04/2003,Eastern Michigan,3,39,88,20,11,46,2,1,Western Michigan,31,31,95,32,19,282,1,0,H,-13,-28,8,-7,-12,-8,-236,1,1,2003
550,550,10/04/2003,Florida,17,35,142,27,14,234,3,0,Mississippi,20,36,223,29,17,262,1,1,H,11.5,-3,-1,-81,-2,-3,-28,2,-1,2003
551,551,10/04/2003,Fresno State,10,35,179,32,17,158,2,0,Colorado State,34,41,270,29,17,197,2,0,V,-4,-24,-6,-91,3,0,-39,0,0,2003
552,552,10/04/2003,Georgia,37,44,96,43,24,274,2,1,Alabama,23,31,94,29,11,115,1,2,H,12.5,14,13,2,14,13,159,1,-1,2003
553,553,10/04/2003,Georgia Tech,29,41,89,38,24,283,0,1,No Carolina State,21,19,-8,47,31,344,0,1,H,-6,8,22,97,-9,-7,-61,0,0,2003
554,554,10/04/2003,Hawaii,16,27,122,41,22,249,2,0,Tulsa,27,49,285,28,14,141,0,0,V,7.5,-11,-22,-163,13,8,108,2,0,2003
555,555,10/04/2003,Idaho,35,27,158,40,29,392,3,0,New Mexico State,31,51,298,24,18,270,0,1,V,-10,4,-24,-140,16,11,122,3,-1,2003
556,556,10/04/2003,Illinois,10,17,38,28,17,153,1,1,Purdue,43,67,324,20,13,209,0,1,V,-14.5,-33,-50,-286,8,4,-56,1,0,2003
557,557,10/04/2003,Indiana,3,45,117,31,14,168,0,1,Michigan State,31,27,104,41,33,382,0,0,V,-16,-28,18,13,-10,-19,-214,0,1,2003
558,558,10/04/2003,Iowa,30,37,100,34,17,195,1,0,Michigan,27,33,74,49,26,389,1,0,H,-3.5,3,4,26,-15,-9,-194,0,0,2003
559,559,10/04/2003,Iowa State,7,31,88,26,10,146,2,1,Oklahoma,53,41,199,39,29,414,1,0,H,-20.5,-46,-10,-111,-13,-19,-268,1,1,2003
560,560,10/04/2003,Kansas State,20,42,209,18,5,89,2,1,Texas,24,52,133,22,10,157,0,2,V,-6.5,-4,-10,76,-4,-5,-68,2,-1,2003
561,561,10/04/2003,Kent State,17,40,160,41,17,205,1,3,Ball State,34,45,138,27,16,164,0,1,H,2.5,-17,-5,22,14,1,41,1,2,2003
562,562,10/04/2003,Louisiana Tech,37,13,103,57,30,456,1,1,Boise State,43,45,163,61,41,569,0,3,H,-7,-6,-32,-60,-4,-11,-113,1,-2,2003
563,563,10/04/2003,Louisville,28,42,187,41,20,272,2,0,South Florida,31,38,119,48,26,256,3,0,V,1.5,-3,4,68,-7,-6,16,-1,0,2003
564,564,10/04/2003,Maryland,21,44,134,27,14,204,0,1,Clemson,7,29,10,45,22,320,2,0,H,8.5,14,15,124,-18,-8,-116,-2,1,2003
565,565,10/04/2003,Memphis,10,28,89,42,32,257,0,2,Alabama-Birmingham,24,41,95,28,14,231,0,0,H,9,-14,-13,-6,14,18,26,0,2,2003
566,566,10/04/2003,Miami-Ohio,45,42,184,47,31,369,0,0,Akron,20,20,47,44,23,258,3,0,H,17,25,22,137,3,8,111,-3,0,2003
567,567,10/04/2003,Michigan,27,33,74,49,26,389,1,0,Iowa,30,37,100,34,17,195,1,0,V,3.5,-3,-4,-26,15,9,194,0,0,2003
568,568,10/04/2003,Michigan State,31,27,104,41,33,382,0,0,Indiana,3,45,117,31,14,168,0,1,H,16,28,-18,-13,10,19,214,0,-1,2003
569,569,10/04/2003,Mid Tennessee St,36,55,227,29,18,205,2,2,Temple,44,40,170,38,18,197,0,1,H,3,-8,15,57,-9,0,8,2,1,2003
570,570,10/04/2003,Minnesota,42,44,241,17,12,331,0,0,Northwestern,17,35,76,34,21,208,2,0,V,10.5,25,9,165,-17,-9,123,-2,0,2003
571,571,10/04/2003,Mississippi,20,36,223,29,17,262,1,1,Florida,17,35,142,27,14,234,3,0,V,-11.5,3,1,81,2,3,28,-2,1,2003
572,572,10/04/2003,Mississippi State,30,44,203,30,18,215,1,1,Vanderbilt,21,39,95,35,22,295,1,2,H,3.5,9,5,108,-5,-4,-80,0,-1,2003
573,573,10/04/2003,Navy,28,65,294,6,3,32,1,1,Air Force,25,61,275,16,7,87,1,0,H,-14.5,3,4,19,-10,-4,-55,0,1,2003
574,574,10/04/2003,Nebraska,30,47,186,15,9,160,1,2,Troy State,0,37,66,23,11,84,2,2,H,27.5,30,10,120,-8,-2,76,-1,0,2003
575,575,10/04/2003,Nevada-Las Vegas,16,48,128,40,27,255,1,2,Nevada-Reno,12,27,92,36,13,180,2,0,V,6,4,21,36,4,14,75,-1,2,2003
576,576,10/04/2003,Nevada-Reno,12,27,92,36,13,180,2,0,Nevada-Las Vegas,16,48,128,40,27,255,1,2,H,-6,-4,-21,-36,-4,-14,-75,1,-2,2003
577,577,10/04/2003,New Mexico,34,51,160,28,14,244,1,0,Utah State,7,31,55,31,14,166,0,3,H,13,27,20,105,-3,0,78,1,-3,2003
578,578,10/04/2003,New Mexico State,31,51,298,24,18,270,0,1,Idaho,35,27,158,40,29,392,3,0,H,10,-4,24,140,-16,-11,-122,-3,1,2003
579,579,10/04/2003,No Carolina State,21,19,-8,47,31,344,0,1,Georgia Tech,29,41,89,38,24,283,0,1,V,6,-8,-22,-97,9,7,61,0,0,2003
580,580,10/04/2003,North Carolina,13,25,58,41,27,207,0,1,Virginia,38,46,229,23,20,286,0,1,H,-8.5,-25,-21,-171,18,7,-79,0,0,2003
581,581,10/04/2003,Northern Illinois,30,25,36,46,26,310,1,0,Ohio,23,66,244,16,5,98,0,0,H,21,7,-41,-208,30,21,212,1,0,2003
582,582,10/04/2003,Northwestern,17,35,76,34,21,208,2,0,Minnesota,42,44,241,17,12,331,0,0,H,-10.5,-25,-9,-165,17,9,-123,2,0,2003
583,583,10/04/2003,Ohio,23,66,244,16,5,98,0,0,Northern Illinois,30,25,36,46,26,310,1,0,V,-21,-7,41,208,-30,-21,-212,-1,0,2003
584,584,10/04/2003,Oklahoma,53,41,199,39,29,414,1,0,Iowa State,7,31,88,26,10,146,2,1,V,20.5,46,10,111,13,19,268,-1,-1,2003
585,585,10/04/2003,Oklahoma State,56,34,303,23,13,169,1,1,UL-Lafayette,3,33,72,41,27,275,1,0,H,36,53,1,231,-18,-14,-106,0,1,2003
586,586,10/04/2003,Oregon State,35,53,269,27,18,224,1,0,California,21,29,185,34,9,52,1,1,V,-1,14,24,84,-7,9,172,0,-1,2003
587,587,10/04/2003,Penn State,23,28,45,44,22,379,0,3,Wisconsin,30,51,234,26,9,140,0,1,H,0,-7,-23,-189,18,13,239,0,2,2003
588,588,10/04/2003,Purdue,43,67,324,20,13,209,0,1,Illinois,10,17,38,28,17,153,1,1,H,14.5,33,50,286,-8,-4,56,-1,0,2003
589,589,10/04/2003,Rice,28,61,297,13,10,110,1,1,San Jose State,24,34,151,33,26,261,0,0,H,4,4,27,146,-20,-16,-151,1,1,2003
590,590,10/04/2003,Rutgers,22,31,129,33,16,182,4,0,Virginia Tech,48,42,186,28,18,287,3,1,H,-28.5,-26,-11,-57,5,-2,-105,1,-1,2003
591,591,10/04/2003,San Diego State,36,34,40,35,18,352,1,2,Brigham Young,44,45,238,27,17,180,0,3,H,3,-8,-11,-198,8,1,172,1,-1,2003
592,592,10/04/2003,San Jose State,24,34,151,33,26,261,0,0,Rice,28,61,297,13,10,110,1,1,V,-4,-4,-27,-146,20,16,151,-1,-1,2003
593,593,10/04/2003,South Florida,31,38,119,48,26,256,3,0,Louisville,28,42,187,41,20,272,2,0,H,-1.5,3,-4,-68,7,6,-16,1,0,2003
594,594,10/04/2003,Southern Cal,37,36,198,34,17,331,1,2,Arizona State,17,44,61,38,19,305,1,1,V,10.5,20,-8,137,-4,-2,26,0,1,2003
595,595,10/04/2003,Southern Methodist,19,36,118,30,14,195,1,2,Texas-El Paso,21,49,232,17,8,190,0,0,H,8.5,-2,-13,-114,13,6,5,1,2,2003
596,596,10/04/2003,Southern Miss,22,32,44,24,12,156,1,1,Cincinnati,20,55,213,25,11,106,2,1,V,-7,2,-23,-169,-1,1,50,-1,0,2003
597,597,10/04/2003,Temple,44,40,170,38,18,197,0,1,Mid Tennessee St,36,55,227,29,18,205,2,2,V,-3,8,-15,-57,9,0,-8,-2,-1,2003
598,598,10/04/2003,Tennessee,21,16,4,47,30,355,1,1,Auburn,28,57,264,18,11,157,0,1,V,-1,-7,-41,-260,29,19,198,1,0,2003
599,599,10/04/2003,Texas,24,52,133,22,10,157,0,2,Kansas State,20,42,209,18,5,89,2,1,H,6.5,4,10,-76,4,5,68,-2,1,2003
600,600,10/04/2003,Texas A & M,28,38,184,32,16,305,0,1,Texas Tech,59,22,64,59,43,605,0,0,V,-5.5,-31,16,120,-27,-27,-300,0,1,2003
601,601,10/04/2003,Texas Christian,27,41,182,31,19,265,0,1,Army,0,33,28,30,14,176,1,1,H,31,27,8,154,1,5,89,-1,0,2003
602,602,10/04/2003,Texas Tech,59,22,64,59,43,605,0,0,Texas A & M,28,38,184,32,16,305,0,1,H,5.5,31,-16,-120,27,27,300,0,-1,2003
603,603,10/04/2003,Texas-El Paso,21,49,232,17,8,190,0,0,Southern Methodist,19,36,118,30,14,195,1,2,V,-8.5,2,13,114,-13,-6,-5,-1,-2,2003
604,604,10/04/2003,Troy State,0,37,66,23,11,84,2,2,Nebraska,30,47,186,15,9,160,1,2,V,-27.5,-30,-10,-120,8,2,-76,1,0,2003
605,605,10/04/2003,Tulsa,27,49,285,28,14,141,0,0,Hawaii,16,27,122,41,22,249,2,0,H,-7.5,11,22,163,-13,-8,-108,-2,0,2003
606,606,10/04/2003,U-C-F,19,55,298,14,6,59,0,1,Buffalo,10,39,178,26,12,93,0,1,H,22.5,9,16,120,-12,-6,-34,0,0,2003
607,607,10/04/2003,U.C.L.A.,46,41,134,24,16,258,1,0,Washington,16,31,77,46,26,281,3,1,H,-1.5,30,10,57,-22,-10,-23,-2,-1,2003
608,608,10/04/2003,UL-Lafayette,3,33,72,41,27,275,1,0,Oklahoma State,56,34,303,23,13,169,1,1,V,-36,-53,-1,-231,18,14,106,0,-1,2003
609,609,10/04/2003,UL-Monroe,41,42,208,41,24,330,2,2,Arkansas State,44,37,227,22,12,138,0,0,V,-7,-3,5,-19,19,12,192,2,2,2003
610,610,10/04/2003,Utah State,7,31,55,31,14,166,0,3,New Mexico,34,51,160,28,14,244,1,0,V,-13,-27,-20,-105,3,0,-78,-1,3,2003
611,611,10/04/2003,Vanderbilt,21,39,95,35,22,295,1,2,Mississippi State,30,44,203,30,18,215,1,1,V,-3.5,-9,-5,-108,5,4,80,0,1,2003
612,612,10/04/2003,Virginia,38,47,231,23,20,286,0,1,North Carolina,13,25,58,41,27,207,0,1,V,8.5,25,22,173,-18,-7,79,0,0,2003
613,613,10/04/2003,Virginia Tech,48,42,186,28,18,287,3,1,Rutgers,22,31,129,33,16,182,4,0,V,28.5,26,11,57,-5,2,105,-1,1,2003
614,614,10/04/2003,Washington,16,31,77,46,26,281,3,1,U.C.L.A.,46,41,134,24,16,258,1,0,V,1.5,-30,-10,-57,22,10,23,2,1,2003
615,615,10/04/2003,Washington State,30,42,161,37,22,352,1,2,Arizona,7,21,65,36,19,133,1,1,H,31,23,21,96,1,3,219,0,1,2003
616,616,10/04/2003,Western Michigan,31,31,95,32,19,282,1,0,Eastern Michigan,3,40,90,20,11,46,2,1,V,13,28,-9,5,12,8,236,-1,-1,2003
617,617,10/04/2003,Wisconsin,30,51,234,26,9,140,0,1,Penn State,23,28,45,44,22,379,0,3,V,0,7,23,189,-18,-13,-239,0,-2,2003
618,618,10/09/2003,Brigham Young,13,38,130,27,11,139,2,2,Colorado State,58,51,214,15,10,232,0,2,H,-1.5,-45,-13,-84,12,1,-93,2,0,2003
619,619,10/09/2003,Colorado State,58,51,214,15,10,232,0,2,Brigham Young,13,38,130,27,11,139,2,2,V,1.5,45,13,84,-12,-1,93,-2,0,2003
620,620,10/09/2003,Kentucky,21,30,117,32,17,210,0,1,South Carolina,27,47,182,29,17,184,0,0,V,-8,-6,-17,-65,3,0,26,0,1,2003
621,621,10/09/2003,South Carolina,27,47,182,29,17,184,0,0,Kentucky,21,30,117,32,17,210,0,1,H,8,6,17,65,-3,0,-26,0,-1,2003
622,622,10/10/2003,Michigan,38,31,94,48,34,389,1,0,Minnesota,35,53,424,19,8,71,2,0,V,2,3,-22,-330,29,26,318,-1,0,2003
623,623,10/10/2003,Minnesota,35,53,424,19,8,71,2,0,Michigan,38,31,94,48,34,389,1,0,H,-2,-3,22,330,-29,-26,-318,1,0,2003
624,624,10/10/2003,South Florida,10,35,22,26,15,104,0,1,Texas Christian,13,45,100,19,10,133,0,0,H,2.5,-3,-10,-78,7,5,-29,0,1,2003
625,625,10/10/2003,Texas Christian,13,45,100,19,10,133,0,0,South Florida,10,35,22,26,15,104,0,1,V,-2.5,3,10,78,-7,-5,29,0,-1,2003
626,626,10/11/2003,Air Force,24,59,261,10,5,63,0,0,Nevada-Las Vegas,7,41,166,20,8,84,1,1,H,7,17,18,95,-10,-3,-21,-1,-1,2003
627,627,10/11/2003,Akron,45,49,198,21,13,209,0,0,Cal-San Luis Obispo,14,32,148,29,8,145,1,0,H, ,31,17,50,-8,5,64,-1,0,2003
628,628,10/11/2003,Alabama,17,50,243,7,3,12,1,0,Southern Miss,3,35,17,37,22,244,0,2,H,10.5,14,15,226,-30,-19,-232,1,-2,2003
629,629,10/11/2003,Alabama-Birmingham,31,45,105,21,12,277,1,0,Cincinnati,14,30,100,43,21,219,0,1,H,-5.5,17,15,5,-22,-9,58,1,-1,2003
630,630,10/11/2003,Arizona,21,42,276,31,17,243,4,0,U.C.L.A.,24,34,103,30,19,230,2,1,H,-17.5,-3,8,173,1,-2,13,2,-1,2003
631,631,10/11/2003,Arizona State,59,44,159,30,20,338,0,0,Oregon,14,33,158,26,9,127,2,0,H,-1.5,45,11,1,4,11,211,-2,0,2003
632,632,10/11/2003,Arkansas,3,39,173,28,13,168,0,1,Auburn,10,42,160,18,10,118,1,0,H,4,-7,-3,13,10,3,50,-1,1,2003
633,633,10/11/2003,Arkansas State,0,28,54,40,18,181,1,0,Mississippi,55,43,192,40,27,390,1,1,V,-26,-55,-15,-138,0,-9,-209,0,-1,2003
634,634,10/11/2003,Army,10,26,97,55,28,242,3,0,Louisville,34,37,208,32,20,411,1,2,V,-31.5,-24,-11,-111,23,8,-169,2,-2,2003
635,635,10/11/2003,Auburn,10,42,160,18,10,118,1,0,Arkansas,3,39,173,28,13,168,0,1,V,-4,7,3,-13,-10,-3,-50,1,-1,2003
636,636,10/11/2003,Baylor,10,41,32,30,17,152,2,2,Texas A & M,73,49,437,24,15,282,1,1,V,-18.5,-63,-8,-405,6,2,-130,1,1,2003
637,637,10/11/2003,Boise State,27,44,164,27,12,199,1,0,Tulsa,20,32,110,35,22,229,1,0,H,22,7,12,54,-8,-10,-30,0,0,2003
638,638,10/11/2003,Boston College,38,41,298,27,20,350,0,2,Temple,13,27,65,47,26,212,2,0,V,9.5,25,14,233,-20,-6,138,-2,2,2003
639,639,10/11/2003,Bowling Green,32,49,224,39,27,286,2,1,Western Michigan,21,20,57,36,18,330,4,0,V,9,11,29,167,3,9,-44,-2,1,2003
640,640,10/11/2003,Buffalo,3,41,158,23,11,86,1,0,Miami-Ohio,59,38,223,31,21,264,0,1,V,-35,-56,3,-65,-8,-10,-178,1,-1,2003
641,641,10/11/2003,Central Michigan,24,45,145,30,17,215,4,0,Northern Illinois,40,47,206,27,17,198,0,1,H,-18.5,-16,-2,-61,3,0,17,4,-1,2003
642,642,10/11/2003,Cincinnati,14,30,100,43,21,219,0,1,Alabama-Birmingham,31,45,105,21,12,277,1,0,V,5.5,-17,-15,-5,22,9,-58,-1,1,2003
643,643,10/11/2003,Clemson,30,46,194,45,28,294,1,0,Virginia,27,22,53,48,33,271,2,0,H,-5,3,24,141,-3,-5,23,-1,0,2003
644,644,10/11/2003,Colorado,50,39,179,54,38,419,1,2,Kansas,47,37,164,31,20,422,0,0,H,6,3,2,15,23,18,-3,1,2,2003
645,645,10/11/2003,Connecticut,24,39,153,39,21,299,1,1,No Carolina State,31,31,89,42,23,234,1,0,V,-15,-7,8,64,-3,-2,65,0,1,2003
646,646,10/11/2003,Duke,20,45,143,47,20,270,1,1,Maryland,33,31,131,32,18,238,1,1,V,-28,-13,14,12,15,2,32,0,0,2003
647,647,10/11/2003,East Carolina,17,45,164,17,13,125,0,1,North Carolina,28,43,189,25,15,198,0,1,H,-9,-11,2,-25,-8,-2,-73,0,0,2003
648,648,10/11/2003,Eastern Michigan,14,38,129,34,16,118,2,1,Toledo,49,38,172,33,26,307,0,0,V,-27,-35,0,-43,1,-10,-189,2,1,2003
649,649,10/11/2003,Florida,19,40,81,30,18,229,0,1,Louisiana State,7,24,56,33,19,231,2,1,V,-10,12,16,25,-3,-1,-2,-2,0,2003
650,650,10/11/2003,Florida State,14,37,61,42,20,235,2,3,Miami-Florida,22,34,131,28,15,181,3,2,H,7,-8,3,-70,14,5,54,-1,1,2003
651,651,10/11/2003,Fresno State,28,34,140,38,25,242,0,3,Hawaii,55,20,145,64,42,404,0,1,V,-4,-27,14,-5,-26,-17,-162,0,2,2003
652,652,10/11/2003,Georgia,41,45,186,28,22,228,1,0,Tennessee,14,27,61,27,13,187,2,2,V,1,27,18,125,1,9,41,-1,-2,2003
653,653,10/11/2003,Georgia Tech,24,47,216,24,12,225,0,0,Wake Forest,7,32,145,28,14,132,2,0,V,-4,17,15,71,-4,-2,93,-2,0,2003
654,654,10/11/2003,Hawaii,55,20,145,64,42,404,0,1,Fresno State,28,34,140,38,25,242,0,3,H,4,27,-14,5,26,17,162,0,-2,2003
655,655,10/11/2003,Houston,45,66,256,39,22,283,1,0,Tulane,42,21,116,34,25,264,1,2,V,1,3,45,140,5,-3,19,0,-2,2003
656,656,10/11/2003,Idaho,14,28,92,41,23,402,1,2,North Texas,24,47,249,23,15,141,0,0,H,-7.5,-10,-19,-157,18,8,261,1,2,2003
657,657,10/11/2003,Illinois,14,43,158,39,26,213,2,1,Michigan State,49,29,102,31,23,317,0,0,H,-3.5,-35,14,56,8,3,-104,2,1,2003
658,658,10/11/2003,Indiana,31,58,327,20,13,204,2,0,Northwestern,37,51,192,20,13,191,0,0,H,-3.5,-6,7,135,0,0,13,2,0,2003
659,659,10/11/2003,Iowa State,21,30,85,33,16,270,1,1,Texas Tech,52,33,240,78,52,535,2,2,V,-18,-31,-3,-155,-45,-36,-265,-1,-1,2003
660,660,10/11/2003,Kansas,47,37,164,31,20,422,0,0,Colorado,50,39,179,54,38,419,1,2,V,-6,-3,-2,-15,-23,-18,3,-1,-2,2003
661,661,10/11/2003,Kansas State,34,44,146,34,20,332,3,0,Oklahoma State,38,45,187,21,12,190,1,0,V,2.5,-4,-1,-41,13,8,142,2,0,2003
662,662,10/11/2003,Kent State,33,38,88,32,16,348,1,0,Marshall,49,41,212,32,27,392,2,1,V,-20,-16,-3,-124,0,-11,-44,-1,-1,2003
663,663,10/11/2003,Louisiana State,7,24,56,33,19,231,2,1,Florida,19,40,81,30,18,229,0,1,H,10,-12,-16,-25,3,1,2,2,0,2003
664,664,10/11/2003,Louisiana Tech,38,39,165,40,22,328,0,1,Texas-El Paso,35,38,250,33,18,285,2,0,V,15.5,3,1,-85,7,4,43,-2,1,2003
665,665,10/11/2003,Louisville,34,37,208,32,20,411,1,2,Army,10,26,97,55,28,242,3,0,H,31.5,24,11,111,-23,-8,169,-2,2,2003
666,666,10/11/2003,Marshall,49,41,212,32,27,392,2,1,Kent State,33,38,88,32,16,348,1,0,H,20,16,3,124,0,11,44,1,1,2003
667,667,10/11/2003,Maryland,33,31,131,32,18,238,1,1,Duke,20,45,143,47,20,270,1,1,H,28,13,-14,-12,-15,-2,-32,0,0,2003
668,668,10/11/2003,Memphis,27,28,170,61,32,398,2,0,Mississippi State,35,37,136,34,16,245,1,0,V,-3,-8,-9,34,27,16,153,1,0,2003
669,669,10/11/2003,Miami-Florida,22,34,131,28,15,181,3,2,Florida State,14,37,61,42,20,235,2,3,V,-7,8,-3,70,-14,-5,-54,1,-1,2003
670,670,10/11/2003,Miami-Ohio,59,38,223,31,21,264,0,1,Buffalo,3,41,158,23,11,86,1,0,H,35,56,-3,65,8,10,178,-1,1,2003
671,671,10/11/2003,Michigan State,49,29,102,31,23,317,0,0,Illinois,14,43,158,39,26,213,2,1,V,3.5,35,-14,-56,-8,-3,104,-2,-1,2003
672,672,10/11/2003,Mid Tennessee St,35,37,85,12,9,208,0,0,New Mexico State,18,54,318,32,18,207,3,1,H,3.5,17,-17,-233,-20,-9,1,-3,-1,2003
673,673,10/11/2003,Mississippi,55,43,192,40,27,390,1,1,Arkansas State,0,28,54,40,18,181,1,0,H,26,55,15,138,0,9,209,0,1,2003
674,674,10/11/2003,Mississippi State,35,37,136,34,16,245,1,0,Memphis,27,28,170,61,32,398,2,0,H,3,8,9,-34,-27,-16,-153,-1,0,2003
675,675,10/11/2003,Missouri,41,44,211,29,15,241,2,0,Nebraska,24,54,253,19,12,146,1,4,H,-8,17,-10,-42,10,3,95,1,-4,2003
676,676,10/11/2003,Navy,37,65,342,17,9,160,0,0,Vanderbilt,27,31,146,30,18,227,0,1,V,-4.5,10,34,196,-13,-9,-67,0,-1,2003
677,677,10/11/2003,Nebraska,24,54,253,19,12,146,1,4,Missouri,41,44,211,29,15,241,2,0,V,8,-17,10,42,-10,-3,-95,-1,4,2003
678,678,10/11/2003,Nevada-Las Vegas,7,41,166,20,8,84,1,1,Air Force,24,59,261,10,5,63,0,0,V,-7,-17,-18,-95,10,3,21,1,1,2003
679,679,10/11/2003,Nevada-Reno,28,33,98,30,19,299,1,0,Washington,17,48,110,37,19,337,3,2,V,-17.5,11,-15,-12,-7,0,-38,-2,-2,2003
680,680,10/11/2003,New Mexico State,18,53,322,31,19,223,3,1,Mid Tennessee St,35,37,85,12,9,208,0,0,V,-3.5,-17,16,237,19,10,15,3,1,2003
681,681,10/11/2003,No Carolina State,31,31,89,42,23,234,1,0,Connecticut,24,39,153,39,21,299,1,1,H,15,7,-8,-64,3,2,-65,0,-1,2003
682,682,10/11/2003,North Carolina,28,43,189,25,15,198,0,1,East Carolina,17,45,164,17,13,125,0,1,V,9,11,-2,25,8,2,73,0,0,2003
683,683,10/11/2003,North Texas,24,48,245,24,14,125,0,0,Idaho,14,28,92,41,23,402,1,2,V,7.5,10,20,153,-17,-9,-277,-1,-2,2003
684,684,10/11/2003,Northern Illinois,40,47,206,27,17,198,0,1,Central Michigan,24,45,145,30,17,215,4,0,V,18.5,16,2,61,-3,0,-17,-4,1,2003
685,685,10/11/2003,Northwestern,37,51,192,20,13,191,0,0,Indiana,31,58,327,20,13,204,2,0,V,3.5,6,-7,-135,0,0,-13,-2,0,2003
686,686,10/11/2003,Notre Dame,20,56,352,17,5,33,1,0,Pittsburgh,14,27,8,30,12,167,0,2,V,-8,6,29,344,-13,-7,-134,1,-2,2003
687,687,10/11/2003,Ohio,28,63,246,6,6,144,0,1,U-C-F,0,22,-6,24,8,104,0,2,H,3.5,28,41,252,-18,-2,40,0,-1,2003
688,688,10/11/2003,Ohio State,10,26,69,26,14,202,1,1,Wisconsin,17,48,141,10,7,158,1,1,V,2.5,-7,-22,-72,16,7,44,0,0,2003
689,689,10/11/2003,Oklahoma,65,47,189,24,20,363,0,1,Texas,13,34,171,30,15,156,3,3,N,6.5,52,13,18,-6,5,207,-3,-2,2003
690,690,10/11/2003,Oklahoma State,38,45,187,21,12,190,1,0,Kansas State,34,44,146,34,20,332,3,0,H,-2.5,4,1,41,-13,-8,-142,-2,0,2003
691,691,10/11/2003,Oregon,14,33,158,26,9,127,2,0,Arizona State,59,44,159,30,20,338,0,0,V,1.5,-45,-11,-1,-4,-11,-211,2,0,2003
692,692,10/11/2003,Penn State,14,27,106,32,10,98,2,1,Purdue,28,51,219,28,17,131,1,0,V,-11.5,-14,-24,-113,4,-7,-33,1,1,2003
693,693,10/11/2003,Pittsburgh,14,27,8,30,12,167,0,2,Notre Dame,20,56,352,17,5,33,1,0,H,8,-6,-29,-344,13,7,134,-1,2,2003
694,694,10/11/2003,Purdue,28,51,219,28,17,131,1,0,Penn State,14,27,106,32,10,98,2,1,H,11.5,14,24,113,-4,7,33,-1,-1,2003
695,695,10/11/2003,Rutgers,19,32,114,29,18,178,2,0,West Virginia,34,59,254,15,7,187,1,1,V,-18,-15,-27,-140,14,11,-9,1,-1,2003
696,696,10/11/2003,San Diego State,6,24,49,36,19,203,1,0,Utah,27,42,142,22,17,273,0,1,V,-8.5,-21,-18,-93,14,2,-70,1,-1,2003
697,697,10/11/2003,San Jose State,48,39,154,41,23,294,1,0,Southern Methodist,14,30,69,20,11,198,2,0,H,8.5,34,9,85,21,12,96,-1,0,2003
698,698,10/11/2003,Southern Cal,44,41,220,31,19,273,0,1,Stanford,21,31,86,40,19,156,2,2,H,22,23,10,134,-9,0,117,-2,-1,2003
699,699,10/11/2003,Southern Methodist,14,30,69,20,11,198,2,0,San Jose State,48,39,154,41,23,294,1,0,V,-8.5,-34,-9,-85,-21,-12,-96,1,0,2003
700,700,10/11/2003,Southern Miss,3,35,17,37,22,244,0,2,Alabama,17,50,243,7,3,12,1,0,V,-10.5,-14,-15,-226,30,19,232,-1,2,2003
701,701,10/11/2003,Stanford,21,31,86,40,19,156,2,2,Southern Cal,44,41,220,31,19,273,0,1,V,-22,-23,-10,-134,9,0,-117,2,1,2003
702,702,10/11/2003,Syracuse,7,35,81,23,8,91,0,1,Virginia Tech,51,45,337,20,8,102,1,1,V,-17.5,-44,-10,-256,3,0,-11,-1,0,2003
703,703,10/11/2003,Temple,13,27,65,47,26,212,2,0,Boston College,38,41,298,27,20,350,0,2,H,-9.5,-25,-14,-233,20,6,-138,2,-2,2003
704,704,10/11/2003,Tennessee,14,27,61,27,13,187,2,2,Georgia,41,45,186,28,22,228,1,0,H,-1,-27,-18,-125,-1,-9,-41,1,2,2003
705,705,10/11/2003,Texas,13,34,171,30,15,156,3,3,Oklahoma,65,47,189,24,20,363,0,1,N,-6.5,-52,-13,-18,6,-5,-207,3,2,2003
706,706,10/11/2003,Texas A & M,73,49,437,24,15,282,1,1,Baylor,10,41,32,30,17,152,2,2,H,18.5,63,8,405,-6,-2,130,-1,-1,2003
707,707,10/11/2003,Texas Tech,52,33,240,78,52,535,2,2,Iowa State,21,30,85,33,16,270,1,1,H,18,31,3,155,45,36,265,1,1,2003
708,708,10/11/2003,Texas-El Paso,35,38,250,33,18,285,2,0,Louisiana Tech,38,39,165,40,22,328,0,1,H,-15.5,-3,-1,85,-7,-4,-43,2,-1,2003
709,709,10/11/2003,Toledo,49,38,172,33,26,307,0,0,Eastern Michigan,14,38,129,34,16,118,2,1,H,27,35,0,43,-1,10,189,-2,-1,2003
710,710,10/11/2003,Tulane,42,21,116,34,25,264,1,2,Houston,45,66,256,39,22,283,1,0,H,-1,-3,-45,-140,-5,3,-19,0,2,2003
711,711,10/11/2003,Tulsa,20,32,110,35,22,229,1,0,Boise State,27,44,164,27,12,199,1,0,V,-22,-7,-12,-54,8,10,30,0,0,2003
712,712,10/11/2003,U-C-F,0,22,-6,24,8,104,0,2,Ohio,28,63,246,6,6,144,0,1,V,-3.5,-28,-41,-252,18,2,-40,0,1,2003
713,713,10/11/2003,U.C.L.A.,24,34,103,30,19,230,2,1,Arizona,21,42,276,31,17,243,4,0,V,17.5,3,-8,-173,-1,2,-13,-2,1,2003
714,714,10/11/2003,UL-Lafayette,42,23,50,54,33,474,2,0,UL-Monroe,45,47,238,30,21,299,0,2,H,3,-3,-24,-188,24,12,175,2,-2,2003
715,715,10/11/2003,UL-Monroe,45,47,238,30,21,299,0,2,UL-Lafayette,42,23,50,54,33,474,2,0,V,-3,3,24,188,-24,-12,-175,-2,2,2003
716,716,10/11/2003,Utah,27,42,142,22,17,273,0,1,San Diego State,6,24,49,36,19,203,1,0,H,8.5,21,18,93,-14,-2,70,-1,1,2003
717,717,10/11/2003,Utah State,21,25,117,36,17,240,1,2,Wyoming,48,47,192,25,14,242,0,0,H,-2,-27,-22,-75,11,3,-2,1,2,2003
718,718,10/11/2003,Vanderbilt,27,31,146,30,18,227,0,1,Navy,37,65,342,17,9,160,0,0,H,4.5,-10,-34,-196,13,9,67,0,1,2003
719,719,10/11/2003,Virginia,27,22,53,48,33,271,2,0,Clemson,30,46,194,45,28,294,1,0,V,5,-3,-24,-141,3,5,-23,1,0,2003
720,720,10/11/2003,Virginia Tech,51,45,337,20,8,102,1,1,Syracuse,7,35,81,23,8,91,0,1,H,17.5,44,10,256,-3,0,11,1,0,2003
721,721,10/11/2003,Wake Forest,7,32,145,28,14,132,2,0,Georgia Tech,24,47,216,24,12,225,0,0,H,4,-17,-15,-71,4,2,-93,2,0,2003
722,722,10/11/2003,Washington,17,48,110,37,19,337,3,2,Nevada-Reno,28,33,98,30,19,299,1,0,H,17.5,-11,15,12,7,0,38,2,2,2003
723,723,10/11/2003,West Virginia,34,59,254,15,7,187,1,1,Rutgers,19,32,114,29,18,178,2,0,H,18,15,27,140,-14,-11,9,-1,1,2003
724,724,10/11/2003,Western Michigan,21,20,57,36,18,330,4,0,Bowling Green,32,49,224,39,27,286,2,1,H,-9,-11,-29,-167,-3,-9,44,2,-1,2003
725,725,10/11/2003,Wisconsin,17,48,141,10,7,158,1,1,Ohio State,10,26,69,26,14,202,1,1,H,-2.5,7,22,72,-16,-7,-44,0,0,2003
726,726,10/11/2003,Wyoming,48,47,192,25,14,242,0,0,Utah State,21,25,117,36,17,240,1,2,V,2,27,22,75,-11,-3,2,-1,-2,2003
727,727,10/16/2003,Air Force,20,52,276,14,4,154,2,1,Colorado State,30,53,306,22,14,258,0,1,V,-5.5,-10,-1,-30,-8,-10,-104,2,0,2003
728,728,10/16/2003,Clemson,15,29,127,37,23,196,1,0,No Carolina State,17,36,70,34,20,213,0,1,V,-4.5,-2,-7,57,3,3,-17,1,-1,2003
729,729,10/16/2003,Colorado State,30,53,306,22,14,258,0,1,Air Force,20,52,276,14,4,154,2,1,H,5.5,10,1,30,8,10,104,-2,0,2003
730,730,10/16/2003,New Mexico State,24,47,226,26,13,212,2,0,UL-Lafayette,26,28,135,47,25,245,2,0,V,7,-2,19,91,-21,-12,-33,0,0,2003
731,731,10/16/2003,No Carolina State,17,36,70,34,20,213,0,1,Clemson,15,29,127,37,23,196,1,0,H,4.5,2,7,-57,-3,-3,17,-1,1,2003
732,732,10/16/2003,UL-Lafayette,26,28,135,47,25,245,2,0,New Mexico State,24,47,226,26,13,212,2,0,H,-7,2,-19,-91,21,12,33,0,0,2003
733,733,10/17/2003,Louisville,47,42,288,28,17,212,0,1,Tulane,28,42,160,29,16,243,2,2,H,15,19,0,128,-1,1,-31,-2,-1,2003
734,734,10/17/2003,Tulane,28,42,160,29,16,243,2,2,Louisville,47,42,288,28,17,212,0,1,V,-15,-19,0,-128,1,-1,31,2,1,2003
735,735,10/18/2003,Akron,38,47,197,38,27,307,0,0,U-C-F,24,20,58,34,25,259,2,1,H,8,14,27,139,4,2,48,-2,-1,2003
736,736,10/18/2003,Alabama,28,30,116,29,21,248,2,1,Mississippi,43,50,216,22,14,230,0,0,V,-3,-15,-20,-100,7,7,18,2,1,2003
737,737,10/18/2003,Alabama-Birmingham,24,27,97,30,11,296,2,1,Texas Christian,27,48,212,36,18,193,2,0,V,-11,-3,-21,-115,-6,-7,103,0,1,2003
738,738,10/18/2003,Arizona State,33,35,190,59,34,408,0,1,North Carolina,31,34,164,23,13,167,0,2,V,7.5,2,1,26,36,21,241,0,-1,2003
739,739,10/18/2003,Arkansas,28,34,186,45,24,343,3,0,Florida,33,35,142,34,20,269,1,0,H,6,-5,-1,44,11,4,74,2,0,2003
740,740,10/18/2003,Army,32,32,88,31,19,235,2,1,East Carolina,38,57,204,23,17,163,1,0,H,-5.5,-6,-25,-116,8,2,72,1,1,2003
741,741,10/18/2003,Auburn,45,56,405,19,12,148,1,1,Mississippi State,13,29,102,30,15,192,1,2,H,21,32,27,303,-11,-3,-44,0,-1,2003
742,742,10/18/2003,Ball State,3,31,29,30,12,153,4,1,Miami-Ohio,49,40,168,35,25,235,0,1,H,-19,-46,-9,-139,-5,-13,-82,4,0,2003
743,743,10/18/2003,Baylor,21,33,110,24,15,175,1,0,Kansas,28,37,132,30,19,252,0,0,V,-23,-7,-4,-22,-6,-4,-77,1,0,2003
744,744,10/18/2003,Boise State,45,32,81,45,32,560,0,0,Southern Methodist,3,37,80,32,13,134,1,0,V,24,42,-5,1,13,19,426,-1,0,2003
745,745,10/18/2003,Boston College,14,30,70,31,20,249,2,0,Syracuse,39,50,192,27,20,215,0,1,V,4,-25,-20,-122,4,0,34,2,-1,2003
746,746,10/18/2003,Bowling Green,33,46,305,25,17,187,0,1,Eastern Michigan,20,42,144,24,14,170,0,0,V,28,13,4,161,1,3,17,0,1,2003
747,747,10/18/2003,Brigham Young,10,36,103,36,21,225,2,1,Wyoming,13,32,85,32,20,140,2,1,V,1.5,-3,4,18,4,1,85,0,0,2003
748,748,10/18/2003,Buffalo,16,44,139,23,15,140,1,0,Marshall,26,32,94,42,26,292,0,2,H,-26,-10,12,45,-19,-11,-152,1,-2,2003
749,749,10/18/2003,California,20,35,75,42,28,322,0,0,U.C.L.A.,23,39,55,20,9,173,0,1,V,-2.5,-3,-4,20,22,19,149,0,-1,2003
750,750,10/18/2003,Central Michigan,13,36,135,33,11,178,0,0,Toledo,31,62,422,36,23,221,0,0,H,-15,-18,-26,-287,-3,-12,-43,0,0,2003
751,751,10/18/2003,Colorado,20,32,132,45,29,290,1,0,Kansas State,49,40,142,28,20,242,0,0,V,-20,-29,-8,-10,17,9,48,1,0,2003
752,752,10/18/2003,Connecticut,34,41,222,51,28,293,1,1,Kent State,31,39,115,26,11,204,0,0,V,13,3,2,107,25,17,89,1,1,2003
753,753,10/18/2003,Duke,13,37,119,49,23,267,1,1,Wake Forest,42,56,256,4,4,78,0,0,H,-9.5,-29,-19,-137,45,19,189,1,1,2003
754,754,10/18/2003,East Carolina,38,57,204,23,17,163,1,0,Army,32,32,88,31,19,235,2,1,V,5.5,6,25,116,-8,-2,-72,-1,-1,2003
755,755,10/18/2003,Eastern Michigan,20,42,144,24,14,170,0,0,Bowling Green,33,46,305,25,17,187,0,1,H,-28,-13,-4,-161,-1,-3,-17,0,-1,2003
756,756,10/18/2003,Florida,33,37,130,34,20,269,1,0,Arkansas,28,34,186,45,24,343,3,0,V,-6,5,3,-56,-11,-4,-74,-2,0,2003
757,757,10/18/2003,Florida State,19,45,196,25,12,189,0,0,Virginia,14,9,-5,54,39,326,1,1,V,7.5,5,36,201,-29,-27,-137,-1,-1,2003
758,758,10/18/2003,Georgia,27,40,135,30,19,208,1,0,Vanderbilt,8,39,116,21,11,102,1,1,V,26.5,19,1,19,9,8,106,0,-1,2003
759,759,10/18/2003,Hawaii,44,23,104,46,33,534,4,1,Louisiana Tech,41,46,218,49,31,405,1,0,V,-1.5,3,-23,-114,-3,2,129,3,1,2003
760,760,10/18/2003,Houston,14,44,160,28,16,163,1,1,Memphis,45,45,255,27,14,232,0,0,H,5,-31,-1,-95,1,2,-69,1,1,2003
761,761,10/18/2003,Idaho,21,38,95,33,22,296,1,1,Mid Tennessee St,28,51,222,29,18,298,1,2,H,-2.5,-7,-13,-127,4,4,-2,0,-1,2003
762,762,10/18/2003,Illinois,14,29,89,28,16,163,1,1,Michigan,56,49,275,34,22,244,0,0,V,-27.5,-42,-20,-186,-6,-6,-81,1,1,2003
763,763,10/18/2003,Iowa,10,40,66,27,14,153,1,2,Ohio State,19,42,56,22,11,129,0,1,V,-2.5,-9,-2,10,5,3,24,1,1,2003
764,764,10/18/2003,Iowa State,19,29,105,34,11,172,0,0,Texas,40,53,235,26,19,343,1,0,H,-19,-21,-24,-130,8,-8,-171,-1,0,2003
765,765,10/18/2003,Kansas,28,37,132,30,19,252,0,0,Baylor,21,33,110,24,15,175,1,0,H,23,7,4,22,6,4,77,-1,0,2003
766,766,10/18/2003,Kansas State,49,40,142,28,20,242,0,0,Colorado,20,32,132,45,29,290,1,0,H,20,29,8,10,-17,-9,-48,-1,0,2003
767,767,10/18/2003,Kent State,31,39,115,26,11,204,0,0,Connecticut,34,41,222,51,28,293,1,1,H,-13,-3,-2,-107,-25,-17,-89,-1,-1,2003
768,768,10/18/2003,Kentucky,35,42,177,23,11,144,0,2,Ohio,14,49,148,18,10,147,1,2,H,13,21,-7,29,5,1,-3,-1,0,2003
769,769,10/18/2003,Louisiana State,33,52,263,32,26,219,1,0,South Carolina,7,17,0,32,15,254,0,1,V,3.5,26,35,263,0,11,-35,1,-1,2003
770,770,10/18/2003,Louisiana Tech,41,46,218,49,31,405,1,0,Hawaii,44,23,104,46,33,534,4,1,H,1.5,-3,23,114,3,-2,-129,-3,-1,2003
771,771,10/18/2003,Marshall,26,32,94,42,26,292,0,2,Buffalo,16,44,139,23,15,140,1,0,V,26,10,-12,-45,19,11,152,-1,2,2003
772,772,10/18/2003,Memphis,45,45,255,27,14,232,0,0,Houston,14,44,160,28,16,163,1,1,V,-5,31,1,95,-1,-2,69,-1,-1,2003
773,773,10/18/2003,Miami-Florida,52,46,342,33,22,259,0,1,Temple,14,27,150,14,5,21,0,1,H,32,38,19,192,19,17,238,0,0,2003
774,774,10/18/2003,Miami-Ohio,49,40,168,35,25,235,0,1,Ball State,3,31,29,30,12,153,4,1,V,19,46,9,139,5,13,82,-4,0,2003
775,775,10/18/2003,Michigan,56,49,275,34,22,244,0,0,Illinois,14,29,89,28,16,163,1,1,H,27.5,42,20,186,6,6,81,-1,-1,2003
776,776,10/18/2003,Michigan State,44,31,161,46,30,252,0,0,Minnesota,38,39,148,40,27,377,0,3,V,-6,6,-8,13,6,3,-125,0,-3,2003
777,777,10/18/2003,Mid Tennessee St,28,51,222,29,18,298,1,2,Idaho,21,38,95,33,22,296,1,1,V,2.5,7,13,127,-4,-4,2,0,1,2003
778,778,10/18/2003,Minnesota,38,39,148,40,27,377,0,3,Michigan State,44,31,161,46,30,252,0,0,H,6,-6,8,-13,-6,-3,125,0,3,2003
779,779,10/18/2003,Mississippi,43,50,216,22,14,230,0,0,Alabama,28,30,116,29,21,248,2,1,H,3,15,20,100,-7,-7,-18,-2,-1,2003
780,780,10/18/2003,Mississippi State,13,29,102,30,15,192,1,2,Auburn,45,56,405,19,12,148,1,1,V,-21,-32,-27,-303,11,3,44,0,1,2003
781,781,10/18/2003,Missouri,13,35,77,35,16,189,1,0,Oklahoma,34,35,146,34,20,278,1,0,V,-26,-21,0,-69,1,-4,-89,0,0,2003
782,782,10/18/2003,Navy,38,69,366,10,6,76,0,0,Rice,6,47,206,14,6,17,1,1,V,2.5,32,22,160,-4,0,59,-1,-1,2003
783,783,10/18/2003,Nebraska,48,68,333,9,3,51,0,0,Texas A & M,12,37,135,27,9,109,5,3,H,8.5,36,31,198,-18,-6,-58,-5,-3,2003
784,784,10/18/2003,Nevada-Las Vegas,10,35,85,31,13,211,0,2,Utah,28,51,220,24,16,221,0,1,H,-2.5,-18,-16,-135,7,-3,-10,0,1,2003
785,785,10/18/2003,Nevada-Reno,28,41,223,27,13,143,1,0,Tulsa,21,41,204,32,14,160,2,3,V,-2.5,7,0,19,-5,-1,-17,-1,-3,2003
786,786,10/18/2003,New Mexico,30,52,207,16,8,119,1,1,San Diego State,7,25,38,59,32,354,5,1,V,1.5,23,27,169,-43,-24,-235,-4,0,2003
787,787,10/18/2003,North Carolina,31,34,164,23,13,167,0,2,Arizona State,33,35,190,59,34,408,0,1,H,-7.5,-2,-1,-26,-36,-21,-241,0,1,2003
788,788,10/18/2003,North Texas,37,49,209,14,8,109,0,2,Utah State,27,25,78,38,26,230,1,1,H,15.5,10,24,131,-24,-18,-121,-1,1,2003
789,789,10/18/2003,Northern Illinois,37,60,238,27,19,276,0,1,Western Michigan,10,18,-2,37,18,229,3,0,H,10,27,42,240,-10,1,47,-3,1,2003
790,790,10/18/2003,Notre Dame,14,36,111,34,15,168,0,1,Southern Cal,45,45,195,36,27,356,0,1,H,-8,-31,-9,-84,-2,-12,-188,0,0,2003
791,791,10/18/2003,Ohio,14,49,148,18,10,147,1,2,Kentucky,35,42,177,23,11,144,0,2,V,-13,-21,7,-29,-5,-1,3,1,0,2003
792,792,10/18/2003,Ohio State,19,42,56,22,11,129,0,1,Iowa,10,40,66,27,14,153,1,2,H,2.5,9,2,-10,-5,-3,-24,-1,-1,2003
793,793,10/18/2003,Oklahoma,34,35,146,34,20,278,1,0,Missouri,13,35,77,35,16,189,1,0,H,26,21,0,69,-1,4,89,0,0,2003
794,794,10/18/2003,Oklahoma State,51,51,352,30,19,321,1,0,Texas Tech,49,20,109,67,42,552,2,0,H,4.5,2,31,243,-37,-23,-231,-1,0,2003
795,795,10/18/2003,Oregon State,17,33,46,48,21,344,3,1,Washington,38,37,89,41,19,285,1,0,H,11,-21,-4,-43,7,2,59,2,1,2003
796,796,10/18/2003,Pittsburgh,42,34,113,38,22,381,0,1,Rutgers,32,40,132,52,27,384,2,3,V,17,10,-6,-19,-14,-5,-3,-2,-2,2003
797,797,10/18/2003,Purdue,26,38,66,55,38,411,0,1,Wisconsin,23,34,97,18,11,196,1,3,V,2.5,3,4,-31,37,27,215,-1,-2,2003
798,798,10/18/2003,Rice,6,47,206,14,6,17,1,1,Navy,38,69,366,10,6,76,0,0,H,-2.5,-32,-22,-160,4,0,-59,1,1,2003
799,799,10/18/2003,Rutgers,32,40,132,52,27,384,2,3,Pittsburgh,42,34,113,38,22,381,0,1,H,-17,-10,6,19,14,5,3,2,2,2003
800,800,10/18/2003,San Diego State,7,25,38,59,32,354,5,1,New Mexico,30,52,207,16,8,119,1,1,H,-1.5,-23,-27,-169,43,24,235,4,0,2003
801,801,10/18/2003,South Carolina,7,17,0,32,15,254,0,1,Louisiana State,33,52,263,32,26,219,1,0,H,-3.5,-26,-35,-263,0,-11,35,-1,1,2003
802,802,10/18/2003,South Florida,55,46,250,11,3,79,0,0,Charleston Southern,7,39,-52,36,19,186,0,2,H, ,48,7,302,-25,-16,-107,0,-2,2003
803,803,10/18/2003,Southern Cal,45,45,195,36,27,356,0,1,Notre Dame,14,36,111,34,15,168,0,1,V,8,31,9,84,2,12,188,0,0,2003
804,804,10/18/2003,Southern Methodist,3,37,80,32,13,134,1,0,Boise State,45,32,81,45,32,560,0,0,H,-24,-42,5,-1,-13,-19,-426,1,0,2003
805,805,10/18/2003,Stanford,14,34,42,50,20,217,2,0,Washington State,24,29,70,52,26,331,1,0,H,-12,-10,5,-28,-2,-6,-114,1,0,2003
806,806,10/18/2003,Syracuse,39,50,192,27,20,215,0,1,Boston College,14,30,70,31,20,249,2,0,H,-4,25,20,122,-4,0,-34,-2,1,2003
807,807,10/18/2003,Temple,14,27,150,14,5,21,0,1,Miami-Florida,52,46,342,33,22,259,0,1,V,-32,-38,-19,-192,-19,-17,-238,0,0,2003
808,808,10/18/2003,Texas,40,53,235,26,19,343,1,0,Iowa State,19,29,105,34,11,172,0,0,V,19,21,24,130,-8,8,171,1,0,2003
809,809,10/18/2003,Texas A & M,12,37,135,27,9,109,5,3,Nebraska,48,68,333,9,3,51,0,0,V,-8.5,-36,-31,-198,18,6,58,5,3,2003
810,810,10/18/2003,Texas Christian,27,48,212,36,18,193,2,0,Alabama-Birmingham,24,27,97,30,11,296,2,1,H,11,3,21,115,6,7,-103,0,-1,2003
811,811,10/18/2003,Texas Tech,49,20,109,67,42,552,2,0,Oklahoma State,51,51,352,30,19,321,1,0,V,-4.5,-2,-31,-243,37,23,231,1,0,2003
812,812,10/18/2003,Toledo,31,62,422,36,23,221,0,0,Central Michigan,13,36,135,33,11,178,0,0,V,15,18,26,287,3,12,43,0,0,2003
813,813,10/18/2003,Troy State,21,52,204,22,12,220,1,1,Florida Intl,10,23,59,32,17,212,0,1,H, ,11,29,145,-10,-5,8,1,0,2003
814,814,10/18/2003,Tulsa,21,41,204,32,14,160,2,3,Nevada-Reno,28,41,223,27,13,143,1,0,H,2.5,-7,0,-19,5,1,17,1,3,2003
815,815,10/18/2003,U-C-F,24,186,654,249,160,1697,12,11,Akron,38,331,1314,191,129,1550,0,4,V,-8,-14,-145,-660,58,31,147,12,7,2003
816,816,10/18/2003,U.C.L.A.,23,39,55,20,9,173,0,1,California,20,35,75,42,28,322,0,0,H,2.5,3,4,-20,-22,-19,-149,0,1,2003
817,817,10/18/2003,Utah,28,51,220,24,16,221,0,1,Nevada-Las Vegas,10,35,85,31,13,211,0,2,V,2.5,18,16,135,-7,3,10,0,-1,2003
818,818,10/18/2003,Utah State,27,25,78,38,26,230,1,1,North Texas,37,49,209,14,8,109,0,2,V,-15.5,-10,-24,-131,24,18,121,1,-1,2003
819,819,10/18/2003,Vanderbilt,8,39,116,21,11,102,1,1,Georgia,27,40,135,30,19,208,1,0,H,-26.5,-19,-1,-19,-9,-8,-106,0,1,2003
820,820,10/18/2003,Virginia,14,9,-5,54,39,326,1,1,Florida State,19,45,196,25,12,189,0,0,H,-7.5,-5,-36,-201,29,27,137,1,1,2003
821,821,10/18/2003,Wake Forest,42,56,256,4,4,78,0,0,Duke,13,37,119,49,23,267,1,1,V,9.5,29,19,137,-45,-19,-189,-1,-1,2003
822,822,10/18/2003,Washington,38,37,89,41,19,285,1,0,Oregon State,17,33,46,48,21,344,3,1,V,-11,21,4,43,-7,-2,-59,-2,-1,2003
823,823,10/18/2003,Washington State,24,29,70,52,26,331,1,0,Stanford,14,34,42,50,20,217,2,0,V,12,10,-5,28,2,6,114,-1,0,2003
824,824,10/18/2003,Western Michigan,10,18,-2,37,18,229,3,0,Northern Illinois,37,60,238,27,19,276,0,1,V,-10,-27,-42,-240,10,-1,-47,3,-1,2003
825,825,10/18/2003,Wisconsin,23,34,97,18,11,196,1,3,Purdue,26,38,66,55,38,411,0,1,H,-2.5,-3,-4,31,-37,-27,-215,1,2,2003
826,826,10/18/2003,Wyoming,13,32,85,32,20,140,2,1,Brigham Young,10,36,103,36,21,225,2,1,H,-1.5,3,-4,-18,-4,-1,-85,0,0,2003
827,827,10/22/2003,Virginia Tech,7,29,65,22,14,146,3,1,West Virginia,28,59,264,14,7,162,0,1,V,14,-21,-30,-199,8,7,-16,3,0,2003
828,828,10/22/2003,West Virginia,28,59,264,14,7,162,0,1,Virginia Tech,7,29,65,22,14,146,3,1,H,-14,21,30,199,-8,-7,16,-3,0,2003
829,829,10/23/2003,Georgia Tech,7,41,130,28,12,98,1,0,Maryland,3,35,96,33,14,157,2,2,H,-2.5,4,6,34,-5,-2,-59,-1,-2,2003
830,830,10/23/2003,Maryland,3,35,96,33,14,157,2,2,Georgia Tech,7,41,130,28,12,98,1,0,V,2.5,-4,-6,-34,5,2,59,1,2,2003
831,831,10/25/2003,Akron,37,48,160,26,15,223,1,1,Connecticut,38,36,178,43,24,299,2,1,V,-8,-1,12,-18,-17,-9,-76,-1,0,2003
832,832,10/25/2003,Alabama,43,61,258,38,21,215,1,0,Tennessee,51,41,209,43,23,283,0,3,H,-2,-8,20,49,-5,-2,-68,1,-3,2003
833,833,10/25/2003,Alabama-Birmingham,13,37,101,21,12,97,1,0,Georgia,16,34,116,33,20,221,2,0,V,-29,-3,3,-15,-12,-8,-124,-1,0,2003
834,834,10/25/2003,Arizona,14,28,201,34,18,201,2,0,California,42,59,327,18,11,117,0,0,V,-18.5,-28,-31,-126,16,7,84,2,0,2003
835,835,10/25/2003,Arizona State,13,30,121,31,15,132,0,1,U.C.L.A.,20,41,213,28,14,190,2,0,V,-2.5,-7,-11,-92,3,1,-58,-2,1,2003
836,836,10/25/2003,Arkansas,7,32,82,32,13,155,1,1,Mississippi,19,41,130,32,17,145,1,1,V,1,-12,-9,-48,0,-4,10,0,0,2003
837,837,10/25/2003,Arkansas State,0,39,114,32,11,158,6,1,Utah State,49,41,91,25,15,275,1,1,V,-8.5,-49,-2,23,7,-4,-117,5,0,2003
838,838,10/25/2003,Army,29,26,6,27,11,132,3,1,Cincinnati,33,56,186,28,17,159,1,0,V,-29,-4,-30,-180,-1,-6,-27,2,1,2003
839,839,10/25/2003,Auburn,7,34,50,27,19,143,0,2,Louisiana State,31,33,157,28,17,224,1,0,V,-3,-24,1,-107,-1,2,-81,-1,2,2003
840,840,10/25/2003,Ball State,38,43,198,27,22,307,0,0,Toledo,14,27,120,42,33,320,2,1,H,-12.5,24,16,78,-15,-11,-13,-2,-1,2003
841,841,10/25/2003,Baylor,0,40,91,34,16,169,1,2,Texas,56,40,248,29,19,229,0,1,H,-32.5,-56,0,-157,5,-3,-60,1,1,2003
842,842,10/25/2003,Boise State,77,34,132,31,19,439,0,1,San Jose State,14,37,64,44,27,229,0,3,H,27,63,-3,68,-13,-8,210,0,-2,2003
843,843,10/25/2003,Boston College,27,53,147,25,13,199,0,1,Notre Dame,25,34,47,39,23,350,2,0,H,4,2,19,100,-14,-10,-151,-2,1,2003
844,844,10/25/2003,Bowling Green,34,50,196,43,27,438,2,0,Northern Illinois,18,27,62,30,14,165,3,0,H,4.5,16,23,134,13,13,273,-1,0,2003
845,845,10/25/2003,Brigham Young,27,37,58,44,31,274,2,3,Nevada-Las Vegas,20,44,110,36,14,161,1,1,V,-3.5,7,-7,-52,8,17,113,1,2,2003
846,846,10/25/2003,Buffalo,26,62,188,18,4,83,1,0,Ohio,17,44,118,30,11,141,1,3,H,-13.5,9,18,70,-12,-7,-58,0,-3,2003
847,847,10/25/2003,California,42,59,327,18,11,117,0,0,Arizona,14,28,201,34,18,201,2,0,H,18.5,28,31,126,-16,-7,-84,-2,0,2003
848,848,10/25/2003,Central Michigan,13,41,198,24,10,118,1,1,U-C-F,31,47,209,33,26,252,3,0,V,-11,-18,-6,-11,-9,-16,-134,-2,1,2003
849,849,10/25/2003,Cincinnati,33,56,186,28,17,159,1,0,Army,29,26,6,27,11,132,3,1,H,29,4,30,180,1,6,27,-2,-1,2003
850,850,10/25/2003,Clemson,36,37,219,35,18,309,0,0,North Carolina,28,40,287,31,19,208,3,1,H,13.5,8,-3,-68,4,-1,101,-3,-1,2003
851,851,10/25/2003,Colorado,20,25,40,33,24,187,1,1,Oklahoma,34,40,186,28,19,248,0,3,H,-25,-14,-15,-146,5,5,-61,1,-2,2003
852,852,10/25/2003,Connecticut,38,36,178,43,24,299,2,1,Akron,37,48,160,26,15,223,1,1,H,8,1,-12,18,17,9,76,1,0,2003
853,853,10/25/2003,Duke,21,56,214,31,16,160,0,1,No Carolina State,28,23,56,31,23,369,1,0,H,-20.5,-7,33,158,0,-7,-209,-1,1,2003
854,854,10/25/2003,East Carolina,20,37,166,42,24,291,1,0,Louisville,36,45,305,28,17,187,0,0,H,-15,-16,-8,-139,14,7,104,1,0,2003
855,855,10/25/2003,Florida State,48,41,138,40,25,367,1,1,Wake Forest,24,52,230,15,8,96,0,1,H,21,24,-11,-92,25,17,271,1,0,2003
856,856,10/25/2003,Fresno State,31,34,194,36,23,205,1,0,Rice,28,62,384,4,1,34,0,1,H,20.5,3,-28,-190,32,22,171,1,-1,2003
857,857,10/25/2003,Georgia,16,34,116,33,20,221,2,0,Alabama-Birmingham,13,37,101,21,12,97,1,0,H,29,3,-3,15,12,8,124,1,0,2003
858,858,10/25/2003,Hawaii,31,11,37,54,27,426,1,0,Texas-El Paso,15,54,244,31,14,170,1,2,H,27.5,16,-43,-207,23,13,256,0,-2,2003
859,859,10/25/2003,Houston,55,37,250,37,17,434,1,2,Texas Christian,62,65,407,28,17,375,0,1,H,-7,-7,-28,-157,9,0,59,1,1,2003
860,860,10/25/2003,Idaho,20,30,179,33,19,213,2,2,UL-Lafayette,31,54,227,21,14,144,1,1,V,2.5,-11,-24,-48,12,5,69,1,1,2003
861,861,10/25/2003,Illinois,10,27,106,38,21,233,1,0,Minnesota,36,57,338,16,12,237,0,0,H,-17.5,-26,-30,-232,22,9,-4,1,0,2003
862,862,10/25/2003,Indiana,6,32,-12,26,17,143,1,0,Ohio State,35,39,216,33,25,387,1,2,H,-20.5,-29,-7,-228,-7,-8,-244,0,-2,2003
863,863,10/25/2003,Iowa,26,51,212,26,13,174,2,1,Penn State,14,28,38,27,14,138,0,1,H,10.5,12,23,174,-1,-1,36,2,0,2003
864,864,10/25/2003,Iowa State,0,30,70,41,20,160,2,1,Nebraska,28,54,282,7,4,35,1,1,V,-23,-28,-24,-212,34,16,125,1,0,2003
865,865,10/25/2003,Kansas,6,30,89,19,12,71,1,2,Kansas State,42,51,257,20,10,138,0,2,V,-21,-36,-21,-168,-1,2,-67,1,0,2003
866,866,10/25/2003,Kansas State,42,51,257,20,10,138,0,2,Kansas,6,30,89,19,12,71,1,2,H,21,36,21,168,1,-2,67,-1,0,2003
867,867,10/25/2003,Kent State,30,24,68,38,19,349,2,1,Miami-Ohio,38,47,239,44,28,409,1,0,H,-25,-8,-23,-171,-6,-9,-60,1,1,2003
868,868,10/25/2003,Kentucky,42,47,154,28,16,256,0,2,Mississippi State,17,32,150,25,14,155,3,0,H,9.5,25,15,4,3,2,101,-3,2,2003
869,869,10/25/2003,Louisiana State,31,33,157,28,17,224,1,0,Auburn,7,34,50,27,19,143,0,2,H,3,24,-1,107,1,-2,81,1,-2,2003
870,870,10/25/2003,Louisiana Tech,42,42,207,34,23,283,0,1,Nevada-Reno,34,46,223,36,18,315,1,1,V,-4,8,-4,-16,-2,5,-32,-1,0,2003
871,871,10/25/2003,Louisville,36,45,305,28,17,187,0,0,East Carolina,20,37,166,42,24,291,1,0,V,15,16,8,139,-14,-7,-104,-1,0,2003
872,872,10/25/2003,Marshall,41,46,239,27,21,326,0,3,Western Michigan,21,29,47,30,17,155,1,1,V, ,20,17,192,-3,4,171,-1,2,2003
873,873,10/25/2003,Memphis,41,46,288,31,17,178,0,2,Tulane,9,45,192,32,12,105,2,0,V,3.5,32,1,96,-1,5,73,-2,2,2003
874,874,10/25/2003,Miami-Ohio,38,47,239,44,28,409,1,0,Kent State,30,24,68,38,19,349,2,1,V,25,8,23,171,6,9,60,-1,-1,2003
875,875,10/25/2003,Michigan,31,38,105,33,18,240,0,1,Purdue,3,29,58,37,18,184,2,1,H,6,28,9,47,-4,0,56,-2,0,2003
876,876,10/25/2003,Mid Tennessee St,28,37,75,33,23,252,1,1,North Texas,33,40,138,13,10,230,0,1,H,-3,-5,-3,-63,20,13,22,1,0,2003
877,877,10/25/2003,Minnesota,36,57,338,16,12,237,0,0,Illinois,10,27,106,38,21,233,1,0,V,17.5,26,30,232,-22,-9,4,-1,0,2003
878,878,10/25/2003,Mississippi,19,41,130,32,17,145,1,1,Arkansas,7,32,82,32,13,155,1,1,H,-1,12,9,48,0,4,-10,0,0,2003
879,879,10/25/2003,Mississippi State,17,32,150,25,14,155,3,0,Kentucky,42,47,154,28,16,256,0,2,V,-9.5,-25,-15,-4,-3,-2,-101,3,-2,2003
880,880,10/25/2003,Missouri,62,55,469,24,13,128,0,0,Texas Tech,31,22,94,73,45,437,4,1,H,-4,31,33,375,-49,-32,-309,-4,-1,2003
881,881,10/25/2003,Navy,17,49,180,21,11,212,1,2,Delaware,21,44,188,23,15,84,1,0,H, ,-4,5,-8,-2,-4,128,0,2,2003
882,882,10/25/2003,Nebraska,28,54,282,7,4,35,1,1,Iowa State,0,30,70,41,20,160,2,1,H,23,28,24,212,-34,-16,-125,-1,0,2003
883,883,10/25/2003,Nevada-Las Vegas,20,44,110,36,14,161,1,1,Brigham Young,27,37,58,44,31,274,2,3,H,3.5,-7,7,52,-8,-17,-113,-1,-2,2003
884,884,10/25/2003,Nevada-Reno,34,46,223,36,18,315,1,1,Louisiana Tech,42,42,207,34,23,283,0,1,H,4,-8,4,16,2,-5,32,1,0,2003
885,885,10/25/2003,New Mexico,47,60,407,24,9,226,1,1,Utah,35,27,80,32,18,220,0,1,V,-7,12,33,327,-8,-9,6,1,0,2003
886,886,10/25/2003,New Mexico State,21,71,336,12,7,108,0,1,UL-Monroe,14,22,35,26,13,113,0,0,V,3.5,7,49,301,-14,-6,-5,0,1,2003
887,887,10/25/2003,No Carolina State,28,23,56,31,23,369,1,0,Duke,21,56,214,31,16,160,0,1,V,20.5,7,-33,-158,0,7,209,1,-1,2003
888,888,10/25/2003,North Carolina,28,40,287,31,19,208,3,1,Clemson,36,37,219,35,18,309,0,0,V,-13.5,-8,3,68,-4,1,-101,3,1,2003
889,889,10/25/2003,North Texas,33,40,138,13,10,230,0,1,Mid Tennessee St,28,37,75,33,23,252,1,1,V,3,5,3,63,-20,-13,-22,-1,0,2003
890,890,10/25/2003,Northern Illinois,18,27,62,30,14,165,3,0,Bowling Green,34,50,196,43,27,438,2,0,V,-4.5,-16,-23,-134,-13,-13,-273,1,0,2003
891,891,10/25/2003,Northwestern,16,52,245,23,10,176,2,0,Wisconsin,7,38,135,36,20,193,1,0,H,-9,9,14,110,-13,-10,-17,1,0,2003
892,892,10/25/2003,Notre Dame,25,34,47,39,23,350,2,0,Boston College,27,53,147,25,13,199,0,1,V,-4,-2,-19,-100,14,10,151,2,-1,2003
893,893,10/25/2003,Ohio,17,44,118,30,11,141,1,3,Buffalo,26,62,188,18,4,83,1,0,V,13.5,-9,-18,-70,12,7,58,0,3,2003
894,894,10/25/2003,Ohio State,35,39,216,33,25,387,1,2,Indiana,6,32,-12,26,17,143,1,0,V,20.5,29,7,228,7,8,244,0,2,2003
895,895,10/25/2003,Oklahoma,34,40,186,28,19,248,0,3,Colorado,20,25,40,33,24,187,1,1,V,25,14,15,146,-5,-5,61,-1,2,2003
896,896,10/25/2003,Oklahoma State,38,47,235,25,16,208,0,1,Texas A & M,10,39,184,27,13,183,1,0,V,6,28,8,51,-2,3,25,-1,1,2003
897,897,10/25/2003,Oregon,35,40,193,27,23,265,0,2,Stanford,0,35,101,34,15,225,3,1,H,10.5,35,5,92,-7,8,40,-3,1,2003
898,898,10/25/2003,Oregon State,30,42,15,42,16,276,2,3,Washington State,36,31,3,40,21,305,5,2,V,-7,-6,11,12,2,-5,-29,-3,1,2003
899,899,10/25/2003,Penn State,14,28,38,27,14,138,0,1,Iowa,26,51,212,26,13,174,2,1,V,-10.5,-12,-23,-174,1,1,-36,-2,0,2003
900,900,10/25/2003,Pittsburgh,34,39,44,32,21,310,1,1,Syracuse,14,39,146,18,7,49,2,1,H,6.5,20,0,-102,14,14,261,-1,0,2003
901,901,10/25/2003,Purdue,3,29,58,37,18,184,2,1,Michigan,31,38,105,33,18,240,0,1,V,-6,-28,-9,-47,4,0,-56,2,0,2003
902,902,10/25/2003,Rice,28,62,384,4,1,34,0,1,Fresno State,31,34,194,36,23,205,1,0,V,-20.5,-3,28,190,-32,-22,-171,-1,1,2003
903,903,10/25/2003,Rutgers,30,43,57,43,31,319,1,2,Temple,14,19,39,41,20,243,2,0,V,-3,16,24,18,2,11,76,-1,2,2003
904,904,10/25/2003,San Diego State,25,47,206,26,14,191,1,1,Wyoming,20,27,45,45,25,247,3,0,H,3,5,20,161,-19,-11,-56,-2,1,2003
905,905,10/25/2003,San Jose State,14,37,64,44,27,229,0,3,Boise State,77,34,132,31,19,439,0,1,V,-27,-63,3,-68,13,8,-210,0,2,2003
906,906,10/25/2003,South Carolina,35,45,218,21,13,161,0,0,Vanderbilt,24,36,137,36,27,319,1,2,H,15,11,9,81,-15,-14,-158,-1,-2,2003
907,907,10/25/2003,South Florida,6,29,98,53,23,288,0,2,Southern Miss,27,44,155,24,11,182,1,1,V,-2.5,-21,-15,-57,29,12,106,-1,1,2003
908,908,10/25/2003,Southern Cal,43,43,214,29,19,351,0,1,Washington,23,32,86,42,22,274,1,1,V,10,20,11,128,-13,-3,77,-1,0,2003
909,909,10/25/2003,Southern Methodist,16,58,245,16,6,51,0,1,Tulsa,35,34,167,17,10,177,1,0,V,-16.5,-19,24,78,-1,-4,-126,-1,1,2003
910,910,10/25/2003,Southern Miss,27,44,155,24,11,182,1,1,South Florida,6,29,98,53,23,288,0,2,H,2.5,21,15,57,-29,-12,-106,1,-1,2003
911,911,10/25/2003,Stanford,0,35,101,34,15,225,3,1,Oregon,35,40,193,27,23,265,0,2,V,-10.5,-35,-5,-92,7,-8,-40,3,-1,2003
912,912,10/25/2003,Syracuse,14,39,146,18,7,49,2,1,Pittsburgh,34,39,44,32,21,310,1,1,V,-6.5,-20,0,102,-14,-14,-261,1,0,2003
913,913,10/25/2003,Temple,14,19,39,41,20,243,2,0,Rutgers,30,43,57,43,31,319,1,2,H,3,-16,-24,-18,-2,-11,-76,1,-2,2003
914,914,10/25/2003,Tennessee,51,41,209,43,23,283,0,3,Alabama,43,61,258,38,21,215,1,0,V,2,8,-20,-49,5,2,68,-1,3,2003
915,915,10/25/2003,Texas,56,40,248,29,19,229,0,1,Baylor,0,40,91,34,16,169,1,2,V,32.5,56,0,157,-5,3,60,-1,-1,2003
916,916,10/25/2003,Texas A & M,10,39,184,27,13,183,1,0,Oklahoma State,38,47,235,25,16,208,0,1,H,-6,-28,-8,-51,2,-3,-25,1,-1,2003
917,917,10/25/2003,Texas Christian,62,65,407,28,17,375,0,1,Houston,55,37,250,37,17,434,1,2,V,7,7,28,157,-9,0,-59,-1,-1,2003
918,918,10/25/2003,Texas Tech,31,22,94,73,45,437,4,1,Missouri,62,55,469,24,13,128,0,0,V,4,-31,-33,-375,49,32,309,4,1,2003
919,919,10/25/2003,Texas-El Paso,15,54,244,31,14,170,1,2,Hawaii,31,11,37,54,27,426,1,0,V,-27.5,-16,43,207,-23,-13,-256,0,2,2003
920,920,10/25/2003,Toledo,14,27,120,42,33,320,2,1,Ball State,38,43,198,27,22,307,0,0,V,12.5,-24,-16,-78,15,11,13,2,1,2003
921,921,10/25/2003,Troy State,0,40,140,29,12,174,2,1,Virginia,24,42,173,37,24,250,1,0,V,-23.5,-24,-2,-33,-8,-12,-76,1,1,2003
922,922,10/25/2003,Tulane,9,45,192,32,12,105,2,0,Memphis,41,46,288,31,17,178,0,2,H,-3.5,-32,-1,-96,1,-5,-73,2,-2,2003
923,923,10/25/2003,Tulsa,35,34,167,17,10,177,1,0,Southern Methodist,16,58,245,16,6,51,0,1,H,16.5,19,-24,-78,1,4,126,1,-1,2003
924,924,10/25/2003,U-C-F,31,47,209,33,26,252,3,0,Central Michigan,13,41,198,24,10,118,1,1,H,11,18,6,11,9,16,134,2,-1,2003
925,925,10/25/2003,U.C.L.A.,20,41,213,28,14,190,2,0,Arizona State,13,30,121,31,15,132,0,1,H,2.5,7,11,92,-3,-1,58,2,-1,2003
926,926,10/25/2003,UL-Lafayette,31,54,227,21,14,144,1,1,Idaho,20,30,179,33,19,213,2,2,H,-2.5,11,24,48,-12,-5,-69,-1,-1,2003
927,927,10/25/2003,UL-Monroe,14,22,35,26,13,113,0,0,New Mexico State,21,71,336,12,7,108,0,1,H,-3.5,-7,-49,-301,14,6,5,0,-1,2003
928,928,10/25/2003,Utah,35,27,80,32,18,220,0,1,New Mexico,47,60,407,24,9,226,1,1,H,7,-12,-33,-327,8,9,-6,-1,0,2003
929,929,10/25/2003,Utah State,49,41,91,25,15,275,1,1,Arkansas State,0,39,114,32,11,158,6,1,H,8.5,49,2,-23,-7,4,117,-5,0,2003
930,930,10/25/2003,Vanderbilt,24,36,137,36,27,319,1,2,South Carolina,35,45,218,21,13,161,0,0,V,-15,-11,-9,-81,15,14,158,1,2,2003
931,931,10/25/2003,Virginia,24,42,173,37,24,250,1,0,Troy State,0,40,140,29,12,174,2,1,H,23.5,24,2,33,8,12,76,-1,-1,2003
932,932,10/25/2003,Wake Forest,24,52,230,15,8,96,0,1,Florida State,48,41,138,40,25,367,1,1,V,-21,-24,11,92,-25,-17,-271,-1,0,2003
933,933,10/25/2003,Washington,23,32,86,42,22,274,1,1,Southern Cal,43,43,214,29,19,351,0,1,H,-10,-20,-11,-128,13,3,-77,1,0,2003
934,934,10/25/2003,Washington State,36,31,3,40,21,305,5,2,Oregon State,30,42,15,42,16,276,2,3,H,7,6,-11,-12,-2,5,29,3,-1,2003
935,935,10/25/2003,Western Michigan,21,29,47,30,17,155,1,1,Marshall,41,46,239,27,21,326,0,3,H, ,-20,-17,-192,3,-4,-171,1,-2,2003
936,936,10/25/2003,Wisconsin,7,38,135,36,20,193,1,0,Northwestern,16,52,245,23,10,176,2,0,V,9,-9,-14,-110,13,10,17,-1,0,2003
937,937,10/25/2003,Wyoming,20,27,45,45,25,247,3,0,San Diego State,25,47,206,26,14,191,1,1,V,-3,-5,-20,-161,19,11,56,2,-1,2003
938,938,10/30/2003,Boise State,50,45,134,24,12,247,1,0,Brigham Young,12,35,122,59,21,207,4,0,V,8.5,38,10,12,-35,-9,40,-3,0,2003
939,939,10/30/2003,Brigham Young,12,35,122,59,21,207,4,0,Boise State,50,45,134,24,12,247,1,0,H,-8.5,-38,-10,-12,35,9,-40,3,0,2003
940,940,10/30/2003,North Texas,21,46,141,15,11,127,1,1,Troy State,0,30,87,31,11,124,3,2,H,12,21,16,54,-16,0,3,-2,-1,2003
941,941,10/30/2003,Troy State,0,30,87,31,11,124,3,2,North Texas,21,46,141,15,11,127,1,1,V,-12,-21,-16,-54,16,0,-3,2,1,2003
942,942,10/31/2003,Cincinnati,17,49,118,36,20,212,2,1,South Florida,24,48,168,31,14,100,0,0,V,-3.5,-7,1,-50,5,6,112,2,1,2003
943,943,10/31/2003,South Florida,24,48,168,31,14,100,0,0,Cincinnati,17,49,118,36,20,212,2,1,H,3.5,7,-1,50,-5,-6,-112,-2,-1,2003
944,944,11/01/2003,Air Force,43,70,288,15,6,74,0,1,Utah,45,40,162,32,22,297,1,1,H,3.5,-2,30,126,-17,-16,-223,-1,0,2003
945,945,11/01/2003,Akron,24,29,141,38,20,250,2,0,Marshall,42,52,374,25,15,199,2,1,V,-13,-18,-23,-233,13,5,51,0,-1,2003
946,946,11/01/2003,Alabama-Birmingham,24,39,156,16,5,181,0,3,Army,9,28,55,55,36,251,0,1,H,21.5,15,11,101,-39,-31,-70,0,2,2003
947,947,11/01/2003,Arizona,23,36,90,31,13,142,1,0,Oregon State,52,44,93,40,23,333,1,1,V,-23,-29,-8,-3,-9,-10,-191,0,-1,2003
948,948,11/01/2003,Arizona State,23,36,98,36,17,253,2,2,California,51,45,232,23,17,307,0,1,H,3,-28,-9,-134,13,0,-54,2,1,2003
949,949,11/01/2003,Arkansas,71,71,334,28,17,271,0,2,Kentucky,63,52,180,51,28,326,1,1,V,5,8,19,154,-23,-11,-55,-1,1,2003
950,950,11/01/2003,Arkansas State,28,42,196,29,17,206,1,0,New Mexico State,24,41,178,33,21,314,1,0,V,-15,4,1,18,-4,-4,-108,0,0,2003
951,951,11/01/2003,Army,9,28,55,55,36,251,0,1,Alabama-Birmingham,24,39,156,16,5,181,0,3,V,-21.5,-15,-11,-101,39,31,70,0,-2,2003
952,952,11/01/2003,Auburn,73,43,241,21,16,240,1,0,UL-Monroe,7,32,23,25,10,128,3,1,H,37,66,11,218,-4,6,112,-2,-1,2003
953,953,11/01/2003,Ball State,23,34,199,40,24,240,3,2,Northern Illinois,48,57,252,19,14,185,0,1,V,-16.5,-25,-23,-53,21,10,55,3,1,2003
954,954,11/01/2003,Baylor,10,42,67,24,11,161,1,0,Kansas State,38,46,234,24,14,242,0,2,V,-43,-28,-4,-167,0,-3,-81,1,-2,2003
955,955,11/01/2003,Boston College,13,38,149,29,12,186,0,0,Pittsburgh,24,45,124,38,25,364,1,0,H,-2.5,-11,-7,25,-9,-13,-178,-1,0,2003
956,956,11/01/2003,Buffalo,29,45,140,37,23,254,1,0,Toledo,56,37,218,32,26,467,1,0,V,-26,-27,8,-78,5,-3,-213,0,0,2003
957,957,11/01/2003,California,51,45,232,23,17,307,0,1,Arizona State,23,36,98,36,17,253,2,2,V,-3,28,9,134,-13,0,54,-2,-1,2003
958,958,11/01/2003,Central Michigan,38,47,227,24,18,185,0,0,Eastern Michigan,10,39,124,29,13,129,0,0,H,7,28,8,103,-5,5,56,0,0,2003
959,959,11/01/2003,Clemson,17,24,62,57,35,343,1,2,Wake Forest,45,60,321,7,5,79,0,1,V,1,-28,-36,-259,50,30,264,1,1,2003
960,960,11/01/2003,Colorado,21,41,81,33,18,213,3,0,Texas Tech,26,23,91,51,30,399,5,1,V,-14,-5,18,-10,-18,-12,-186,-2,-1,2003
961,961,11/01/2003,Colorado State,28,46,304,29,17,205,0,2,Wyoming,35,30,129,36,23,337,1,0,V,12.5,-7,16,175,-7,-6,-132,-1,2,2003
962,962,11/01/2003,Connecticut,41,41,225,37,25,343,1,1,Western Michigan,27,30,53,41,29,391,0,1,H,15,14,11,172,-4,-4,-48,1,0,2003
963,963,11/01/2003,Duke,6,48,180,21,12,119,0,1,Tennessee,23,31,147,27,16,208,0,0,V,-24.5,-17,17,33,-6,-4,-89,0,1,2003
964,964,11/01/2003,East Carolina,24,39,55,32,16,168,1,2,Memphis,41,46,225,33,18,284,0,2,V,-18,-17,-7,-170,-1,-2,-116,1,0,2003
965,965,11/01/2003,Eastern Michigan,10,39,124,29,13,129,0,0,Central Michigan,38,47,227,24,18,185,0,0,V,-7,-28,-8,-103,5,-5,-56,0,0,2003
966,966,11/01/2003,Florida,16,34,89,23,13,235,0,0,Georgia,13,48,202,33,18,188,1,0,N,-2,3,-14,-113,-10,-5,47,-1,0,2003
967,967,11/01/2003,Florida State,37,37,98,31,17,327,3,0,Notre Dame,0,30,146,52,20,175,3,0,V,13,37,7,-48,-21,-3,152,0,0,2003
968,968,11/01/2003,Fresno State,20,42,159,33,13,86,2,0,Southern Methodist,11,53,180,16,6,93,0,3,V,14.5,9,-11,-21,17,7,-7,2,-3,2003
969,969,11/01/2003,Georgia,13,48,202,33,18,188,1,0,Florida,16,34,89,23,13,235,0,0,N,2,-3,14,113,10,5,-47,1,0,2003
970,970,11/01/2003,Hawaii,13,17,79,46,28,332,2,0,San Jose State,10,39,103,42,23,223,0,0,V,12.5,3,-22,-24,4,5,109,2,0,2003
971,971,11/01/2003,Illinois,10,26,59,32,16,206,0,2,Iowa,41,50,244,25,16,261,0,1,V,-27,-31,-24,-185,7,0,-55,0,1,2003
972,972,11/01/2003,Indiana,7,40,111,30,12,152,0,1,Minnesota,55,62,435,15,11,92,0,0,V,-29,-48,-22,-324,15,1,60,0,1,2003
973,973,11/01/2003,Iowa,41,50,244,25,16,261,0,1,Illinois,10,26,59,32,16,206,0,2,H,27,31,24,185,-7,0,55,0,-1,2003
974,974,11/01/2003,Kansas,33,34,153,38,26,328,1,2,Texas A & M,45,54,253,23,15,294,1,0,V,-14.5,-12,-20,-100,15,11,34,0,2,2003
975,975,11/01/2003,Kansas State,38,46,234,24,14,242,0,2,Baylor,10,42,67,24,11,161,1,0,H,43,28,4,167,0,3,81,-1,2,2003
976,976,11/01/2003,Kentucky,63,52,180,51,28,326,1,1,Arkansas,71,71,334,28,17,271,0,2,H,-5,-8,-19,-154,23,11,55,1,-1,2003
977,977,11/01/2003,Louisiana State,49,41,281,31,25,372,0,1,Louisiana Tech,10,25,121,39,16,220,2,0,H,26.5,39,16,160,-8,9,152,-2,1,2003
978,978,11/01/2003,Louisiana Tech,10,25,121,39,16,220,2,0,Louisiana State,49,41,281,31,25,372,0,1,V,-26.5,-39,-16,-160,8,-9,-152,2,-1,2003
979,979,11/01/2003,Marshall,42,52,374,25,15,199,2,1,Akron,24,29,141,38,20,250,2,0,H,13,18,23,233,-13,-5,-51,0,1,2003
980,980,11/01/2003,Maryland,59,50,252,27,16,360,0,0,North Carolina,21,25,108,32,21,277,1,2,H,17.5,38,25,144,-5,-5,83,-1,-2,2003
981,981,11/01/2003,Memphis,41,46,225,33,18,284,0,2,East Carolina,24,39,55,32,16,168,1,2,H,18,17,7,170,1,2,116,-1,0,2003
982,982,11/01/2003,Miami-Florida,7,38,116,47,29,261,3,1,Virginia Tech,31,41,175,8,2,44,1,1,V,4,-24,-3,-59,39,27,217,2,0,2003
983,983,11/01/2003,Michigan,27,55,216,31,17,223,1,1,Michigan State,20,16,36,41,21,254,1,0,V,4,7,39,180,-10,-4,-31,0,1,2003
984,984,11/01/2003,Michigan State,20,16,36,41,21,254,1,0,Michigan,27,55,216,31,17,223,1,1,H,-4,-7,-39,-180,10,4,31,0,-1,2003
985,985,11/01/2003,Mid Tennessee St,20,29,93,45,22,196,2,1,Utah State,41,39,194,35,22,301,0,1,V,-3,-21,-10,-101,10,0,-105,2,0,2003
986,986,11/01/2003,Minnesota,55,62,435,15,11,92,0,0,Indiana,7,40,111,30,12,152,0,1,H,29,48,22,324,-15,-1,-60,0,-1,2003
987,987,11/01/2003,Mississippi,43,43,147,42,30,391,1,1,South Carolina,40,28,118,32,14,298,0,0,H,7,3,15,29,10,16,93,1,1,2003
988,988,11/01/2003,Navy,35,58,357,7,2,57,1,3,Tulane,17,35,145,40,27,214,2,1,H,10,18,23,212,-33,-25,-157,-1,2,2003
989,989,11/01/2003,Nebraska,7,40,53,15,5,122,1,0,Texas,31,51,353,27,13,131,3,0,V,-5.5,-24,-11,-300,-12,-8,-9,-2,0,2003
990,990,11/01/2003,Nevada-Las Vegas,37,49,74,24,15,155,0,1,New Mexico,35,31,149,39,24,429,3,3,V,-10,2,18,-75,-15,-9,-274,-3,-2,2003
991,991,11/01/2003,Nevada-Reno,42,53,316,34,18,221,1,1,Rice,52,53,387,10,8,145,0,0,V,5,-10,0,-71,24,10,76,1,1,2003
992,992,11/01/2003,New Mexico,35,31,149,39,24,429,3,3,Nevada-Las Vegas,37,49,74,24,15,155,0,1,H,10,-2,-18,75,15,9,274,3,2,2003
993,993,11/01/2003,New Mexico State,24,41,178,33,21,314,1,0,Arkansas State,28,42,196,29,17,206,1,0,H,15,-4,-1,-18,4,4,108,0,0,2003
994,994,11/01/2003,No Carolina State,51,25,143,35,29,410,0,2,Virginia,37,23,50,55,41,393,1,1,H,-1,14,2,93,-20,-12,17,-1,1,2003
995,995,11/01/2003,North Carolina,21,25,108,32,21,277,1,2,Maryland,59,50,252,27,16,360,0,0,V,-17.5,-38,-25,-144,5,5,-83,1,2,2003
996,996,11/01/2003,Northern Illinois,48,57,252,19,14,185,0,1,Ball State,23,34,199,40,24,240,3,2,H,16.5,25,23,53,-21,-10,-55,-3,-1,2003
997,997,11/01/2003,Northwestern,14,51,161,24,14,165,0,4,Purdue,34,48,178,24,14,212,0,0,V,-18,-20,3,-17,0,0,-47,0,4,2003
998,998,11/01/2003,Notre Dame,0,30,146,52,20,175,3,0,Florida State,37,37,98,31,17,327,3,0,H,-13,-37,-7,48,21,3,-152,0,0,2003
999,999,11/01/2003,Ohio State,21,39,153,29,17,148,1,0,Penn State,20,27,33,42,27,253,1,0,V,7.5,1,12,120,-13,-10,-105,0,0,2003
1000,1000,11/01/2003,Oklahoma,52,50,221,29,13,225,2,0,Oklahoma State,9,37,99,24,9,62,1,2,H,14.5,43,13,122,5,4,163,1,-2,2003
1001,1001,11/01/2003,Oklahoma State,9,37,99,24,9,62,1,2,Oklahoma,52,50,221,29,13,225,2,0,V,-14.5,-43,-13,-122,-5,-4,-163,-1,2,2003
1002,1002,11/01/2003,Oregon,10,34,73,29,16,246,1,2,Washington,42,41,261,32,16,214,0,0,V,-1,-32,-7,-188,-3,0,32,1,2,2003
1003,1003,11/01/2003,Oregon State,52,44,93,40,23,333,1,1,Arizona,23,36,90,31,13,142,1,0,H,23,29,8,3,9,10,191,0,1,2003
1004,1004,11/01/2003,Penn State,20,27,33,42,27,253,1,0,Ohio State,21,39,153,29,17,148,1,0,H,-7.5,-1,-12,-120,13,10,105,0,0,2003
1005,1005,11/01/2003,Pittsburgh,24,45,124,38,25,364,1,0,Boston College,13,38,149,29,12,186,0,0,V,2.5,11,7,-25,9,13,178,1,0,2003
1006,1006,11/01/2003,Purdue,34,48,178,24,14,212,0,0,Northwestern,14,51,161,24,14,165,0,4,H,18,20,-3,17,0,0,47,0,-4,2003
1007,1007,11/01/2003,Rice,52,53,387,10,8,145,0,0,Nevada-Reno,42,53,316,34,18,221,1,1,H,-5,10,0,71,-24,-10,-76,-1,-1,2003
1008,1008,11/01/2003,San Jose State,10,39,103,42,23,223,0,0,Hawaii,13,17,79,46,28,332,2,0,H,-12.5,-3,22,24,-4,-5,-109,-2,0,2003
1009,1009,11/01/2003,South Carolina,40,28,118,32,14,298,0,0,Mississippi,43,43,147,42,30,391,1,1,V,-7,-3,-15,-29,-10,-16,-93,-1,-1,2003
1010,1010,11/01/2003,Southern Cal,43,31,222,32,18,214,0,0,Washington State,16,30,-25,57,34,345,1,3,H,11.5,27,1,247,-25,-16,-131,-1,-3,2003
1011,1011,11/01/2003,Southern Methodist,11,53,180,16,6,93,0,3,Fresno State,20,42,159,33,13,86,2,0,H,-14.5,-9,11,21,-17,-7,7,-2,3,2003
1012,1012,11/01/2003,Southern Miss,48,46,264,29,18,286,1,1,UL-Lafayette,3,33,94,23,14,106,1,0,H,22.5,45,13,170,6,4,180,0,1,2003
1013,1013,11/01/2003,Stanford,21,41,115,20,12,91,1,0,U.C.L.A.,14,36,48,43,24,239,1,2,H,-7,7,5,67,-23,-12,-148,0,-2,2003
1014,1014,11/01/2003,Tennessee,23,31,147,27,16,208,0,0,Duke,6,48,180,21,12,119,0,1,H,24.5,17,-17,-33,6,4,89,0,-1,2003
1015,1015,11/01/2003,Texas,31,51,353,27,13,131,3,0,Nebraska,7,40,53,15,5,122,1,0,H,5.5,24,11,300,12,8,9,2,0,2003
1016,1016,11/01/2003,Texas A & M,45,54,253,23,15,294,1,0,Kansas,33,34,153,38,26,328,1,2,H,14.5,12,20,100,-15,-11,-34,0,-2,2003
1017,1017,11/01/2003,Texas Tech,26,23,91,51,30,399,5,1,Colorado,21,41,81,33,18,213,3,0,H,14,5,-18,10,18,12,186,2,1,2003
1018,1018,11/01/2003,Texas-El Paso,28,32,78,43,26,287,3,0,Tulsa,56,45,287,22,15,219,1,0,H,-8,-28,-13,-209,21,11,68,2,0,2003
1019,1019,11/01/2003,Toledo,56,37,218,32,26,467,1,0,Buffalo,29,45,140,37,23,254,1,0,H,26,27,-8,78,-5,3,213,0,0,2003
1020,1020,11/01/2003,Tulane,17,35,145,40,27,214,2,1,Navy,35,58,357,7,2,57,1,3,V,-10,-18,-23,-212,33,25,157,1,-2,2003
1021,1021,11/01/2003,Tulsa,56,45,287,22,15,219,1,0,Texas-El Paso,28,32,78,43,26,287,3,0,V,8,28,13,209,-21,-11,-68,-2,0,2003
1022,1022,11/01/2003,U-C-F,18,20,44,45,27,253,1,1,West Virginia,36,57,303,17,10,161,1,1,V,-22.5,-18,-37,-259,28,17,92,0,0,2003
1023,1023,11/01/2003,U.C.L.A.,14,36,48,43,24,239,1,2,Stanford,21,41,115,20,12,91,1,0,V,7,-7,-5,-67,23,12,148,0,2,2003
1024,1024,11/01/2003,UL-Lafayette,3,33,94,23,14,106,1,0,Southern Miss,48,46,264,29,18,286,1,1,V,-22.5,-45,-13,-170,-6,-4,-180,0,-1,2003
1025,1025,11/01/2003,UL-Monroe,7,32,23,25,10,128,3,1,Auburn,73,43,241,21,16,240,1,0,V,-37,-66,-11,-218,4,-6,-112,2,1,2003
1026,1026,11/01/2003,Utah,45,40,162,32,22,297,1,1,Air Force,43,70,288,15,6,74,0,1,V,-3.5,2,-30,-126,17,16,223,1,0,2003
1027,1027,11/01/2003,Utah State,41,39,194,35,22,301,0,1,Mid Tennessee St,20,29,93,45,22,196,2,1,H,3,21,10,101,-10,0,105,-2,0,2003
1028,1028,11/01/2003,Virginia,37,23,50,55,41,393,1,1,No Carolina State,51,25,143,35,29,410,0,2,V,1,-14,-2,-93,20,12,-17,1,-1,2003
1029,1029,11/01/2003,Virginia Tech,31,41,175,8,2,44,1,1,Miami-Florida,7,38,116,47,29,261,3,1,H,-4,24,3,59,-39,-27,-217,-2,0,2003
1030,1030,11/01/2003,Wake Forest,45,60,321,7,5,79,0,1,Clemson,17,24,62,57,35,343,1,2,H,-1,28,36,259,-50,-30,-264,-1,-1,2003
1031,1031,11/01/2003,Washington,42,41,261,32,16,214,0,0,Oregon,10,34,73,29,16,246,1,2,H,1,32,7,188,3,0,-32,-1,-2,2003
1032,1032,11/01/2003,Washington State,16,30,-25,57,34,345,1,3,Southern Cal,43,31,222,32,18,214,0,0,V,-11.5,-27,-1,-247,25,16,131,1,3,2003
1033,1033,11/01/2003,West Virginia,36,57,303,17,10,161,1,1,U-C-F,18,20,44,45,27,253,1,1,H,22.5,18,37,259,-28,-17,-92,0,0,2003
1034,1034,11/01/2003,Western Michigan,27,30,53,41,29,391,0,1,Connecticut,41,41,225,37,25,343,1,1,V,-15,-14,-11,-172,4,4,48,-1,0,2003
1035,1035,11/01/2003,Wyoming,35,30,129,36,23,337,1,0,Colorado State,28,46,304,29,17,205,0,2,H,-12.5,7,-16,-175,7,6,132,1,-2,2003
1036,1036,11/04/2003,Bowling Green,10,37,183,35,20,160,0,4,Miami-Ohio,33,36,126,29,20,250,1,2,V,-7,-23,1,57,6,0,-90,-1,2,2003
1037,1037,11/04/2003,Miami-Ohio,33,36,126,29,20,250,1,2,Bowling Green,10,37,183,35,20,160,0,4,H,7,23,-1,-57,-6,0,90,1,-2,2003
1038,1038,11/05/2003,Louisville,28,32,121,50,31,459,0,0,Texas Christian,31,46,210,28,17,251,0,0,V,-2,-3,-14,-89,22,14,208,0,0,2003
1039,1039,11/05/2003,Texas Christian,31,46,210,28,17,251,0,0,Louisville,28,32,121,50,31,459,0,0,H,2,3,14,89,-22,-14,-208,0,0,2003
1040,1040,11/06/2003,Arkansas,28,96,496,30,22,296,0,6,South Carolina,6,58,246,72,42,362,4,4,H,7.5,22,38,250,-42,-20,-66,-4,2,2003
1041,1041,11/06/2003,New Mexico State,26,56,193,24,18,208,0,0,Utah State,21,29,137,47,23,287,1,1,H,-2.5,5,27,56,-23,-5,-79,-1,-1,2003
1042,1042,11/06/2003,South Carolina,6,58,246,72,42,362,4,4,Arkansas,28,96,496,30,22,296,0,6,V,-7.5,-22,-38,-250,42,20,66,4,-2,2003
1043,1043,11/06/2003,Utah State,21,29,137,47,23,287,1,1,New Mexico State,26,56,193,24,18,208,0,0,V,2.5,-5,-27,-56,23,5,79,1,1,2003
1044,1044,11/07/2003,Colorado State,34,40,111,24,16,217,0,2,New Mexico,37,45,319,12,8,106,0,0,V,1,-3,-5,-208,12,8,111,0,2,2003
1045,1045,11/07/2003,New Mexico,37,45,319,12,8,106,0,0,Colorado State,34,40,111,24,16,217,0,2,H,-1,3,5,208,-12,-8,-111,0,-2,2003
1046,1046,11/08/2003,Air Force,31,67,372,15,9,74,0,0,Army,3,41,141,28,10,58,2,4,H,28.5,28,26,231,-13,-1,16,-2,-4,2003
1047,1047,11/08/2003,Akron,40,53,191,34,27,416,0,2,Central Michigan,28,41,214,28,17,155,1,1,V,7.5,12,12,-23,6,10,261,-1,1,2003
1048,1048,11/08/2003,Alabama,38,50,190,16,10,211,1,0,Mississippi State,0,20,24,31,16,128,2,0,V,12,38,30,166,-15,-6,83,-1,0,2003
1049,1049,11/08/2003,Alabama-Birmingham,24,45,237,36,14,262,2,2,Tulane,38,37,244,33,16,255,1,1,H,13.5,-14,8,-7,3,-2,7,1,1,2003
1050,1050,11/08/2003,Arizona,27,37,250,26,11,151,1,0,Washington,22,35,101,51,31,351,0,2,H,-15,5,2,149,-25,-20,-200,1,-2,2003
1051,1051,11/08/2003,Arizona State,27,23,97,53,23,357,1,2,Stanford,38,53,188,34,18,279,1,0,V,2,-11,-30,-91,19,5,78,0,2,2003
1052,1052,11/08/2003,Arkansas State,24,50,190,24,15,137,1,0,Idaho,23,35,66,39,23,270,1,2,H,-1,1,15,124,-15,-8,-133,0,-2,2003
1053,1053,11/08/2003,Army,3,41,141,28,10,58,2,4,Air Force,31,67,372,15,9,74,0,0,V,-28.5,-28,-26,-231,13,1,-16,2,4,2003
1054,1054,11/08/2003,Auburn,20,33,158,26,14,231,0,0,Mississippi,24,37,84,30,19,218,0,0,H,8.5,-4,-4,74,-4,-5,13,0,0,2003
1055,1055,11/08/2003,Ball State,20,34,111,44,27,326,0,1,Western Michigan,28,35,167,23,20,250,0,0,V,-2.5,-8,-1,-56,21,7,76,0,1,2003
1056,1056,11/08/2003,Baylor,14,31,96,26,18,164,1,1,Texas Tech,62,28,136,64,44,580,0,0,H,-24.5,-48,3,-40,-38,-26,-416,1,1,2003
1057,1057,11/08/2003,Boston College,28,36,158,55,30,317,4,0,West Virginia,35,39,144,16,11,167,0,0,H,3.5,-7,-3,14,39,19,150,4,0,2003
1058,1058,11/08/2003,Buffalo,9,35,130,37,19,176,2,2,Northern Illinois,40,43,201,31,17,280,1,1,H,-22.5,-31,-8,-71,6,2,-104,1,1,2003
1059,1059,11/08/2003,California,17,40,106,27,15,188,1,0,Oregon,21,27,94,34,17,224,0,0,V,2,-4,13,12,-7,-2,-36,1,0,2003
1060,1060,11/08/2003,Central Michigan,28,41,214,28,17,155,1,1,Akron,40,53,191,34,27,416,0,2,H,-7.5,-12,-12,23,-6,-10,-261,1,-1,2003
1061,1061,11/08/2003,Cincinnati,31,42,228,28,20,332,1,1,Rhode Island,24,60,371,5,2,58,0,0,H, ,7,-18,-143,23,18,274,1,1,2003
1062,1062,11/08/2003,Clemson,26,50,152,27,17,272,1,0,Florida State,10,17,11,53,28,364,2,1,H,-16,16,33,141,-26,-11,-92,-1,-1,2003
1063,1063,11/08/2003,Colorado,21,33,89,26,19,187,0,0,Missouri,16,41,169,42,29,278,2,2,H,-5,5,-8,-80,-16,-10,-91,-2,-2,2003
1064,1064,11/08/2003,Connecticut,38,30,99,32,17,222,0,0,Rutgers,31,45,244,32,18,211,2,3,H,7,7,-15,-145,0,-1,11,-2,-3,2003
1065,1065,11/08/2003,Duke,41,48,253,15,8,141,1,0,Georgia Tech,17,30,142,47,27,247,3,1,H,-13,24,18,111,-32,-19,-106,-2,-1,2003
1066,1066,11/08/2003,East Carolina,37,61,216,34,16,146,0,1,South Florida,38,39,142,22,10,101,0,3,H,-11,-1,22,74,12,6,45,0,-2,2003
1067,1067,11/08/2003,Eastern Michigan,19,47,152,18,8,116,1,1,U-C-F,13,47,135,18,7,46,1,2,H,-7,6,0,17,0,1,70,0,-1,2003
1068,1068,11/08/2003,Florida,35,34,194,25,15,179,2,2,Vanderbilt,17,45,133,39,18,189,4,0,H,23,18,-11,61,-14,-3,-10,-2,2,2003
1069,1069,11/08/2003,Florida State,10,17,11,52,27,358,2,1,Clemson,26,50,152,27,17,272,1,0,V,16,-16,-33,-141,25,10,86,1,1,2003
1070,1070,11/08/2003,Fresno State,27,53,212,28,19,184,0,1,Nevada-Reno,10,28,113,34,17,308,1,1,V,0,17,25,99,-6,2,-124,-1,0,2003
1071,1071,11/08/2003,Georgia Tech,17,30,142,47,27,247,3,1,Duke,41,48,253,15,8,141,1,0,V,13,-24,-18,-111,32,19,106,2,1,2003
1072,1072,11/08/2003,Houston,10,52,205,30,15,158,1,1,Southern Miss,31,35,136,26,17,237,0,0,H,-7.5,-21,17,69,4,-2,-79,1,1,2003
1073,1073,11/08/2003,Idaho,23,35,66,39,23,270,1,2,Arkansas State,24,50,190,24,15,137,1,0,V,1,-1,-15,-124,15,8,133,0,2,2003
1074,1074,11/08/2003,Illinois,14,42,178,21,15,163,1,1,Indiana,17,51,195,24,17,161,0,0,V,1,-3,-9,-17,-3,-2,2,1,1,2003
1075,1075,11/08/2003,Indiana,17,51,195,24,17,161,0,0,Illinois,14,42,178,21,15,163,1,1,H,-1,3,9,17,3,2,-2,-1,-1,2003
1076,1076,11/08/2003,Iowa,14,36,98,30,16,203,1,0,Purdue,27,44,154,20,13,167,0,0,V,-3.5,-13,-8,-56,10,3,36,1,0,2003
1077,1077,11/08/2003,Iowa State,0,28,39,30,11,101,3,0,Kansas State,45,48,356,17,14,147,0,2,H,-18,-45,-20,-317,13,-3,-46,3,-2,2003
1078,1078,11/08/2003,Kansas,3,29,88,34,24,204,3,1,Nebraska,24,53,290,12,7,110,1,1,H,-18,-21,-24,-202,22,17,94,2,0,2003
1079,1079,11/08/2003,Kansas State,45,48,356,17,14,147,0,2,Iowa State,0,29,24,30,11,101,3,0,V,18,45,19,332,-13,3,46,-3,2,2003
1080,1080,11/08/2003,Kent State,37,36,168,37,21,283,1,3,Ohio,33,58,274,12,10,168,0,1,V,-2.5,4,-22,-106,25,11,115,1,2,2003
1081,1081,11/08/2003,Louisiana Tech,41,34,192,22,11,209,1,0,Southern Methodist,6,43,162,20,10,80,2,0,H,18.5,35,-9,30,2,1,129,-1,0,2003
1082,1082,11/08/2003,Miami-Florida,6,25,108,35,22,213,2,2,Tennessee,10,40,89,18,11,81,0,0,H,11.5,-4,-15,19,17,11,132,2,2,2003
1083,1083,11/08/2003,Michigan State,23,17,5,56,36,373,2,0,Ohio State,33,49,182,24,12,213,1,0,V,-6,-10,-32,-177,32,24,160,1,0,2003
1084,1084,11/08/2003,Mid Tennessee St,27,42,195,23,16,182,0,1,Troy State,20,46,202,29,12,147,1,1,H,3,7,-4,-7,-6,4,35,-1,0,2003
1085,1085,11/08/2003,Minnesota,37,55,336,17,11,159,0,0,Wisconsin,34,32,119,34,23,305,1,0,H,8.5,3,23,217,-17,-12,-146,-1,0,2003
1086,1086,11/08/2003,Mississippi,24,37,84,30,19,218,0,0,Auburn,20,33,158,26,14,231,0,0,V,-8.5,4,4,-74,4,5,-13,0,0,2003
1087,1087,11/08/2003,Mississippi State,0,20,24,31,16,128,2,0,Alabama,38,50,190,16,10,211,1,0,H,-12,-38,-30,-166,15,6,-83,1,0,2003
1088,1088,11/08/2003,Missouri,16,41,169,42,29,278,2,2,Colorado,21,33,89,26,19,187,0,0,V,5,-5,8,80,16,10,91,2,2,2003
1089,1089,11/08/2003,Navy,24,53,238,5,4,46,0,1,Notre Dame,27,48,280,27,14,137,0,0,V,-8.5,-3,5,-42,-22,-10,-91,0,1,2003
1090,1090,11/08/2003,Nebraska,24,53,290,12,7,110,1,1,Kansas,3,29,88,34,24,204,3,1,V,18,21,24,202,-22,-17,-94,-2,0,2003
1091,1091,11/08/2003,Nevada-Las Vegas,0,22,31,34,15,144,3,1,San Diego State,7,50,151,25,13,158,1,1,H,5,-7,-28,-120,9,2,-14,2,0,2003
1092,1092,11/08/2003,Nevada-Reno,10,28,113,34,17,308,1,1,Fresno State,27,53,212,28,19,184,0,1,H,0,-17,-25,-99,6,-2,124,1,0,2003
1093,1093,11/08/2003,North Carolina,42,46,328,26,12,147,1,0,Wake Forest,34,53,251,33,22,311,0,3,H,-9,8,-7,77,-7,-10,-164,1,-3,2003
1094,1094,11/08/2003,North Texas,28,48,142,18,12,215,1,0,UL-Monroe,26,28,106,39,23,230,1,1,V,18,2,20,36,-21,-11,-15,0,-1,2003
1095,1095,11/08/2003,Northern Illinois,40,43,201,31,17,280,1,1,Buffalo,9,35,130,37,19,176,2,2,V,22.5,31,8,71,-6,-2,104,-1,-1,2003
1096,1096,11/08/2003,Northwestern,17,51,253,21,13,188,1,2,Penn State,7,31,93,38,23,241,1,0,H,-5.5,10,20,160,-17,-10,-53,0,2,2003
1097,1097,11/08/2003,Notre Dame,27,48,280,27,14,137,0,0,Navy,24,53,238,5,4,46,0,1,H,8.5,3,-5,42,22,10,91,0,-1,2003
1098,1098,11/08/2003,Ohio,33,58,274,12,10,168,0,1,Kent State,37,36,168,37,21,283,1,3,H,2.5,-4,22,106,-25,-11,-115,-1,-2,2003
1099,1099,11/08/2003,Ohio State,33,49,182,24,12,213,1,0,Michigan State,23,17,5,56,36,373,2,0,H,6,10,32,177,-32,-24,-160,-1,0,2003
1100,1100,11/08/2003,Oklahoma,77,61,342,21,18,297,0,0,Texas A & M,0,28,22,14,4,32,0,1,H,30.5,77,33,320,7,14,265,0,-1,2003
1101,1101,11/08/2003,Oklahoma State,16,48,160,32,11,149,2,1,Texas,55,47,298,16,11,204,0,0,H,-3,-39,1,-138,16,0,-55,2,1,2003
1102,1102,11/08/2003,Oregon,21,27,94,34,17,224,0,0,California,17,40,106,27,15,188,1,0,H,-2,4,-13,-12,7,2,36,-1,0,2003
1103,1103,11/08/2003,Penn State,7,31,93,38,23,241,1,0,Northwestern,17,51,253,21,13,188,1,2,V,5.5,-10,-20,-160,17,10,53,0,-2,2003
1104,1104,11/08/2003,Pittsburgh,31,39,143,31,24,303,1,2,Virginia Tech,28,40,269,21,11,186,2,2,H,-5,3,-1,-126,10,13,117,-1,0,2003
1105,1105,11/08/2003,Purdue,27,44,154,20,13,167,0,0,Iowa,14,36,98,30,16,203,1,0,H,3.5,13,8,56,-10,-3,-36,-1,0,2003
1106,1106,11/08/2003,Rice,28,54,201,8,2,31,1,2,Tulsa,31,38,206,30,18,195,3,1,H,-3,-3,16,-5,-22,-16,-164,-2,1,2003
1107,1107,11/08/2003,Rutgers,31,45,244,32,18,211,2,3,Connecticut,38,30,99,32,17,222,0,0,V,-7,-7,15,145,0,1,-11,2,3,2003
1108,1108,11/08/2003,San Diego State,7,50,151,25,13,158,1,1,Nevada-Las Vegas,0,22,31,34,15,144,3,1,V,-5,7,28,120,-9,-2,14,-2,0,2003
1109,1109,11/08/2003,San Jose State,69,33,117,41,29,547,0,1,Texas-El Paso,41,42,281,40,23,349,4,0,V,3,28,-9,-164,1,6,198,-4,1,2003
1110,1110,11/08/2003,South Florida,38,39,142,22,10,101,0,3,East Carolina,37,61,216,34,16,146,0,1,V,11,1,-22,-74,-12,-6,-45,0,2,2003
1111,1111,11/08/2003,Southern Methodist,6,43,162,20,10,80,2,0,Louisiana Tech,41,34,192,22,11,209,1,0,V,-18.5,-35,9,-30,-2,-1,-129,1,0,2003
1112,1112,11/08/2003,Southern Miss,31,35,136,26,17,237,0,0,Houston,10,52,205,30,15,158,1,1,V,7.5,21,-17,-69,-4,2,79,-1,-1,2003
1113,1113,11/08/2003,Stanford,38,53,188,34,18,279,1,0,Arizona State,27,23,97,53,23,357,1,2,H,-2,11,30,91,-19,-5,-78,0,-2,2003
1114,1114,11/08/2003,Syracuse,41,51,232,20,16,221,1,0,Temple,17,30,94,34,19,183,2,0,H,18.5,24,21,138,-14,-3,38,-1,0,2003
1115,1115,11/08/2003,Temple,17,30,94,34,19,183,2,0,Syracuse,41,51,232,20,16,221,1,0,V,-18.5,-24,-21,-138,14,3,-38,1,0,2003
1116,1116,11/08/2003,Tennessee,10,40,89,18,11,81,0,0,Miami-Florida,6,25,108,35,22,213,2,2,V,-11.5,4,15,-19,-17,-11,-132,-2,-2,2003
1117,1117,11/08/2003,Texas,55,47,298,16,11,204,0,0,Oklahoma State,16,48,160,32,11,149,2,1,V,3,39,-1,138,-16,0,55,-2,-1,2003
1118,1118,11/08/2003,Texas A & M,0,28,22,14,4,32,0,1,Oklahoma,77,61,342,21,18,297,0,0,V,-30.5,-77,-33,-320,-7,-14,-265,0,1,2003
1119,1119,11/08/2003,Texas Tech,62,28,136,64,44,580,0,0,Baylor,14,30,111,26,18,164,1,1,V,24.5,48,-2,25,38,26,416,-1,-1,2003
1120,1120,11/08/2003,Texas-El Paso,41,41,276,40,23,349,4,0,San Jose State,69,33,117,41,29,547,0,1,H,-3,-28,8,159,-1,-6,-198,4,-1,2003
1121,1121,11/08/2003,Troy State,20,46,202,29,12,147,1,1,Mid Tennessee St,27,42,195,23,16,182,0,1,V,-3,-7,4,7,6,-4,-35,1,0,2003
1122,1122,11/08/2003,Tulane,38,37,244,33,16,255,1,1,Alabama-Birmingham,24,45,237,36,14,262,2,2,V,-13.5,14,-8,7,-3,2,-7,-1,-1,2003
1123,1123,11/08/2003,Tulsa,31,38,206,30,18,195,3,1,Rice,28,53,196,8,2,31,1,2,V,3,3,-15,10,22,16,164,2,-1,2003
1124,1124,11/08/2003,U-C-F,13,47,135,18,7,46,1,2,Eastern Michigan,19,47,152,18,8,116,1,1,V,7,-6,0,-17,0,-1,-70,0,1,2003
1125,1125,11/08/2003,U.C.L.A.,13,42,145,42,18,220,3,4,Washington State,31,49,146,22,8,177,3,4,V,-10.5,-18,-7,-1,20,10,43,0,0,2003
1126,1126,11/08/2003,UL-Lafayette,43,50,236,37,21,207,1,0,Florida Intl,10,26,94,41,19,211,1,1,H, ,33,24,142,-4,2,-4,0,-1,2003
1127,1127,11/08/2003,UL-Monroe,26,28,106,39,23,230,1,1,North Texas,28,48,142,18,12,215,1,0,H,-18,-2,-20,-36,21,11,15,0,1,2003
1128,1128,11/08/2003,Vanderbilt,17,45,133,39,18,189,4,0,Florida,35,34,194,25,15,179,2,2,V,-23,-18,11,-61,14,3,10,2,-2,2003
1129,1129,11/08/2003,Virginia Tech,28,40,269,21,11,186,2,2,Pittsburgh,31,39,143,31,24,303,1,2,V,5,-3,1,126,-10,-13,-117,1,0,2003
1130,1130,11/08/2003,Wake Forest,34,53,251,34,23,317,0,3,North Carolina,42,46,328,26,12,147,1,0,V,9,-8,7,-77,8,11,170,-1,3,2003
1131,1131,11/08/2003,Washington,22,35,101,51,31,351,0,2,Arizona,27,37,250,26,11,151,1,0,V,15,-5,-2,-149,25,20,200,-1,2,2003
1132,1132,11/08/2003,Washington State,31,49,146,22,8,177,3,4,U.C.L.A.,13,42,145,42,18,220,3,4,H,10.5,18,7,1,-20,-10,-43,0,0,2003
1133,1133,11/08/2003,West Virginia,35,39,144,16,11,167,0,0,Boston College,28,36,158,55,30,317,4,0,V,-3.5,7,3,-14,-39,-19,-150,-4,0,2003
1134,1134,11/08/2003,Western Michigan,28,35,167,23,20,250,0,0,Ball State,20,34,111,44,27,326,0,1,H,2.5,8,1,56,-21,-7,-76,0,-1,2003
1135,1135,11/08/2003,Wisconsin,34,32,119,34,23,305,1,0,Minnesota,37,55,336,17,11,159,0,0,V,-8.5,-3,-23,-217,17,12,146,1,0,2003
1136,1136,11/12/2003,Marshall,6,28,126,25,14,113,2,3,Miami-Ohio,45,44,212,30,18,282,0,0,V,-13.5,-39,-16,-86,-5,-4,-169,2,3,2003
1137,1137,11/12/2003,Miami-Ohio,45,44,212,30,18,282,0,0,Marshall,6,28,126,25,14,113,2,3,H,13.5,39,16,86,5,4,169,-2,-3,2003
1138,1138,11/13/2003,Maryland,27,48,278,21,14,191,0,0,Virginia,17,32,108,26,13,186,0,0,H,6,10,16,170,-5,1,5,0,0,2003
1139,1139,11/13/2003,Virginia,17,32,108,26,13,186,0,0,Maryland,27,48,278,21,14,191,0,0,V,-6,-10,-16,-170,5,-1,-5,0,0,2003
1140,1140,11/15/2003,Air Force,12,44,158,15,8,115,1,0,New Mexico,24,58,274,10,5,90,0,0,V,-4.5,-12,-14,-116,5,3,25,1,0,2003
1141,1141,11/15/2003,Akron,35,36,98,31,17,277,0,0,Ohio,28,53,220,23,11,190,2,0,H,11,7,-17,-122,8,6,87,-2,0,2003
1142,1142,11/15/2003,Alabama,3,26,65,33,12,154,1,0,Louisiana State,27,40,219,36,24,251,1,1,H,-7.5,-24,-14,-154,-3,-12,-97,0,-1,2003
1143,1143,11/15/2003,Arizona,0,26,50,34,12,145,3,1,Southern Cal,45,48,220,37,26,367,0,2,H,-29,-45,-22,-170,-3,-14,-222,3,-1,2003
1144,1144,11/15/2003,Arizona State,19,32,60,35,19,262,1,1,Washington State,34,39,118,31,19,284,1,0,V,-13,-15,-7,-58,4,0,-22,0,1,2003
1145,1145,11/15/2003,Arkansas,48,8,60,2,1,44,0,-2,New Mexico State,20,8,13,-9,-2,33,-2,0,H,29,28,0,47,11,3,11,2,-2,2003
1146,1146,11/15/2003,Arkansas State,14,35,41,24,13,149,2,2,North Texas,58,49,337,17,10,185,1,2,V,-21,-44,-14,-296,7,3,-36,1,0,2003
1147,1147,11/15/2003,Army,14,28,10,29,11,198,0,0,Houston,34,70,260,28,24,301,0,3,H,-8.5,-20,-42,-250,1,-13,-103,0,-3,2003
1148,1148,11/15/2003,Auburn,7,25,81,33,20,178,1,2,Georgia,26,45,123,25,12,208,0,0,V,-4.5,-19,-20,-42,8,8,-30,1,2,2003
1149,1149,11/15/2003,Ball State,14,27,63,48,27,273,2,1,Eastern Michigan,38,53,238,9,6,52,0,0,V,10.5,-24,-26,-175,39,21,221,2,1,2003
1150,1150,11/15/2003,Baylor,3,36,75,30,16,108,1,1,Oklahoma,41,29,56,41,22,308,0,0,V,-54,-38,7,19,-11,-6,-200,1,1,2003
1151,1151,11/15/2003,Boise State,51,45,256,34,16,218,1,0,Texas-El Paso,21,37,101,33,18,211,2,1,H,41.5,30,8,155,1,-2,7,-1,-1,2003
1152,1152,11/15/2003,Boston College,35,42,215,26,17,244,0,1,Rutgers,25,42,101,28,20,249,0,0,V,7,10,0,114,-2,-3,-5,0,1,2003
1153,1153,11/15/2003,Bowling Green,42,42,297,36,24,324,0,3,Kent State,33,46,298,45,19,239,0,0,H,21.5,9,-4,-1,-9,5,85,0,3,2003
1154,1154,11/15/2003,Brigham Young,14,26,53,30,18,250,3,1,Notre Dame,33,50,204,30,15,156,1,0,V,-9.5,-19,-24,-151,0,3,94,2,1,2003
1155,1155,11/15/2003,California,54,35,381,34,20,348,0,0,Washington,7,33,34,47,25,259,2,1,H,6,47,2,347,-13,-5,89,-2,-1,2003
1156,1156,11/15/2003,Central Michigan,21,48,160,32,16,190,0,3,Western Michigan,44,37,143,35,20,348,1,1,V,-9,-23,11,17,-3,-4,-158,-1,2,2003
1157,1157,11/15/2003,Cincinnati,10,34,89,52,27,284,2,1,Texas Christian,43,38,177,20,9,121,2,0,V,-7.5,-33,-4,-88,32,18,163,0,1,2003
1158,1158,11/15/2003,Clemson,40,37,142,43,28,344,2,1,Duke,7,39,117,15,7,57,2,1,H,13.5,33,-2,25,28,21,287,0,0,2003
1159,1159,11/15/2003,Colorado,44,45,110,29,21,288,1,2,Iowa State,10,32,102,40,16,121,1,2,V,6,34,13,8,-11,5,167,0,0,2003
1160,1160,11/15/2003,Colorado State,21,40,168,19,11,156,0,1,San Diego State,6,30,108,50,23,237,2,0,H,14.5,15,10,60,-31,-12,-81,-2,1,2003
1161,1161,11/15/2003,Connecticut,51,44,223,38,24,313,1,1,Wake Forest,17,40,135,28,16,149,1,1,V,-9.5,34,4,88,10,8,164,0,0,2003
1162,1162,11/15/2003,Duke,7,39,117,15,7,57,2,1,Clemson,40,37,142,43,28,344,2,1,V,-13.5,-33,2,-25,-28,-21,-287,0,0,2003
1163,1163,11/15/2003,Eastern Michigan,38,53,238,9,6,52,0,0,Ball State,14,27,63,48,27,273,2,1,H,-10.5,24,26,175,-39,-21,-221,-2,-1,2003
1164,1164,11/15/2003,Florida,24,40,243,20,12,121,0,2,South Carolina,22,49,199,27,14,132,1,1,V,7,2,-9,44,-7,-2,-11,-1,1,2003
1165,1165,11/15/2003,Florida State,50,43,272,32,15,183,1,0,No Carolina State,44,35,92,39,28,422,0,3,H,13.5,6,8,180,-7,-13,-239,1,-3,2003
1166,1166,11/15/2003,Fresno State,41,40,311,32,21,197,0,0,San Jose State,7,27,114,38,24,179,0,1,H,14,34,13,197,-6,-3,18,0,-1,2003
1167,1167,11/15/2003,Georgia,26,45,123,25,12,208,0,0,Auburn,7,25,81,33,20,178,1,2,H,4.5,19,20,42,-8,-8,30,-1,-2,2003
1168,1168,11/15/2003,Georgia Tech,41,50,298,27,14,148,0,0,North Carolina,24,31,157,40,26,289,1,1,H,9,17,19,141,-13,-12,-141,-1,-1,2003
1169,1169,11/15/2003,Hawaii,14,20,89,48,25,269,2,1,Nevada-Reno,24,49,143,30,15,169,1,1,V,4,-10,-29,-54,18,10,100,1,0,2003
1170,1170,11/15/2003,Houston,34,70,260,28,24,301,0,3,Army,14,28,10,29,11,198,0,0,V,8.5,20,42,250,-1,13,103,0,3,2003
1171,1171,11/15/2003,Idaho,58,52,284,18,12,223,1,0,UL-Monroe,20,31,93,43,22,232,3,0,V,1.5,38,21,191,-25,-10,-9,-2,0,2003
1172,1172,11/15/2003,Indiana,7,61,253,28,15,126,1,1,Penn State,52,31,178,23,14,260,0,0,V,-19,-45,30,75,5,1,-134,1,1,2003
1173,1173,11/15/2003,Iowa,40,31,134,28,17,210,1,0,Minnesota,22,51,175,46,28,388,1,4,H,5.5,18,-20,-41,-18,-11,-178,0,-4,2003
1174,1174,11/15/2003,Iowa State,10,32,102,40,16,121,1,2,Colorado,44,45,110,29,21,288,1,2,H,-6,-34,-13,-8,11,-5,-167,0,0,2003
1175,1175,11/15/2003,Kansas,21,36,136,53,30,259,3,0,Oklahoma State,44,36,295,22,14,190,2,0,V,-19.5,-23,0,-159,31,16,69,1,0,2003
1176,1176,11/15/2003,Kansas State,38,53,248,28,15,313,3,0,Nebraska,9,41,195,26,8,98,2,2,V,2.5,29,12,53,2,7,215,1,-2,2003
1177,1177,11/15/2003,Kent State,33,46,298,45,19,239,0,0,Bowling Green,42,42,297,36,24,324,0,3,V,-21.5,-9,4,1,9,-5,-85,0,-3,2003
1178,1178,11/15/2003,Kentucky,17,37,168,38,16,241,1,0,Vanderbilt,28,41,246,17,14,175,0,0,V,6.5,-11,-4,-78,21,2,66,1,0,2003
1179,1179,11/15/2003,Louisiana State,27,40,219,36,24,251,1,1,Alabama,3,26,65,33,12,154,1,0,V,7.5,24,14,154,3,12,97,0,1,2003
1180,1180,11/15/2003,Louisiana Tech,18,44,152,27,12,161,4,1,Tulsa,48,45,242,31,20,241,1,0,V,0,-30,-1,-90,-4,-8,-80,3,1,2003
1181,1181,11/15/2003,Louisville,7,27,57,31,13,159,1,0,Memphis,37,51,242,29,17,201,0,0,H,4.5,-30,-24,-185,2,-4,-42,1,0,2003
1182,1182,11/15/2003,Memphis,37,51,242,29,17,201,0,0,Louisville,7,27,57,31,13,159,1,0,V,-4.5,30,24,185,-2,4,42,-1,0,2003
1183,1183,11/15/2003,Miami-Florida,17,49,170,14,5,80,1,2,Syracuse,10,37,107,21,12,85,1,0,H,19,7,12,63,-7,-7,-5,0,2,2003
1184,1184,11/15/2003,Michigan,41,48,217,31,22,288,0,1,Northwestern,10,33,117,23,12,144,1,2,V,17.5,31,15,100,8,10,144,-1,-1,2003
1185,1185,11/15/2003,Michigan State,21,34,95,33,17,215,2,1,Wisconsin,56,39,245,26,17,385,0,1,V,-3,-35,-5,-150,7,0,-170,2,0,2003
1186,1186,11/15/2003,Mid Tennessee St,51,41,121,40,23,284,1,1,UL-Lafayette,57,43,139,56,37,435,1,1,H,14.5,-6,-2,-18,-16,-14,-151,0,0,2003
1187,1187,11/15/2003,Minnesota,22,51,175,46,28,388,1,4,Iowa,40,31,134,28,17,210,1,0,V,-5.5,-18,20,41,18,11,178,0,4,2003
1188,1188,11/15/2003,Mississippi State,21,32,96,32,19,192,2,1,Tennessee,59,38,189,35,21,346,0,0,V,-23.5,-38,-6,-93,-3,-2,-154,2,1,2003
1189,1189,11/15/2003,Missouri,45,48,362,20,12,89,0,0,Texas A & M,22,47,108,43,30,376,0,1,H,13.5,23,1,254,-23,-18,-287,0,-1,2003
1190,1190,11/15/2003,Nebraska,9,41,195,26,8,98,2,2,Kansas State,38,53,248,28,15,313,3,0,H,-2.5,-29,-12,-53,-2,-7,-215,-1,2,2003
1191,1191,11/15/2003,Nevada-Reno,24,49,143,30,15,169,1,1,Hawaii,14,20,89,48,25,269,2,1,H,-4,10,29,54,-18,-10,-100,-1,0,2003
1192,1192,11/15/2003,New Mexico,24,58,274,10,5,90,0,0,Air Force,12,44,158,15,8,115,1,0,H,4.5,12,14,116,-5,-3,-25,-1,0,2003
1193,1193,11/15/2003,New Mexico State,20,37,136,27,19,214,0,2,Arkansas,48,56,308,17,12,192,0,1,V,-29,-28,-19,-172,10,7,22,0,1,2003
1194,1194,11/15/2003,No Carolina State,44,35,92,39,28,422,0,3,Florida State,50,43,272,32,15,183,1,0,V,-13.5,-6,-8,-180,7,13,239,-1,3,2003
1195,1195,11/15/2003,North Carolina,24,31,157,40,26,289,1,1,Georgia Tech,41,50,298,27,14,148,0,0,V,-9,-17,-19,-141,13,12,141,1,1,2003
1196,1196,11/15/2003,North Texas,58,49,337,17,10,185,1,2,Arkansas State,14,35,41,24,13,149,2,2,H,21,44,14,296,-7,-3,36,-1,0,2003
1197,1197,11/15/2003,Northern Illinois,30,47,233,34,19,211,3,1,Toledo,49,32,131,27,24,301,0,2,V,1.5,-19,15,102,7,-5,-90,3,-1,2003
1198,1198,11/15/2003,Northwestern,10,33,117,23,12,144,1,2,Michigan,41,48,217,31,22,288,0,1,H,-17.5,-31,-15,-100,-8,-10,-144,1,1,2003
1199,1199,11/15/2003,Notre Dame,33,50,204,30,15,156,1,0,Brigham Young,14,26,53,30,18,250,3,1,H,9.5,19,24,151,0,-3,-94,-2,-1,2003
1200,1200,11/15/2003,Ohio,28,53,220,23,11,190,2,0,Akron,35,36,98,31,17,277,0,0,V,-11,-7,17,122,-8,-6,-87,2,0,2003
1201,1201,11/15/2003,Ohio State,16,39,125,30,15,226,0,0,Purdue,13,36,106,47,27,249,0,2,H,3.5,3,3,19,-17,-12,-23,0,-2,2003
1202,1202,11/15/2003,Oklahoma,41,29,56,41,22,308,0,0,Baylor,3,36,75,30,16,108,1,1,H,54,38,-7,-19,11,6,200,-1,-1,2003
1203,1203,11/15/2003,Oklahoma State,44,36,295,22,14,190,2,0,Kansas,21,36,136,53,30,259,3,0,H,19.5,23,0,159,-31,-16,-69,-1,0,2003
1204,1204,11/15/2003,Oregon,31,30,45,28,21,183,0,1,U.C.L.A.,13,32,78,49,29,249,1,0,V,-4,18,-2,-33,-21,-8,-66,-1,1,2003
1205,1205,11/15/2003,Oregon State,43,37,222,52,28,441,1,2,Stanford,3,30,-12,44,16,145,1,1,H,14.5,40,7,234,8,12,296,0,1,2003
1206,1206,11/15/2003,Penn State,52,31,178,23,14,260,0,0,Indiana,7,61,253,28,15,126,1,1,H,19,45,-30,-75,-5,-1,134,-1,-1,2003
1207,1207,11/15/2003,Pittsburgh,31,26,10,47,25,419,3,0,West Virginia,52,58,307,23,14,216,1,1,V,0,-21,-32,-297,24,11,203,2,-1,2003
1208,1208,11/15/2003,Purdue,13,36,106,47,27,249,0,2,Ohio State,16,39,125,30,15,226,0,0,V,-3.5,-3,-3,-19,17,12,23,0,2,2003
1209,1209,11/15/2003,Rice,41,61,300,10,6,221,0,0,Southern Methodist,20,37,137,26,17,186,1,2,V,6.5,21,24,163,-16,-11,35,-1,-2,2003
1210,1210,11/15/2003,Rutgers,25,42,101,28,20,249,0,0,Boston College,35,42,215,26,17,244,0,1,H,-7,-10,0,-114,2,3,5,0,-1,2003
1211,1211,11/15/2003,San Diego State,6,30,108,50,23,237,2,0,Colorado State,21,40,168,19,11,156,0,1,V,-14.5,-15,-10,-60,31,12,81,2,-1,2003
1212,1212,11/15/2003,San Jose State,7,27,114,38,24,179,0,1,Fresno State,41,40,311,32,21,197,0,0,V,-14,-34,-13,-197,6,3,-18,0,1,2003
1213,1213,11/15/2003,South Carolina,22,20,76,-9,-7,-49,-1,-1,Florida,24,-8,-5,5,1,-27,0,-1,H,-7,-2,28,81,-14,-8,-22,-1,0,2003
1214,1214,11/15/2003,Southern Cal,45,48,220,37,26,367,0,2,Arizona,0,26,50,34,12,145,3,1,V,29,45,22,170,3,14,222,-3,1,2003
1215,1215,11/15/2003,Southern Methodist,20,37,137,26,17,186,1,2,Rice,41,61,300,10,6,221,0,0,H,-6.5,-21,-24,-163,16,11,-35,1,2,2003
1216,1216,11/15/2003,Southern Miss,28,50,166,17,11,231,1,0,Tulane,14,35,104,36,21,244,0,1,H,17.5,14,15,62,-19,-10,-13,1,-1,2003
1217,1217,11/15/2003,Stanford,3,30,-12,44,16,145,1,1,Oregon State,43,37,222,52,28,441,1,2,V,-14.5,-40,-7,-234,-8,-12,-296,0,-1,2003
1218,1218,11/15/2003,Syracuse,10,37,107,21,12,85,1,0,Miami-Florida,17,49,170,14,5,80,1,2,V,-19,-7,-12,-63,7,7,5,0,-2,2003
1219,1219,11/15/2003,Temple,23,43,237,30,15,156,0,0,Virginia Tech,24,41,209,25,15,188,2,0,H,-28,-1,2,28,5,0,-32,-2,0,2003
1220,1220,11/15/2003,Tennessee,59,38,189,35,21,346,0,0,Mississippi State,21,32,96,32,19,192,2,1,H,23.5,38,6,93,3,2,154,-2,-1,2003
1221,1221,11/15/2003,Texas,43,43,207,30,20,287,2,1,Texas Tech,40,30,162,58,32,365,0,0,H,18.5,3,13,45,-28,-12,-78,2,1,2003
1222,1222,11/15/2003,Texas A & M,22,47,108,43,30,376,0,1,Missouri,45,48,362,20,12,89,0,0,V,-13.5,-23,-1,-254,23,18,287,0,1,2003
1223,1223,11/15/2003,Texas Christian,43,38,177,20,9,121,2,0,Cincinnati,10,34,89,52,27,284,2,1,H,7.5,33,4,88,-32,-18,-163,0,-1,2003
1224,1224,11/15/2003,Texas Tech,40,30,162,58,32,365,0,0,Texas,43,43,207,30,20,287,2,1,V,-18.5,-3,-13,-45,28,12,78,-2,-1,2003
1225,1225,11/15/2003,Texas-El Paso,21,37,101,33,18,211,2,1,Boise State,51,45,256,34,16,218,1,0,V,-41.5,-30,-8,-155,-1,2,-7,1,1,2003
1226,1226,11/15/2003,Toledo,49,32,131,27,24,301,0,2,Northern Illinois,30,47,233,34,19,211,3,1,H,-1.5,19,-15,-102,-7,5,90,-3,1,2003
1227,1227,11/15/2003,Troy State,23,61,223,18,7,105,0,1,Utah State,14,32,111,37,21,196,3,4,V,-7,9,29,112,-19,-14,-91,-3,-3,2003
1228,1228,11/15/2003,Tulane,14,35,104,36,21,244,0,1,Southern Miss,28,50,166,17,11,231,1,0,V,-17.5,-14,-15,-62,19,10,13,-1,1,2003
1229,1229,11/15/2003,Tulsa,48,45,242,31,20,241,1,0,Louisiana Tech,18,44,152,27,12,161,4,1,H,0,30,1,90,4,8,80,-3,-1,2003
1230,1230,11/15/2003,U.C.L.A.,13,32,78,49,29,249,1,0,Oregon,31,30,45,28,21,183,0,1,H,4,-18,2,33,21,8,66,1,-1,2003
1231,1231,11/15/2003,UL-Lafayette,57,43,139,56,37,435,1,1,Mid Tennessee St,51,41,121,40,23,284,1,1,V,-14.5,6,2,18,16,14,151,0,0,2003
1232,1232,11/15/2003,UL-Monroe,20,31,93,43,22,232,3,0,Idaho,58,52,284,18,12,223,1,0,H,-1.5,-38,-21,-191,25,10,9,2,0,2003
1233,1233,11/15/2003,Utah,47,51,252,26,17,296,0,1,Wyoming,17,22,60,31,19,272,0,0,H,10.5,30,29,192,-5,-2,24,0,1,2003
1234,1234,11/15/2003,Utah State,14,32,111,37,21,196,3,4,Troy State,23,61,223,18,7,105,0,1,H,7,-9,-29,-112,19,14,91,3,3,2003
1235,1235,11/15/2003,Vanderbilt,28,41,246,17,14,175,0,0,Kentucky,17,37,168,38,16,241,1,0,H,-6.5,11,4,78,-21,-2,-66,-1,0,2003
1236,1236,11/15/2003,Virginia Tech,24,41,209,25,15,188,2,0,Temple,23,43,237,30,15,156,0,0,V,28,1,-2,-28,-5,0,32,2,0,2003
1237,1237,11/15/2003,Wake Forest,17,40,135,28,16,149,1,1,Connecticut,51,44,223,38,24,313,1,1,H,9.5,-34,-4,-88,-10,-8,-164,0,0,2003
1238,1238,11/15/2003,Washington,7,33,34,47,25,259,2,1,California,54,35,381,34,20,348,0,0,V,-6,-47,-2,-347,13,5,-89,2,1,2003
1239,1239,11/15/2003,Washington State,34,39,118,31,19,284,1,0,Arizona State,19,32,60,35,19,262,1,1,H,13,15,7,58,-4,0,22,0,-1,2003
1240,1240,11/15/2003,West Virginia,52,58,307,23,14,216,1,1,Pittsburgh,31,26,10,47,25,419,3,0,H,0,21,32,297,-24,-11,-203,-2,1,2003
1241,1241,11/15/2003,Western Michigan,44,37,143,35,20,348,1,1,Central Michigan,21,48,160,32,16,190,0,3,H,9,23,-11,-17,3,4,158,1,-2,2003
1242,1242,11/15/2003,Wisconsin,56,39,245,26,17,385,0,1,Michigan State,21,34,95,33,17,215,2,1,H,3,35,5,150,-7,0,170,-2,0,2003
1243,1243,11/15/2003,Wyoming,17,22,60,31,19,272,0,0,Utah,47,51,252,26,17,296,0,1,V,-10.5,-30,-29,-192,5,2,-24,0,-1,2003
1244,1244,11/19/2003,Marshall,21,47,225,24,16,139,1,0,U-C-F,7,32,111,13,7,59,0,0,V,12,14,15,114,11,9,80,1,0,2003
1245,1245,11/19/2003,U-C-F,7,32,111,13,7,59,0,0,Marshall,21,47,225,24,16,139,1,0,H,-12,-14,-15,-114,-11,-9,-80,-1,0,2003
1246,1246,11/20/2003,Arkansas State,14,31,124,41,21,218,4,0,Mid Tennessee St,24,37,76,37,23,306,0,2,H,-6.5,-10,-6,48,4,-2,-88,4,-2,2003
1247,1247,11/20/2003,Mid Tennessee St,24,37,76,37,23,306,0,2,Arkansas State,14,31,124,41,21,218,4,0,V,6.5,10,6,-48,-4,2,88,-4,2,2003
1248,1248,11/20/2003,Southern Miss,40,35,51,23,14,227,1,0,Texas Christian,28,52,169,31,18,260,2,2,H,2.5,12,-17,-118,-8,-4,-33,-1,-2,2003
1249,1249,11/20/2003,Texas Christian,28,52,169,31,18,260,2,2,Southern Miss,40,35,51,23,14,227,1,0,V,-2.5,-12,17,118,8,4,33,1,2,2003
1250,1250,11/21/2003,Boise State,31,35,90,31,22,273,1,0,Fresno State,17,30,48,51,28,290,1,0,V,8.5,14,5,42,-20,-6,-17,0,0,2003
1251,1251,11/21/2003,Fresno State,17,30,48,51,28,290,1,0,Boise State,31,35,90,31,22,273,1,0,H,-8.5,-14,-5,-42,20,6,17,0,0,2003
1252,1252,11/22/2003,Air Force,3,54,191,24,10,95,1,1,San Diego State,24,33,132,32,24,251,0,0,V,4,-21,21,59,-8,-14,-156,1,1,2003
1253,1253,11/22/2003,Alabama,23,34,111,29,13,180,2,1,Auburn,28,41,249,27,18,270,2,1,V,-7.5,-5,-7,-138,2,-5,-90,0,0,2003
1254,1254,11/22/2003,Alabama-Birmingham,22,44,110,21,12,167,1,0,South Florida,19,41,192,32,12,144,5,1,V,-6.5,3,3,-82,-11,0,23,-4,-1,2003
1255,1255,11/22/2003,Arkansas,52,63,322,21,14,254,0,0,Mississippi State,6,31,120,28,11,107,6,2,H,25.5,46,32,202,-7,3,147,-6,-2,2003
1256,1256,11/22/2003,Army,28,24,60,41,27,338,2,2,Hawaii,59,33,198,61,42,543,3,0,V,-26.5,-31,-9,-138,-20,-15,-205,-1,2,2003
1257,1257,11/22/2003,Auburn,28,41,249,27,18,270,2,1,Alabama,23,34,111,29,13,180,2,1,H,7.5,5,7,138,-2,5,90,0,0,2003
1258,1258,11/22/2003,Ball State,14,31,116,43,21,211,1,1,Bowling Green,41,48,295,29,16,150,0,0,H,-16.5,-27,-17,-179,14,5,61,1,1,2003
1259,1259,11/22/2003,Baylor,27,41,170,33,21,219,0,0,Oklahoma State,38,44,283,22,11,180,0,2,H,-27,-11,-3,-113,11,10,39,0,-2,2003
1260,1260,11/22/2003,Boston College,34,54,229,28,15,232,2,2,Virginia Tech,27,40,203,27,13,187,0,2,V,-15,7,14,26,1,2,45,2,0,2003
1261,1261,11/22/2003,Bowling Green,41,48,295,29,16,150,0,0,Ball State,14,31,116,43,21,211,1,1,V,16.5,27,17,179,-14,-5,-61,-1,-1,2003
1262,1262,11/22/2003,Brigham Young,0,32,115,14,4,41,2,1,Utah,3,46,107,20,11,113,1,1,H,-8,-3,-14,8,-6,-7,-72,1,0,2003
1263,1263,11/22/2003,Buffalo,24,52,262,28,18,172,0,1,Kent State,34,35,239,38,16,211,0,1,V,-14,-10,17,23,-10,2,-39,0,0,2003
1264,1264,11/22/2003,California,28,38,174,38,26,359,1,3,Stanford,16,30,77,35,16,207,1,1,V,12,12,8,97,3,10,152,0,2,2003
1265,1265,11/22/2003,Central Michigan,34,62,283,28,20,233,1,1,Navy,63,52,530,6,3,114,0,0,V,-21,-29,10,-247,22,17,119,1,1,2003
1266,1266,11/22/2003,Cincinnati,16,34,29,39,18,272,1,0,Memphis,21,45,167,28,9,145,3,0,V,-10,-5,-11,-138,11,9,127,-2,0,2003
1267,1267,11/22/2003,Clemson,63,41,240,26,18,302,1,1,South Carolina,17,39,153,34,16,166,3,0,V,1,46,2,87,-8,2,136,-2,1,2003
1268,1268,11/22/2003,Colorado State,24,40,182,26,17,214,2,1,Nevada-Las Vegas,23,48,168,27,12,172,0,0,V,7,1,-8,14,-1,5,42,2,1,2003
1269,1269,11/22/2003,Duke,30,62,254,18,10,171,0,0,North Carolina,22,22,86,35,18,203,1,1,V,-5,8,40,168,-17,-8,-32,-1,-1,2003
1270,1270,11/22/2003,East Carolina,18,43,213,27,13,126,2,0,Tulane,28,38,82,20,14,227,1,0,V,-9.5,-10,5,131,7,-1,-101,1,0,2003
1271,1271,11/22/2003,Eastern Michigan,24,47,155,24,12,148,4,0,Northern Illinois,38,36,188,26,11,159,0,0,V,-24,-14,11,-33,-2,1,-11,4,0,2003
1272,1272,11/22/2003,Georgia,30,46,153,38,24,289,0,1,Kentucky,10,28,75,36,21,137,1,0,H,18,20,18,78,2,3,152,-1,1,2003
1273,1273,11/22/2003,Georgia Tech,17,32,116,30,16,157,1,1,Virginia,29,38,89,37,28,275,0,0,V,-7,-12,-6,27,-7,-12,-118,1,1,2003
1274,1274,11/22/2003,Hawaii,59,33,198,61,42,543,3,0,Army,28,24,60,41,27,338,2,2,H,26.5,31,9,138,20,15,205,1,-2,2003
1275,1275,11/22/2003,Houston,45,48,229,27,21,224,0,2,Louisville,66,52,445,31,24,334,0,0,V,-11,-21,-4,-216,-4,-3,-110,0,2,2003
1276,1276,11/22/2003,Idaho,20,43,143,35,21,250,0,1,Utah State,13,28,114,45,30,322,0,1,H,1.5,7,15,29,-10,-9,-72,0,0,2003
1277,1277,11/22/2003,Illinois,20,34,122,56,32,281,4,2,Northwestern,37,70,444,9,3,24,1,1,H,-3,-17,-36,-322,47,29,257,3,1,2003
1278,1278,11/22/2003,Indiana,16,47,196,26,12,115,1,0,Purdue,24,52,173,20,11,222,2,1,H,-27,-8,-5,23,6,1,-107,-1,-1,2003
1279,1279,11/22/2003,Iowa,27,34,201,27,8,66,2,1,Wisconsin,21,50,171,31,14,194,3,1,V,-3,6,-16,30,-4,-6,-128,-1,0,2003
1280,1280,11/22/2003,Iowa State,7,36,97,28,10,79,2,0,Kansas,36,44,180,28,18,221,1,0,V,-9.5,-29,-8,-83,0,-8,-142,1,0,2003
1281,1281,11/22/2003,Kansas,36,44,180,28,18,221,1,0,Iowa State,7,36,97,28,10,79,2,0,H,9.5,29,8,83,0,8,142,-1,0,2003
1282,1282,11/22/2003,Kansas State,24,69,367,16,7,70,1,1,Missouri,14,29,109,28,14,155,1,0,H,15,10,40,258,-12,-7,-85,0,1,2003
1283,1283,11/22/2003,Kent State,34,35,239,38,16,211,0,1,Buffalo,24,52,262,28,18,172,0,1,H,14,10,-17,-23,10,-2,39,0,0,2003
1284,1284,11/22/2003,Kentucky,10,28,75,36,21,137,1,0,Georgia,30,46,153,38,24,289,0,1,V,-18,-20,-18,-78,-2,-3,-152,1,-1,2003
1285,1285,11/22/2003,Louisiana State,17,47,152,29,16,189,3,0,Mississippi,14,21,27,36,16,200,1,0,V,6.5,3,26,125,-7,0,-11,2,0,2003
1286,1286,11/22/2003,Louisville,66,52,445,31,24,334,0,0,Houston,45,48,229,27,21,224,0,2,H,11,21,4,216,4,3,110,0,-2,2003
1287,1287,11/22/2003,Maryland,26,42,190,37,17,243,1,1,No Carolina State,24,34,98,30,16,276,1,1,V,0,2,8,92,7,1,-33,0,0,2003
1288,1288,11/22/2003,Memphis,21,45,167,28,9,145,3,0,Cincinnati,16,34,29,39,18,272,1,0,H,10,5,11,138,-11,-9,-127,2,0,2003
1289,1289,11/22/2003,Miami-Florida,34,43,220,17,7,93,0,0,Rutgers,10,35,130,46,24,213,3,0,H,28.5,24,8,90,-29,-17,-120,-3,0,2003
1290,1290,11/22/2003,Miami-Ohio,49,34,123,35,22,372,1,2,Ohio,31,45,87,31,14,247,0,0,V,24,18,-11,36,4,8,125,1,2,2003
1291,1291,11/22/2003,Michigan,35,40,170,32,21,278,1,0,Ohio State,21,25,54,46,28,329,1,0,H,7,14,15,116,-14,-7,-51,0,0,2003
1292,1292,11/22/2003,Michigan State,41,30,119,50,29,357,1,0,Penn State,10,31,55,33,16,183,1,1,H,5,31,-1,64,17,13,174,0,-1,2003
1293,1293,11/22/2003,Mississippi,14,21,27,36,16,200,1,0,Louisiana State,17,47,152,29,16,189,3,0,H,-6.5,-3,-26,-125,7,0,11,-2,0,2003
1294,1294,11/22/2003,Mississippi State,6,31,120,28,11,107,6,2,Arkansas,52,62,310,22,15,266,0,0,V,-25.5,-46,-31,-190,6,-4,-159,6,2,2003
1295,1295,11/22/2003,Missouri,14,29,109,28,14,155,1,0,Kansas State,24,69,367,16,7,70,1,1,V,-15,-10,-40,-258,12,7,85,0,-1,2003
1296,1296,11/22/2003,Navy,63,52,530,6,3,114,0,0,Central Michigan,34,62,283,28,20,233,1,1,H,21,29,-10,247,-22,-17,-119,-1,-1,2003
1297,1297,11/22/2003,Nevada-Las Vegas,23,48,168,27,12,172,0,0,Colorado State,24,40,182,26,17,214,2,1,H,-7,-1,8,-14,1,-5,-42,-2,-1,2003
1298,1298,11/22/2003,New Mexico,26,60,336,15,8,77,1,0,Wyoming,3,23,23,25,12,99,1,1,V,8.5,23,37,313,-10,-4,-22,0,-1,2003
1299,1299,11/22/2003,No Carolina State,24,34,98,30,16,276,1,1,Maryland,26,42,190,37,17,243,1,1,H,0,-2,-8,-92,-7,-1,33,0,0,2003
1300,1300,11/22/2003,North Carolina,22,22,86,35,18,203,1,1,Duke,30,62,254,18,10,171,0,0,H,5,-8,-40,-168,17,8,32,1,1,2003
1301,1301,11/22/2003,Northern Illinois,38,36,188,26,11,159,0,0,Eastern Michigan,24,47,155,24,12,148,4,0,H,24,14,-11,33,2,-1,11,-4,0,2003
1302,1302,11/22/2003,Northwestern,37,70,444,9,3,24,1,1,Illinois,20,34,122,56,32,281,4,2,V,3,17,36,322,-47,-29,-257,-3,-1,2003
1303,1303,11/22/2003,Ohio,31,45,87,31,14,247,0,0,Miami-Ohio,49,34,123,35,22,372,1,2,H,-24,-18,11,-36,-4,-8,-125,-1,-2,2003
1304,1304,11/22/2003,Ohio State,21,25,54,46,28,329,1,0,Michigan,35,40,170,32,21,278,1,0,V,-7,-14,-15,-116,14,7,51,0,0,2003
1305,1305,11/22/2003,Oklahoma,56,36,78,32,22,394,0,2,Texas Tech,25,27,129,54,31,230,5,0,V,19,31,9,-51,-22,-9,164,-5,2,2003
1306,1306,11/22/2003,Oklahoma State,38,44,283,22,11,180,0,2,Baylor,27,41,170,33,21,219,0,0,V,27,11,3,113,-11,-10,-39,0,2,2003
1307,1307,11/22/2003,Oregon,34,47,218,27,11,125,1,1,Oregon State,20,26,24,46,22,303,2,1,H,-3,14,21,194,-19,-11,-178,-1,0,2003
1308,1308,11/22/2003,Oregon State,20,26,24,46,22,303,2,1,Oregon,34,47,218,27,11,125,1,1,V,3,-14,-21,-194,19,11,178,1,0,2003
1309,1309,11/22/2003,Penn State,10,31,55,33,16,183,1,1,Michigan State,41,30,119,50,29,357,1,0,V,-5,-31,1,-64,-17,-13,-174,0,1,2003
1310,1310,11/22/2003,Pittsburgh,30,41,253,22,10,147,1,0,Temple,16,33,92,40,24,278,1,0,V,15.5,14,8,161,-18,-14,-131,0,0,2003
1311,1311,11/22/2003,Purdue,24,52,173,20,11,222,2,1,Indiana,16,47,196,26,12,115,1,0,V,27,8,5,-23,-6,-1,107,1,1,2003
1312,1312,11/22/2003,Rice,45,64,450,9,4,48,1,1,Texas-El Paso,14,42,167,26,14,185,1,2,H,14.5,31,22,283,-17,-10,-137,0,-1,2003
1313,1313,11/22/2003,Rutgers,10,35,130,46,24,213,3,0,Miami-Florida,34,43,220,17,7,93,0,0,V,-28.5,-24,-8,-90,29,17,120,3,0,2003
1314,1314,11/22/2003,San Diego State,24,33,132,32,24,251,0,0,Air Force,3,54,191,24,10,95,1,1,H,-4,21,-21,-59,8,14,156,-1,-1,2003
1315,1315,11/22/2003,San Jose State,32,33,97,52,32,470,1,1,Tulsa,34,44,251,25,16,213,1,0,H,-7,-2,-11,-154,27,16,257,0,1,2003
1316,1316,11/22/2003,South Carolina,17,39,153,34,16,166,3,0,Clemson,63,41,240,26,18,302,1,1,H,-1,-46,-2,-87,8,-2,-136,2,-1,2003
1317,1317,11/22/2003,South Florida,19,41,192,32,12,144,5,1,Alabama-Birmingham,22,44,110,21,12,167,1,0,H,6.5,-3,-3,82,11,0,-23,4,1,2003
1318,1318,11/22/2003,Southern Cal,47,34,123,41,27,321,0,2,U.C.L.A.,22,29,11,40,22,283,1,3,H,23,25,5,112,1,5,38,-1,-1,2003
1319,1319,11/22/2003,Stanford,16,30,77,35,16,207,1,1,California,28,38,174,38,26,359,1,3,H,-12,-12,-8,-97,-3,-10,-152,0,-2,2003
1320,1320,11/22/2003,Syracuse,23,38,163,37,23,336,0,2,West Virginia,34,48,196,25,14,271,1,0,H,-1,-11,-10,-33,12,9,65,-1,2,2003
1321,1321,11/22/2003,Temple,16,33,92,40,24,278,1,0,Pittsburgh,30,41,253,22,10,147,1,0,H,-15.5,-14,-8,-161,18,14,131,0,0,2003
1322,1322,11/22/2003,Tennessee,48,36,150,32,18,302,1,1,Vanderbilt,0,37,125,27,9,66,2,0,H,20.5,48,-1,25,5,9,236,-1,1,2003
1323,1323,11/22/2003,Texas Tech,25,27,129,54,31,230,5,0,Oklahoma,56,36,78,32,22,394,0,2,H,-19,-31,-9,51,22,9,-164,5,-2,2003
1324,1324,11/22/2003,Texas-El Paso,14,42,167,26,14,185,1,2,Rice,45,64,450,9,4,48,1,1,V,-14.5,-31,-22,-283,17,10,137,0,1,2003
1325,1325,11/22/2003,Toledo,34,49,227,33,22,225,2,0,Western Michigan,17,25,39,35,24,262,2,0,H,11.5,17,24,188,-2,-2,-37,0,0,2003
1326,1326,11/22/2003,Troy State,28,35,42,41,17,192,0,1,UL-Monroe,24,31,37,52,28,317,1,2,H,15,4,4,5,-11,-11,-125,-1,-1,2003
1327,1327,11/22/2003,Tulane,28,38,82,20,14,227,1,0,East Carolina,18,43,213,27,13,126,2,0,H,9.5,10,-5,-131,-7,1,101,-1,0,2003
1328,1328,11/22/2003,Tulsa,34,44,251,25,16,213,1,0,San Jose State,32,33,97,52,32,470,1,1,V,7,2,11,154,-27,-16,-257,0,-1,2003
1329,1329,11/22/2003,U.C.L.A.,22,29,11,40,22,283,1,3,Southern Cal,47,34,123,41,27,321,0,2,V,-23,-25,-5,-112,-1,-5,-38,1,1,2003
1330,1330,11/22/2003,UL-Monroe,24,31,37,52,28,317,1,2,Troy State,28,35,42,41,17,192,0,1,V,-15,-4,-4,-5,11,11,125,1,1,2003
1331,1331,11/22/2003,Utah,3,46,107,20,11,113,1,1,Brigham Young,0,32,115,14,4,41,2,1,V,8,3,14,-8,6,7,72,-1,0,2003
1332,1332,11/22/2003,Utah State,13,28,114,45,30,322,0,1,Idaho,20,43,143,35,21,250,0,1,V,-1.5,-7,-15,-29,10,9,72,0,0,2003
1333,1333,11/22/2003,Vanderbilt,0,37,125,27,9,66,2,0,Tennessee,48,37,162,31,17,290,1,1,V,-20.5,-48,0,-37,-4,-8,-224,1,-1,2003
1334,1334,11/22/2003,Virginia,29,38,89,37,28,275,0,0,Georgia Tech,17,32,116,30,16,157,1,1,H,7,12,6,-27,7,12,118,-1,-1,2003
1335,1335,11/22/2003,Virginia Tech,27,40,203,27,13,187,0,2,Boston College,34,54,229,28,15,232,2,2,H,15,-7,-14,-26,-1,-2,-45,-2,0,2003
1336,1336,11/22/2003,Washington,27,42,78,45,23,183,2,3,Washington State,19,33,147,35,16,157,5,2,H,-7,8,9,-69,10,7,26,-3,1,2003
1337,1337,11/22/2003,Washington State,19,33,147,35,16,157,5,2,Washington,27,42,78,45,23,183,2,3,V,7,-8,-9,69,-10,-7,-26,3,-1,2003
1338,1338,11/22/2003,West Virginia,34,48,196,25,14,271,1,0,Syracuse,23,38,163,37,23,336,0,2,V,1,11,10,33,-12,-9,-65,1,-2,2003
1339,1339,11/22/2003,Western Michigan,17,25,39,35,24,262,2,0,Toledo,34,49,227,33,22,225,2,0,V,-11.5,-17,-24,-188,2,2,37,0,0,2003
1340,1340,11/22/2003,Wisconsin,21,50,171,31,14,194,3,1,Iowa,27,34,201,27,8,66,2,1,H,3,-6,16,-30,4,6,128,1,0,2003
1341,1341,11/22/2003,Wyoming,3,23,23,25,12,99,1,1,New Mexico,26,60,336,15,8,77,1,0,H,-8.5,-23,-37,-313,10,4,22,0,1,2003
1342,1342,11/25/2003,New Mexico State,10,42,163,22,16,206,1,0,North Texas,13,44,182,11,4,85,0,0,H,-7.5,-3,-2,-19,11,12,121,1,0,2003
1343,1343,11/25/2003,North Texas,13,44,182,11,4,85,0,0,New Mexico State,10,42,163,22,16,206,1,0,V,7.5,3,2,19,-11,-12,-121,-1,0,2003
1344,1344,11/27/2003,Mississippi,31,39,99,27,19,260,0,2,Mississippi State,0,25,101,31,14,91,1,1,V,19,31,14,-2,-4,5,169,-1,1,2003
1345,1345,11/27/2003,Mississippi State,0,25,101,31,14,91,1,1,Mississippi,31,39,99,27,19,260,0,2,H,-19,-31,-14,2,4,-5,-169,1,-1,2003
1346,1346,11/28/2003,Arizona,7,35,113,48,28,339,1,1,Arizona State,28,37,203,26,16,281,0,2,V,-14.5,-21,-2,-90,22,12,58,1,-1,2003
1347,1347,11/28/2003,Arizona State,28,37,203,26,16,281,0,2,Arizona,7,35,113,48,28,339,1,1,H,14.5,21,2,90,-22,-12,-58,-1,1,2003
1348,1348,11/28/2003,Arkansas,24,40,201,12,4,100,2,3,Louisiana State,55,50,250,20,12,186,0,1,V,-9.5,-31,-10,-49,-8,-8,-86,2,2,2003
1349,1349,11/28/2003,Cincinnati,40,42,203,40,20,336,0,1,Louisville,43,35,315,27,16,211,1,3,H,-2.5,-3,7,-112,13,4,125,-1,-2,2003
1350,1350,11/28/2003,Colorado,22,31,64,44,26,269,2,0,Nebraska,31,59,223,18,8,146,0,0,H,-2.5,-9,-28,-159,26,18,123,2,0,2003
1351,1351,11/28/2003,Louisiana State,55,50,250,20,12,186,0,1,Arkansas,24,40,201,12,4,100,2,3,H,9.5,31,10,49,8,8,86,-2,-2,2003
1352,1352,11/28/2003,Louisville,43,35,315,27,16,211,1,3,Cincinnati,40,42,203,40,20,336,0,1,V,2.5,3,-7,112,-13,-4,-125,1,2,2003
1353,1353,11/28/2003,Marshall,28,58,290,15,7,119,1,0,Ohio,0,40,101,11,4,52,0,2,H,17,28,18,189,4,3,67,1,-2,2003
1354,1354,11/28/2003,Miami-Ohio,56,29,107,44,35,450,1,0,U-C-F,21,28,22,48,23,355,2,1,V,26.5,35,1,85,-4,12,95,-1,-1,2003
1355,1355,11/28/2003,Nebraska,31,59,223,18,8,146,0,0,Colorado,22,31,64,44,26,269,2,0,V,2.5,9,28,159,-26,-18,-123,-2,0,2003
1356,1356,11/28/2003,Ohio,0,40,101,11,4,52,0,2,Marshall,28,58,290,15,7,119,1,0,V,-17,-28,-18,-189,-4,-3,-67,-1,2,2003
1357,1357,11/28/2003,Texas,46,60,393,8,5,97,0,3,Texas A & M,15,37,121,37,17,212,1,2,V,22.5,31,23,272,-29,-12,-115,-1,1,2003
1358,1358,11/28/2003,Texas A & M,15,37,121,37,17,212,1,2,Texas,46,60,393,8,5,97,0,3,H,-22.5,-31,-23,-272,29,12,115,1,-1,2003
1359,1359,11/28/2003,U-C-F,21,28,22,48,23,355,2,1,Miami-Ohio,56,29,107,44,35,450,1,0,H,-26.5,-35,-1,-85,4,-12,-95,1,1,2003
1360,1360,11/29/2003,Alabama,29,43,151,38,21,258,2,1,Hawaii,37,21,134,48,22,275,1,0,V,2.5,-8,22,17,-10,-1,-17,1,1,2003
1361,1361,11/29/2003,Alabama-Birmingham,28,45,276,18,9,153,2,0,Houston,56,59,375,14,9,196,0,0,V,1,-28,-14,-99,4,0,-43,2,0,2003
1362,1362,11/29/2003,Boise State,56,45,140,31,21,437,1,0,Nevada-Reno,3,32,149,36,13,127,3,0,H,23.5,53,13,-9,-5,8,310,-2,0,2003
1363,1363,11/29/2003,Bowling Green,31,36,129,27,22,304,0,1,Toledo,23,44,198,23,13,184,1,0,H,8,8,-8,-69,4,9,120,-1,1,2003
1364,1364,11/29/2003,East Carolina,21,39,108,35,20,239,2,2,Southern Miss,38,47,190,24,11,208,3,0,H,-14.5,-17,-8,-82,11,9,31,-1,2,2003
1365,1365,11/29/2003,Florida,34,34,142,37,23,303,0,1,Florida State,38,43,134,19,14,256,0,1,H,-1,-4,-9,8,18,9,47,0,0,2003
1366,1366,11/29/2003,Florida State,38,43,134,19,14,256,0,1,Florida,34,34,142,37,23,303,0,1,V,1,4,9,-8,-18,-9,-47,0,0,2003
1367,1367,11/29/2003,Fresno State,23,41,168,31,22,325,2,1,Texas-El Paso,20,41,128,26,13,124,1,1,V,19,3,0,40,5,9,201,1,0,2003
1368,1368,11/29/2003,Georgia,34,38,106,22,16,235,0,0,Georgia Tech,17,41,146,38,21,255,3,1,V,10,17,-3,-40,-16,-5,-20,-3,-1,2003
1369,1369,11/29/2003,Georgia Tech,17,41,146,38,21,255,3,1,Georgia,34,38,106,22,16,235,0,1,H,-10,-17,3,40,16,5,20,3,0,2003
1370,1370,11/29/2003,Hawaii,37,21,134,48,22,275,1,0,Alabama,29,43,151,38,21,258,2,1,H,-2.5,8,-22,-17,10,1,17,-1,-1,2003
1371,1371,11/29/2003,Houston,56,59,375,14,9,196,0,0,Alabama-Birmingham,28,45,276,18,9,153,2,0,H,-1,28,14,99,-4,0,43,-2,0,2003
1372,1372,11/29/2003,Iowa State,7,47,178,23,13,162,1,3,Missouri,45,46,376,25,15,108,0,0,V,-26.5,-38,1,-198,-2,-2,54,1,3,2003
1373,1373,11/29/2003,Kentucky,7,25,51,43,19,136,2,1,Tennessee,20,38,160,27,11,110,1,-1,H,-14,-13,-13,-109,16,8,26,1,2,2003
1374,1374,11/29/2003,Louisiana Tech,14,19,97,49,26,344,0,3,Rice,49,89,672,5,3,61,0,1,H,7,-35,-70,-575,44,23,283,0,2,2003
1375,1375,11/29/2003,Maryland,41,45,339,22,12,198,0,0,Wake Forest,28,48,316,24,12,108,2,1,V,8.5,13,-3,23,-2,0,90,-2,-1,2003
1376,1376,11/29/2003,Memphis,16,38,187,51,25,271,4,3,South Florida,21,47,25,17,8,167,0,2,H,9,-5,-9,162,34,17,104,4,1,2003
1377,1377,11/29/2003,Miami-Florida,28,52,280,17,12,195,1,1,Pittsburgh,14,33,26,30,17,206,3,0,V,3,14,19,254,-13,-5,-11,-2,1,2003
1378,1378,11/29/2003,Missouri,45,46,376,25,15,108,0,0,Iowa State,7,47,178,23,13,162,1,3,H,26.5,38,-1,198,2,2,-54,-1,-3,2003
1379,1379,11/29/2003,Nevada-Las Vegas,35,40,235,25,13,170,1,1,Wyoming,24,42,74,44,27,321,0,1,V,1,11,-2,161,-19,-14,-151,1,0,2003
1380,1380,11/29/2003,Nevada-Reno,3,32,149,36,13,127,3,0,Boise State,56,45,140,31,21,437,1,0,V,-23.5,-53,-13,9,5,-8,-310,2,0,2003
1381,1381,11/29/2003,Notre Dame,57,50,320,16,10,192,1,0,Stanford,7,35,20,39,22,231,1,2,V,5,50,15,300,-23,-12,-39,0,-2,2003
1382,1382,11/29/2003,Pittsburgh,14,33,26,30,17,206,3,0,Miami-Florida,28,52,280,17,12,195,1,1,H,-3,-14,-19,-254,13,5,11,2,-1,2003
1383,1383,11/29/2003,Rice,49,89,672,5,3,61,0,1,Louisiana Tech,14,19,97,49,26,344,0,3,V,-7,35,70,575,-44,-23,-283,0,-2,2003
1384,1384,11/29/2003,Rutgers,24,53,167,33,19,125,1,0,Syracuse,7,27,37,32,14,161,1,1,H,-6.5,17,26,130,1,5,-36,0,-1,2003
1385,1385,11/29/2003,South Florida,21,49,4,16,8,167,0,2,Memphis,16,38,187,51,25,271,4,3,V,-9,5,11,-183,-35,-17,-104,-4,-1,2003
1386,1386,11/29/2003,Southern Methodist,13,40,122,16,7,116,0,0,Texas Christian,20,50,193,26,18,180,1,0,H,-24.5,-7,-10,-71,-10,-11,-64,-1,0,2003
1387,1387,11/29/2003,Southern Miss,38,47,190,24,11,208,3,0,East Carolina,21,41,87,34,20,239,2,2,V,14.5,17,6,103,-10,-9,-31,1,-2,2003
1388,1388,11/29/2003,Stanford,7,35,20,39,22,231,1,2,Notre Dame,57,50,320,16,10,192,1,0,H,-5,-50,-15,-300,23,12,39,0,2,2003
1389,1389,11/29/2003,Syracuse,7,27,37,32,14,161,1,1,Rutgers,24,53,167,33,19,125,1,0,V,6.5,-17,-26,-130,-1,-5,36,0,1,2003
1390,1390,11/29/2003,Temple,28,49,176,33,17,171,3,1,West Virginia,45,49,208,17,7,91,1,1,V,-21,-17,0,-32,16,10,80,2,0,2003
1391,1391,11/29/2003,Tennessee,20,38,160,27,11,110,1,0,Kentucky,7,25,51,43,19,136,2,1,V,14,13,13,109,-16,-8,-26,-1,-1,2003
1392,1392,11/29/2003,Texas Christian,20,50,193,26,18,180,1,0,Southern Methodist,13,40,122,16,7,116,0,0,V,24.5,7,10,71,10,11,64,1,0,2003
1393,1393,11/29/2003,Texas-El Paso,20,41,128,26,13,124,1,1,Fresno State,23,41,168,31,22,325,2,1,H,-19,-3,0,-40,-5,-9,-201,-1,0,2003
1394,1394,11/29/2003,Toledo,23,44,198,23,13,184,1,0,Bowling Green,31,36,129,27,22,304,0,1,V,-8,-8,8,69,-4,-9,-120,1,-1,2003
1395,1395,11/29/2003,Virginia,35,31,110,46,32,358,1,0,Virginia Tech,21,40,151,26,14,214,2,0,H,2.5,14,-9,-41,20,18,144,-1,0,2003
1396,1396,11/29/2003,Virginia Tech,21,40,151,26,14,214,2,0,Virginia,35,31,110,46,32,358,1,0,V,-2.5,-14,9,41,-20,-18,-144,1,0,2003
1397,1397,11/29/2003,Wake Forest,28,48,316,24,12,108,2,0,Maryland,41,45,339,22,12,198,0,0,H,-8.5,-13,3,-23,2,0,-90,2,0,2003
1398,1398,11/29/2003,West Virginia,45,49,208,17,7,91,1,1,Temple,28,49,176,33,17,171,3,1,H,21,17,0,32,-16,-10,-80,-2,0,2003
1399,1399,11/29/2003,Wyoming,24,42,74,44,27,321,0,1,Nevada-Las Vegas,35,40,235,25,13,170,1,1,H,-1,-11,2,-161,19,14,151,-1,0,2003
1400,1400,12/04/2003,Bowling Green,27,35,142,49,30,260,1,2,Miami-Ohio,49,31,136,35,26,440,0,0,H,-6.5,-22,4,6,14,4,-180,1,2,2003
1401,1401,12/04/2003,Miami-Ohio,49,31,136,35,26,440,0,0,Bowling Green,27,35,142,49,30,260,1,2,V,6.5,22,-4,-6,-14,-4,180,-1,-2,2003
1402,1402,12/06/2003,Army,6,30,83,31,16,115,2,0,Navy,34,67,359,10,4,55,1,0,N,-22.5,-28,-37,-276,21,12,60,1,0,2003
1403,1403,12/06/2003,Boise State,45,43,100,31,20,329,1,1,Hawaii,28,18,103,63,33,305,3,0,V,11,17,25,-3,-32,-13,24,-2,1,2003
1404,1404,12/06/2003,Georgia,13,25,50,41,17,199,3,0,Louisiana State,34,46,293,22,14,151,1,0,N,-3,-21,-21,-243,19,3,48,2,0,2003
1405,1405,12/06/2003,Hawaii,28,18,103,63,33,305,3,0,Boise State,45,43,100,31,20,329,1,1,H,-11,-17,-25,3,32,13,-24,2,-1,2003
1406,1406,12/06/2003,Kansas State,35,41,292,17,10,227,0,0,Oklahoma,7,25,83,54,29,315,2,0,N,-14,28,16,209,-37,-19,-88,-2,0,2003
1407,1407,12/06/2003,Louisiana State,34,46,293,22,14,151,1,0,Georgia,13,25,50,41,17,199,3,0,N,3,21,21,243,-19,-3,-48,-2,0,2003
1408,1408,12/06/2003,Navy,34,67,359,10,4,55,1,0,Army,6,30,83,31,16,115,2,0,N,22.5,28,37,276,-21,-12,-60,-1,0,2003
1409,1409,12/06/2003,Notre Dame,12,36,62,34,18,199,2,2,Syracuse,38,45,247,27,17,209,3,1,V,3,-26,-9,-185,7,1,-10,-1,1,2003
1410,1410,12/06/2003,Oklahoma,7,25,83,54,29,315,2,0,Kansas State,35,41,292,17,10,227,0,0,N,14,-28,-16,-209,37,19,88,2,0,2003
1411,1411,12/06/2003,Oregon State,28,33,58,60,34,485,4,1,Southern Cal,52,26,110,38,22,278,2,0,V,-22,-24,7,-52,22,12,207,2,1,2003
1412,1412,12/06/2003,Southern Cal,52,26,110,38,22,278,2,0,Oregon State,28,33,58,60,34,485,4,1,H,22,24,-7,52,-22,-12,-207,-2,-1,2003
1413,1413,12/06/2003,Syracuse,38,45,247,27,17,209,3,1,Notre Dame,12,36,62,34,18,199,2,2,H,-3,26,9,185,-7,-1,10,1,-1,2003
