,Unnamed: 0,Date,TeamName,ScoreOff,RushAttOff,RushYdsOff,PassAttOff,PassCompOff,PassYdsOff,PassIntOff,FumblesOff,Opponent,ScoreDef,RushAttDef,RushYdsDef,PassAttDef,PassCompDef,PassYdsDef,PassIntDef,FumblesDef,Site,Line,ScoreDiff,RushAttDiff,RushYdsDiff,PassAttDiff,PassCompDiff,PassYdsDiff,PassIntDiff,FumblesDiff,season
0,0,09/03/2009,Ball State,10,24,169,35,15,140,1,1,North Texas,20,51,296,33,23,216,1,1,H,15,-10,-27,-127,2,-8,-76,0,0,2009
1,1,09/03/2009,Boise State,19,59,164,30,19,197,0,3,Oregon,9,17,31,27,14,121,1,1,H,3,10,42,133,3,5,76,-1,2,2009
2,2,09/03/2009,Bowling Green,31,28,50,44,32,339,1,0,Troy,14,21,41,44,28,263,2,0,H,-7.5,17,7,9,0,4,76,-1,0,2009
3,3,09/03/2009,Indiana,19,31,73,36,27,326,2,1,Eastern Kentucky,13,31,100,26,17,278,0,1,H, ,6,0,-27,10,10,48,2,0,2009
4,4,09/03/2009,Iowa State,34,40,204,31,17,238,0,2,North Dakota St,17,38,210,27,15,178,1,1,H, ,17,2,-6,4,2,60,-1,1,2009
5,5,09/03/2009,Kent State,18,40,143,35,21,201,2,0,Coastal Carolina,0,40,78,26,12,107,1,1,H, ,18,0,65,9,9,94,1,-1,2009
6,6,09/03/2009,No Carolina State,3,31,59,25,13,74,0,1,South Carolina,7,42,108,22,13,148,1,0,H,5,-4,-11,-49,3,0,-74,-1,1,2009
7,7,09/03/2009,North Texas,20,51,296,33,23,216,1,1,Ball State,10,24,169,35,15,140,1,1,V,-15,10,27,127,-2,8,76,0,0,2009
8,8,09/03/2009,Oregon,9,17,31,27,14,121,1,1,Boise State,19,59,164,30,19,197,0,3,V,-3,-10,-42,-133,-3,-5,-76,1,-2,2009
9,9,09/03/2009,South Carolina,7,42,108,22,13,148,1,0,No Carolina State,3,31,59,25,13,74,0,1,V,-5,4,11,49,-3,0,74,1,-1,2009
10,10,09/03/2009,Temple,24,30,139,28,19,317,3,2,Villanova,27,36,64,36,25,293,0,1,H, ,-3,-6,75,-8,-6,24,3,1,2009
11,11,09/03/2009,Troy,14,21,41,44,28,263,2,0,Bowling Green,31,28,50,44,32,339,1,0,V,7.5,-17,-7,-9,0,-4,-76,1,0,2009
12,12,09/03/2009,Utah,35,50,233,30,20,286,1,2,Utah State,17,34,221,26,10,121,1,0,H,21,18,16,12,4,10,165,0,2,2009
13,13,09/03/2009,Utah State,17,34,221,26,10,121,1,0,Utah,35,50,233,30,20,286,1,2,V,-21,-18,-16,-12,-4,-10,-165,0,-2,2009
14,14,09/04/2009,Hawaii,25,28,111,32,21,304,1,3,Central Arkansas,20,38,84,31,20,186,0,1,H, ,5,-10,27,1,1,118,1,2,2009
15,15,09/04/2009,Tulane,13,34,39,32,19,325,2,0,Tulsa,37,43,201,20,15,211,0,1,H,-14,-24,-9,-162,12,4,114,2,-1,2009
16,16,09/04/2009,Tulsa,37,43,201,20,15,211,0,1,Tulane,13,34,39,32,19,325,2,0,V,14,24,9,162,-12,-4,-114,-2,1,2009
17,17,09/05/2009,Air Force,72,68,474,7,5,102,0,0,Nicholls State,0,44,90,13,7,61,0,4,H, ,72,24,384,-6,-2,41,0,-4,2009
18,18,09/05/2009,Akron,7,30,28,24,13,158,1,0,Penn State,31,30,136,44,32,379,1,1,V,-29,-24,0,-108,-20,-19,-221,0,-1,2009
19,19,09/05/2009,Alabama,34,49,268,30,15,230,1,1,Virginia Tech,24,31,64,20,9,91,0,2,N,6.5,10,18,204,10,6,139,1,-1,2009
20,20,09/05/2009,Arizona,19,46,246,30,19,202,1,1,Central Michigan,6,20,74,31,18,108,1,1,H,14.5,13,26,172,-1,1,94,0,0,2009
21,21,09/05/2009,Arizona State,50,39,199,30,17,208,0,0,Idaho State,3,27,-5,20,9,42,4,1,H, ,47,12,204,10,8,166,-4,-1,2009
22,22,09/05/2009,Arkansas,48,30,144,41,30,447,1,0,Missouri State,10,36,82,22,13,123,2,0,H, ,38,-6,62,19,17,324,-1,0,2009
23,23,09/05/2009,Arkansas State,61,53,358,14,9,138,0,1,Miss Valley State,0,28,30,16,6,39,0,2,H, ,61,25,328,-2,3,99,0,-1,2009
24,24,09/05/2009,Army,27,49,300,5,2,8,0,1,Eastern Michigan,17,29,40,31,18,183,2,1,V,-3.5,10,20,260,-26,-16,-175,-2,0,2009
25,25,09/05/2009,Auburn,37,52,301,27,17,255,0,2,Louisiana Tech,13,37,96,33,18,149,1,1,H,13.5,24,15,205,-6,-1,106,-1,1,2009
26,26,09/05/2009,Baylor,24,37,197,25,16,169,0,1,Wake Forest,21,34,126,31,20,143,3,1,V,-2.5,3,3,71,-6,-4,26,-3,0,2009
27,27,09/05/2009,Boston College,54,38,236,22,15,205,0,0,Northeastern,0,40,82,14,8,49,0,0,H, ,54,-2,154,8,7,156,0,0,2009
28,28,09/05/2009,Brigham Young,14,33,28,38,26,329,2,2,Oklahoma,13,31,118,26,16,147,0,2,N,-23,1,2,-90,12,10,182,2,0,2009
29,29,09/05/2009,Buffalo,23,42,150,19,12,159,0,0,UTEP,17,29,139,46,27,233,0,0,V,-10.5,6,13,11,-27,-15,-74,0,0,2009
30,30,09/05/2009,California,52,37,244,27,17,298,0,0,Maryland,13,43,136,30,17,167,0,2,H,21,39,-6,108,-3,0,131,0,-2,2009
31,31,09/05/2009,Central Michigan,6,20,74,31,18,108,1,1,Arizona,19,46,246,30,19,202,1,1,V,-14.5,-13,-26,-172,1,-1,-94,0,0,2009
32,32,09/05/2009,Clemson,37,47,202,21,9,159,1,1,Middle Tennessee,14,37,92,44,21,207,3,0,H,18.5,23,10,110,-23,-12,-48,-2,1,2009
33,33,09/05/2009,Connecticut,23,49,259,24,11,127,3,1,Ohio,16,32,61,28,15,186,1,1,V,3.5,7,17,198,-4,-4,-59,2,0,2009
34,34,09/05/2009,Duke,16,16,19,55,34,350,0,0,Richmond,24,40,125,24,13,157,0,0,H, ,-8,-24,-106,31,21,193,0,0,2009
35,35,09/05/2009,East Carolina,29,35,189,27,12,131,2,0,Appalachian State,24,48,102,25,14,144,1,0,H, ,5,-13,87,2,-2,-13,1,0,2009
36,36,09/05/2009,Eastern Michigan,17,29,40,31,18,183,2,1,Army,27,49,300,5,2,8,0,1,H,3.5,-10,-20,-260,26,16,175,2,0,2009
37,37,09/05/2009,Florida,62,33,369,27,18,255,0,0,Charleston Southern,3,27,95,49,28,228,1,0,H, ,59,6,274,-22,-10,27,-1,0,2009
38,38,09/05/2009,Florida Atlantic,3,35,122,41,20,236,2,1,Nebraska,49,32,259,25,17,231,1,0,V,-23.5,-46,3,-137,16,3,5,1,1,2009
39,39,09/05/2009,Fresno State,51,52,310,13,8,201,1,1,UC-Davis,0,20,43,42,19,188,1,0,H, ,51,32,267,-29,-11,13,0,1,2009
40,40,09/05/2009,Georgia,10,30,95,30,15,162,1,2,Oklahoma State,24,46,172,22,11,135,0,0,V,-5.5,-14,-16,-77,8,4,27,1,2,2009
41,41,09/05/2009,Georgia Tech,37,50,335,12,7,162,0,3,Jacksonville St,17,33,98,38,23,193,1,1,H, ,20,17,237,-26,-16,-31,-1,2,2009
42,42,09/05/2009,Houston,55,27,91,44,32,447,0,1,Northwestern St(LA),7,40,157,36,22,106,0,3,H, ,48,-13,-66,8,10,341,0,-2,2009
43,43,09/05/2009,Idaho,21,32,171,22,11,179,1,0,New Mexico State,6,33,107,34,22,235,1,2,V,-2.5,15,-1,64,-12,-11,-56,0,-2,2009
44,44,09/05/2009,Illinois,9,35,110,37,22,215,1,1,Missouri,37,37,117,35,26,325,0,0,N,7,-28,-2,-7,2,-4,-110,1,1,2009
45,45,09/05/2009,Iowa,17,31,87,34,22,242,0,2,Northern Iowa,16,32,84,38,23,270,0,1,H, ,1,-1,3,-4,-1,-28,0,1,2009
46,46,09/05/2009,Kansas,49,47,328,22,15,219,0,0,Northern Colorado,3,25,74,31,20,172,0,2,H, ,46,22,254,-9,-5,47,0,-2,2009
47,47,09/05/2009,Kansas State,21,48,225,27,14,182,1,2,Massachusetts,17,26,110,34,10,102,2,0,H, ,4,22,115,-7,4,80,-1,2,2009
48,48,09/05/2009,Kentucky,42,49,245,31,20,243,0,0,Miami-Ohio,0,22,62,34,13,126,2,0,N,16.5,42,27,183,-3,7,117,-2,0,2009
49,49,09/05/2009,Louisiana State,31,29,149,19,11,172,0,1,Washington,23,38,157,45,25,321,1,1,V,18,8,-9,-8,-26,-14,-149,-1,0,2009
50,50,09/05/2009,Louisiana Tech,13,37,96,33,18,149,1,1,Auburn,37,52,301,27,17,255,0,2,V,-13.5,-24,-15,-205,6,1,-106,1,-1,2009
51,51,09/05/2009,Louisville,30,30,176,35,20,243,2,0,Indiana State,10,31,19,21,10,82,3,1,H, ,20,-1,157,14,10,161,-1,-1,2009
52,52,09/05/2009,Marshall,31,36,72,36,27,316,1,1,Southern Illinois,28,28,105,38,22,206,1,2,H, ,3,8,-33,-2,5,110,0,-1,2009
53,53,09/05/2009,Maryland,13,43,136,30,17,167,0,2,California,52,37,244,27,17,298,0,0,V,-21,-39,6,-108,3,0,-131,0,2,2009
54,54,09/05/2009,Miami-Ohio,0,22,62,34,13,126,2,0,Kentucky,42,49,245,31,20,243,0,0,N,-16.5,-42,-27,-183,3,-7,-117,2,0,2009
55,55,09/05/2009,Michigan,31,50,242,28,15,197,1,0,Western Michigan,7,24,38,39,23,263,2,1,H,13,24,26,204,-11,-8,-66,-1,-1,2009
56,56,09/05/2009,Michigan State,44,40,175,35,19,318,0,0,Montana State,3,28,62,26,13,98,0,0,H, ,41,12,113,9,6,220,0,0,2009
57,57,09/05/2009,Middle Tennessee,14,37,92,44,21,207,3,0,Clemson,37,47,202,21,9,159,1,1,V,-18.5,-23,-10,-110,23,12,48,2,-1,2009
58,58,09/05/2009,Minnesota,23,32,112,42,19,248,1,1,Syracuse,20,34,90,31,19,167,1,1,V,7,3,-2,22,11,0,81,0,0,2009
59,59,09/05/2009,Mississippi State,45,45,238,25,16,172,0,2,Jackson State,7,34,62,20,8,132,2,3,H, ,38,11,176,5,8,40,-2,-1,2009
60,60,09/05/2009,Missouri,37,37,117,35,26,325,0,0,Illinois,9,35,110,37,22,215,1,1,N,-7,28,2,7,-2,4,110,-1,-1,2009
61,61,09/05/2009,Navy,27,44,186,13,9,156,1,2,Ohio State,31,38,153,26,17,210,1,0,V,-22,-4,6,33,-13,-8,-54,0,2,2009
62,62,09/05/2009,Nebraska,49,32,259,25,17,231,1,0,Florida Atlantic,3,35,122,41,20,236,2,1,H,23.5,46,-3,137,-16,-3,-5,-1,-1,2009
63,63,09/05/2009,Nevada-Las Vegas,38,41,216,21,17,250,0,0,Sacramento State,3,36,129,19,9,99,1,0,H, ,35,5,87,2,8,151,-1,0,2009
64,64,09/05/2009,Nevada-Reno,0,29,153,27,13,154,2,1,Notre Dame,35,41,178,20,17,332,0,0,V,-14.5,-35,-12,-25,7,-4,-178,2,1,2009
65,65,09/05/2009,New Mexico,6,24,21,40,29,210,0,2,Texas A+M,41,47,245,43,32,361,0,0,V,-14.5,-35,-23,-224,-3,-3,-151,0,2,2009
66,66,09/05/2009,New Mexico State,6,33,107,34,22,235,1,2,Idaho,21,32,171,22,11,179,1,0,H,2.5,-15,1,-64,12,11,56,0,2,2009
67,67,09/05/2009,North Carolina,40,44,261,22,9,114,2,2,The Citadel,6,20,30,39,22,123,3,1,H, ,34,24,231,-17,-13,-9,-1,1,2009
68,68,09/05/2009,Northern Illinois,20,35,100,24,15,174,0,1,Wisconsin,28,38,152,25,18,281,2,1,V,-16.5,-8,-3,-52,-1,-3,-107,-2,0,2009
69,69,09/05/2009,Northwestern,47,54,221,22,16,264,1,0,Towson,14,30,65,27,15,140,2,0,H, ,33,24,156,-5,1,124,-1,0,2009
70,70,09/05/2009,Notre Dame,35,41,178,20,17,332,0,0,Nevada-Reno,0,29,153,27,13,154,2,1,H,14.5,35,12,25,-7,4,178,-2,-1,2009
71,71,09/05/2009,Ohio,16,32,61,28,15,186,1,1,Connecticut,23,49,259,24,11,127,3,1,H,-3.5,-7,-17,-198,4,4,59,-2,0,2009
72,72,09/05/2009,Ohio State,31,38,153,26,17,210,1,0,Navy,27,44,186,13,9,156,1,2,H,22,4,-6,-33,13,8,54,0,-2,2009
73,73,09/05/2009,Oklahoma,13,31,118,26,16,147,0,2,Brigham Young,14,33,28,38,26,329,2,2,N,23,-1,-2,90,-12,-10,-182,-2,0,2009
74,74,09/05/2009,Oklahoma State,24,46,172,22,11,135,0,0,Georgia,10,30,95,30,15,162,1,2,H,5.5,14,16,77,-8,-4,-27,-1,-2,2009
75,75,09/05/2009,Oregon State,34,36,151,23,15,282,0,0,Portland State,7,25,77,41,22,274,0,1,H, ,27,11,74,-18,-7,8,0,-1,2009
76,76,09/05/2009,Penn State,31,30,136,44,32,379,1,1,Akron,7,30,28,24,13,158,1,0,H,29,24,0,108,20,19,221,0,1,2009
77,77,09/05/2009,Pittsburgh,38,33,187,24,16,203,1,0,Youngstown State,3,35,46,22,11,113,2,0,H, ,35,-2,141,2,5,90,-1,0,2009
78,78,09/05/2009,Purdue,52,39,315,28,17,220,3,0,Toledo,31,22,70,69,41,423,2,1,H,10,21,17,245,-41,-24,-203,1,-1,2009
79,79,09/05/2009,Rice,24,34,156,42,22,235,1,1,U-A-B,44,39,295,16,12,221,0,2,V,-5.5,-20,-5,-139,26,10,14,1,-1,2009
80,80,09/05/2009,S-M-U,31,27,153,45,23,202,2,0,Stephen F Austin,23,28,69,52,31,391,5,1,H, ,8,-1,84,-7,-8,-189,-3,-1,2009
81,81,09/05/2009,San Diego State,14,18,39,45,18,238,3,0,U.C.L.A.,33,38,144,31,20,215,2,1,V,-18.5,-19,-20,-105,14,-2,23,1,-1,2009
82,82,09/05/2009,San Jose State,3,31,9,30,15,112,0,2,Southern Cal,56,45,342,23,19,278,0,2,V,-34,-53,-14,-333,7,-4,-166,0,0,2009
83,83,09/05/2009,South Florida,40,32,174,25,21,185,1,1,Wofford,7,50,177,11,4,34,0,2,H, ,33,-18,-3,14,17,151,1,-1,2009
84,84,09/05/2009,Southern Cal,56,45,342,23,19,278,0,2,San Jose State,3,31,9,30,15,112,0,2,H,34,53,14,333,-7,4,166,0,0,2009
85,85,09/05/2009,Southern Miss,52,60,398,29,21,233,0,1,Alcorn State,0,27,62,25,11,109,2,1,H, ,52,33,336,4,10,124,-2,0,2009
86,86,09/05/2009,Stanford,39,42,288,24,11,193,0,0,Washington State,13,34,102,30,19,247,0,0,V,17,26,8,186,-6,-8,-54,0,0,2009
87,87,09/05/2009,Syracuse,20,34,90,31,19,167,1,1,Minnesota,23,32,112,42,19,248,1,1,H,-7,-3,2,-22,-11,0,-81,0,0,2009
88,88,09/05/2009,Tennessee,63,44,380,32,25,277,2,1,Western Kentucky,7,30,34,16,9,49,1,2,H,31,56,14,346,16,16,228,1,-1,2009
89,89,09/05/2009,Texas,59,49,199,35,25,363,1,2,UL-Monroe,20,35,101,30,14,197,1,2,H,43,39,14,98,5,11,166,0,0,2009
90,90,09/05/2009,Texas A+M,41,47,245,43,32,361,0,0,New Mexico,6,24,21,40,29,210,0,2,H,14.5,35,23,224,3,3,151,0,-2,2009
91,91,09/05/2009,Texas Tech,38,19,40,48,34,405,3,0,North Dakota,13,29,73,28,20,134,0,1,H, ,25,-10,-33,20,14,271,3,-1,2009
92,92,09/05/2009,Toledo,31,22,70,69,41,423,2,1,Purdue,52,39,315,28,17,220,3,0,V,-10,-21,-17,-245,41,24,203,-1,1,2009
93,93,09/05/2009,U-A-B,44,39,295,16,12,221,0,2,Rice,24,34,156,42,22,235,1,1,H,5.5,20,5,139,-26,-10,-14,-1,1,2009
94,94,09/05/2009,U-C-F,28,41,125,24,13,157,1,1,Samford,24,30,78,35,21,208,0,0,H, ,4,11,47,-11,-8,-51,1,1,2009
95,95,09/05/2009,U.C.L.A.,33,38,144,31,20,215,2,1,San Diego State,14,18,39,45,18,238,3,0,H,18.5,19,20,105,-14,2,-23,-1,1,2009
96,96,09/05/2009,UL-Lafayette,42,39,208,25,19,325,0,2,Southern Univ,19,36,115,34,20,265,3,0,H, ,23,3,93,-9,-1,60,-3,2,2009
97,97,09/05/2009,UL-Monroe,20,35,101,30,14,197,1,2,Texas,59,49,199,35,25,363,1,2,V,-43,-39,-14,-98,-5,-11,-166,0,0,2009
98,98,09/05/2009,UTEP,17,29,139,46,27,233,0,0,Buffalo,23,42,150,19,12,159,0,0,H,10.5,-6,-13,-11,27,15,74,0,0,2009
99,99,09/05/2009,Vanderbilt,45,70,433,25,13,187,0,1,Western Carolina,0,24,41,26,13,74,1,3,H, ,45,46,392,-1,0,113,-1,-2,2009
100,100,09/05/2009,Virginia,14,39,131,33,18,137,3,4,William + Mary,26,37,125,44,23,184,1,0,H, ,-12,2,6,-11,-5,-47,2,4,2009
101,101,09/05/2009,Virginia Tech,24,31,64,20,9,91,0,2,Alabama,34,49,268,30,15,230,1,1,N,-6.5,-10,-18,-204,-10,-6,-139,-1,1,2009
102,102,09/05/2009,Wake Forest,21,34,126,31,20,143,3,1,Baylor,24,37,197,25,16,169,0,1,H,2.5,-3,-3,-71,6,4,-26,3,0,2009
103,103,09/05/2009,Washington,23,38,157,45,25,321,1,1,Louisiana State,31,29,149,19,11,172,0,1,H,-18,-8,9,8,26,14,149,1,0,2009
104,104,09/05/2009,Washington State,13,34,102,30,19,247,0,0,Stanford,39,42,288,24,11,193,0,0,H,-17,-26,-8,-186,6,8,54,0,0,2009
105,105,09/05/2009,West Virginia,33,34,195,26,19,243,0,0,Liberty,20,26,89,33,22,210,1,0,H, ,13,8,106,-7,-3,33,-1,0,2009
106,106,09/05/2009,Western Kentucky,7,30,34,16,9,49,1,2,Tennessee,63,44,380,32,25,277,2,1,V,-31,-56,-14,-346,-16,-16,-228,-1,1,2009
107,107,09/05/2009,Western Michigan,7,24,38,39,23,263,2,1,Michigan,31,50,242,28,15,197,1,0,V,-13,-24,-26,-204,11,8,66,1,1,2009
108,108,09/05/2009,Wisconsin,28,38,152,25,18,281,2,1,Northern Illinois,20,35,100,24,15,174,0,1,H,16.5,8,3,52,1,3,107,2,0,2009
109,109,09/05/2009,Wyoming,29,48,246,32,16,188,0,1,Weber State,22,21,89,51,32,322,5,0,H, ,7,27,157,-19,-16,-134,-5,1,2009
110,110,09/06/2009,Colorado,17,21,29,40,24,222,1,1,Colorado State,23,45,168,17,10,208,2,0,H,11,-6,-24,-139,23,14,14,-1,1,2009
111,111,09/06/2009,Colorado State,23,45,168,17,10,208,2,0,Colorado,17,21,29,40,24,222,1,1,V,-11,6,24,139,-23,-14,-14,1,-1,2009
112,112,09/06/2009,Memphis,14,42,150,36,17,134,2,1,Mississippi,45,39,174,22,12,175,2,1,H,-17.5,-31,3,-24,14,5,-41,0,0,2009
113,113,09/06/2009,Mississippi,45,39,174,22,12,175,2,1,Memphis,14,42,150,36,17,134,2,1,V,17.5,31,-3,24,-14,-5,41,0,0,2009
114,114,09/07/2009,Cincinnati,47,34,168,36,29,396,1,0,Rutgers,15,33,50,37,23,243,3,0,V,-4.5,32,1,118,-1,6,153,-2,0,2009
115,115,09/07/2009,Florida State,34,29,119,41,24,286,1,1,Miami-Florida,38,29,98,34,21,378,2,0,H,6,-4,0,21,7,3,-92,-1,1,2009
116,116,09/07/2009,Miami-Florida,38,29,98,34,21,378,2,0,Florida State,34,29,119,41,24,286,1,1,V,-6,4,0,-21,-7,-3,92,1,-1,2009
117,117,09/07/2009,Rutgers,15,33,50,37,23,243,3,0,Cincinnati,47,34,168,36,29,396,1,0,H,4.5,-32,-1,-118,1,-6,-153,2,0,2009
118,118,09/10/2009,Clemson,27,36,125,32,15,261,2,0,Georgia Tech,30,49,301,15,4,117,2,0,V,-5,-3,-13,-176,17,11,144,0,0,2009
119,119,09/10/2009,Georgia Tech,30,49,301,15,4,117,2,0,Clemson,27,36,125,32,15,261,2,0,H,5,3,13,176,-17,-11,-144,0,0,2009
120,120,09/11/2009,Colorado,38,23,95,64,30,356,3,1,Toledo,54,43,305,23,15,319,0,2,V,3.5,-16,-20,-210,41,15,37,3,-1,2009
121,121,09/11/2009,Toledo,54,43,305,23,15,319,0,2,Colorado,38,23,95,64,30,356,3,1,H,-3.5,16,20,210,-41,-15,-37,-3,1,2009
122,122,09/12/2009,Air Force,13,66,261,17,10,125,0,1,Minnesota,20,24,108,29,20,219,0,1,V,-3,-7,42,153,-12,-10,-94,0,0,2009
123,123,09/12/2009,Akron,41,49,250,28,16,186,0,0,Morgan State,0,23,41,20,11,86,2,0,H, ,41,26,209,8,5,100,-2,0,2009
124,124,09/12/2009,Alabama,40,42,275,24,18,241,0,0,Florida Intl,14,26,1,38,18,213,1,0,H,33.5,26,16,274,-14,0,28,-1,0,2009
125,125,09/12/2009,Arizona,34,47,365,28,20,194,1,1,Northern Arizona,17,19,67,30,20,159,2,0,H, ,17,28,298,-2,0,35,-1,1,2009
126,126,09/12/2009,Arkansas State,9,38,143,20,11,131,0,1,Nebraska,38,28,136,41,30,358,0,0,V,-22,-29,10,7,-21,-19,-227,0,1,2009
127,127,09/12/2009,Army,19,57,266,24,10,119,2,2,Duke,35,32,70,24,12,166,0,2,H,-2.5,-16,25,196,0,-2,-47,2,0,2009
128,128,09/12/2009,Auburn,49,59,390,24,11,199,0,0,Mississippi State,24,38,167,21,11,130,2,0,H,15.5,25,21,223,3,0,69,-2,0,2009
129,129,09/12/2009,Ball State,16,26,13,34,15,114,1,2,New Hampshire,23,40,110,35,21,212,0,0,7, ,-7,-14,-97,-1,-6,-98,1,2,2009
130,130,09/12/2009,Boise State,48,29,127,30,18,314,1,0,Miami-Ohio,0,26,38,39,23,156,4,0,H,37.5,48,3,89,-9,-5,158,-3,0,2009
131,131,09/12/2009,Boston College,34,37,126,29,15,223,1,0,Kent State,7,29,60,37,21,119,2,1,H,21,27,8,66,-8,-6,104,-1,-1,2009
132,132,09/12/2009,Bowling Green,20,29,114,46,29,206,0,0,Missouri,27,44,181,33,20,172,0,2,V,-20,-7,-15,-67,13,9,34,0,-2,2009
133,133,09/12/2009,Brigham Young,54,45,206,34,26,321,1,0,Tulane,3,24,37,28,20,125,2,2,V,18.5,51,21,169,6,6,196,-1,-2,2009
134,134,09/12/2009,Buffalo,27,30,67,39,26,433,1,3,Pittsburgh,54,28,209,30,21,172,0,0,H,-12,-27,2,-142,9,5,261,1,3,2009
135,135,09/12/2009,California,59,46,342,21,14,165,0,0,Eastern Washington,7,28,14,37,28,221,0,1,H, ,52,18,328,-16,-14,-56,0,-1,2009
136,136,09/12/2009,Central Michigan,29,29,66,47,34,352,1,0,Michigan State,27,30,101,26,16,215,0,0,V,-14.5,2,-1,-35,21,18,137,1,0,2009
137,137,09/12/2009,Cincinnati,70,42,227,35,24,351,0,0,S E Missouri St,3,32,54,28,16,122,3,1,H, ,67,10,173,7,8,229,-3,-1,2009
138,138,09/12/2009,Colorado State,24,23,63,24,11,243,1,0,Weber State,23,36,58,47,29,258,2,1,H, ,1,-13,5,-23,-18,-15,-1,-1,2009
139,139,09/12/2009,Connecticut,10,35,72,26,14,124,1,1,North Carolina,12,38,35,32,23,233,2,0,H,-6,-2,-3,37,-6,-9,-109,-1,1,2009
140,140,09/12/2009,Duke,35,32,70,24,12,166,0,2,Army,19,57,266,24,10,119,2,2,V,2.5,16,-25,-196,0,2,47,-2,0,2009
141,141,09/12/2009,East Carolina,20,27,62,40,16,175,1,0,West Virginia,35,37,175,31,24,334,1,3,V,-5.5,-15,-10,-113,9,-8,-159,0,-3,2009
142,142,09/12/2009,Eastern Michigan,24,32,172,28,20,148,2,0,Northwestern,27,48,185,24,14,158,1,2,V,-21.5,-3,-16,-13,4,6,-10,1,-2,2009
143,143,09/12/2009,Florida,56,46,291,36,25,372,0,3,Troy,6,35,73,24,8,66,1,2,H,37,50,11,218,12,17,306,-1,1,2009
144,144,09/12/2009,Florida Intl,14,26,1,38,18,213,1,0,Alabama,40,42,275,24,18,241,0,0,V,-34,-26,-16,-274,14,0,-28,1,0,2009
145,145,09/12/2009,Florida State,19,27,69,35,22,332,0,3,Jacksonville St,9,42,89,27,12,221,0,1,H, ,10,-15,-20,8,10,111,0,2,2009
146,146,09/12/2009,Fresno State,31,39,179,38,22,289,3,0,Wisconsin,34,39,188,28,17,225,0,0,V,-7.5,-3,0,-9,10,5,64,3,0,2009
147,147,09/12/2009,Georgia,41,29,107,24,17,201,1,2,South Carolina,37,30,114,53,31,313,1,0,H,7,4,-1,-7,-29,-14,-112,0,2,2009
148,148,09/12/2009,Hawaii,38,26,137,37,27,489,0,4,Washington State,20,39,176,38,20,227,3,4,N,2.5,18,-13,-39,-1,7,262,-3,0,2009
149,149,09/12/2009,Houston,45,36,146,46,32,366,1,1,Oklahoma State,35,41,194,31,18,240,1,3,V,-16.5,10,-5,-48,15,14,126,0,-2,2009
150,150,09/12/2009,Idaho,23,23,63,40,26,349,1,0,Washington,42,33,118,25,17,253,0,1,V,-21,-19,-10,-55,15,9,96,1,-1,2009
151,151,09/12/2009,Illinois,45,46,384,17,13,164,1,1,Illinois State,17,20,44,52,31,354,2,1,H, ,28,26,340,-35,-18,-190,-1,0,2009
152,152,09/12/2009,Indiana,23,33,187,29,18,185,0,0,Western Michigan,19,29,22,43,28,266,0,3,H,1,4,4,165,-14,-10,-81,0,-3,2009
153,153,09/12/2009,Iowa,35,35,191,37,20,235,2,0,Iowa State,3,34,190,31,13,113,5,1,V,6.5,32,1,1,6,7,122,-3,-1,2009
154,154,09/12/2009,Iowa State,3,34,190,31,13,113,5,1,Iowa,35,35,191,37,20,235,2,0,H,-6.5,-32,-1,-1,-6,-7,-122,3,1,2009
155,155,09/12/2009,Kansas,34,42,255,43,27,321,1,1,UTEP,7,20,4,29,17,204,1,0,V,13,27,22,251,14,10,117,0,1,2009
156,156,09/12/2009,Kansas State,15,46,196,30,14,181,1,1,UL-Lafayette,17,29,102,36,20,185,1,2,V,6.5,-2,17,94,-6,-6,-4,0,-1,2009
157,157,09/12/2009,Kent State,7,29,60,37,21,119,2,1,Boston College,34,37,126,29,15,223,1,0,V,-21,-27,-8,-66,8,6,-104,1,1,2009
158,158,09/12/2009,Louisiana State,23,42,178,30,21,148,0,1,Vanderbilt,9,39,122,24,11,88,1,0,H,14,14,3,56,6,10,60,-1,1,2009
159,159,09/12/2009,Louisiana Tech,14,17,11,29,18,156,1,0,Navy,32,69,290,8,5,103,0,0,V,-7.5,-18,-52,-279,21,13,53,1,0,2009
160,160,09/12/2009,Marshall,10,28,126,33,16,126,0,1,Virginia Tech,52,53,444,19,9,161,1,0,V,-20,-42,-25,-318,14,7,-35,-1,1,2009
161,161,09/12/2009,Maryland,38,32,123,38,25,236,1,1,James Madison,35,42,268,19,10,149,0,0,H, ,3,-10,-145,19,15,87,1,1,2009
162,162,09/12/2009,Memphis,14,37,93,26,17,126,1,1,Middle Tennessee,31,43,164,27,19,272,0,1,V,-1,-17,-6,-71,-1,-2,-146,1,0,2009
163,163,09/12/2009,Miami-Ohio,0,26,38,39,23,156,4,0,Boise State,48,29,127,30,18,314,1,0,V,-37.5,-48,-3,-89,9,5,-158,3,0,2009
164,164,09/12/2009,Michigan,38,38,190,33,23,240,1,0,Notre Dame,34,30,154,42,25,336,0,1,H,-3.5,4,8,36,-9,-2,-96,1,-1,2009
165,165,09/12/2009,Michigan State,27,30,101,26,16,215,0,0,Central Michigan,29,29,66,47,34,352,1,0,H,14.5,-2,1,35,-21,-18,-137,-1,0,2009
166,166,09/12/2009,Middle Tennessee,31,43,164,27,19,272,0,1,Memphis,14,37,93,26,17,126,1,1,H,1,17,6,71,1,2,146,-1,0,2009
167,167,09/12/2009,Minnesota,20,24,108,29,20,219,0,1,Air Force,13,66,261,17,10,125,0,1,H,3,7,-42,-153,12,10,94,0,0,2009
168,168,09/12/2009,Mississippi State,24,38,167,21,11,130,2,0,Auburn,49,59,390,24,11,199,0,0,V,-15.5,-25,-21,-223,-3,0,-69,2,0,2009
169,169,09/12/2009,Missouri,27,44,181,33,20,172,0,2,Bowling Green,20,29,114,46,29,206,0,0,H,20,7,15,67,-13,-9,-34,0,2,2009
170,170,09/12/2009,Navy,32,69,290,8,5,103,0,0,Louisiana Tech,14,17,11,29,18,156,1,0,H,7.5,18,52,279,-21,-13,-53,-1,0,2009
171,171,09/12/2009,Nebraska,38,28,136,41,30,358,0,0,Arkansas State,9,38,153,20,11,131,0,1,H,22,29,-10,-17,21,19,227,0,-1,2009
172,172,09/12/2009,Nevada-Las Vegas,21,25,82,35,24,228,1,1,Oregon State,23,35,184,31,25,198,0,0,H,-6.5,-2,-10,-102,4,-1,30,1,1,2009
173,173,09/12/2009,New Mexico,10,25,55,30,17,116,1,3,Tulsa,44,44,151,36,23,338,0,1,H,-17,-34,-19,-96,-6,-6,-222,1,2,2009
174,174,09/12/2009,New Mexico State,21,51,238,20,8,63,1,0,Prairie View,18,32,146,27,17,135,1,1,H, ,3,19,92,-7,-9,-72,0,-1,2009
175,175,09/12/2009,No Carolina State,65,48,191,29,21,293,0,0,Murray State,7,25,1,20,9,35,1,2,H, ,58,23,190,9,12,258,-1,-2,2009
176,176,09/12/2009,North Carolina,12,38,35,32,23,233,2,0,Connecticut,10,35,72,26,14,124,1,1,V,6,2,3,-37,6,9,109,1,-1,2009
177,177,09/12/2009,North Texas,30,40,115,35,21,186,1,3,Ohio,31,44,63,31,16,169,1,2,H,-2.5,-1,-4,52,4,5,17,0,1,2009
178,178,09/12/2009,Northern Illinois,41,41,244,18,11,151,0,1,Western Illinois,7,29,82,30,18,141,0,2,H, ,34,12,162,-12,-7,10,0,-1,2009
179,179,09/12/2009,Northwestern,27,48,185,24,14,158,1,2,Eastern Michigan,24,32,172,28,20,148,2,0,H,21.5,3,16,13,-4,-6,10,-1,2,2009
180,180,09/12/2009,Notre Dame,34,30,154,42,25,336,0,1,Michigan,38,38,190,33,23,240,1,0,V,3.5,-4,-8,-36,9,2,96,-1,1,2009
181,181,09/12/2009,Ohio,31,44,63,31,16,169,1,2,North Texas,30,40,115,35,21,186,1,3,V,2.5,1,4,-52,-4,-5,-17,0,-1,2009
182,182,09/12/2009,Ohio State,15,30,88,25,11,177,1,0,Southern Cal,18,40,118,32,15,195,1,0,H,-7,-3,-10,-30,-7,-4,-18,0,0,2009
183,183,09/12/2009,Oklahoma,64,44,278,32,18,286,1,1,Idaho State,0,32,-22,26,11,66,0,2,H, ,64,12,300,6,7,220,1,-1,2009
184,184,09/12/2009,Oklahoma State,35,41,194,31,18,240,1,3,Houston,45,36,146,46,32,366,1,1,H,16.5,-10,5,48,-15,-14,-126,0,2,2009
185,185,09/12/2009,Oregon,38,41,193,21,11,163,0,2,Purdue,36,44,170,42,25,281,2,1,H,13,2,-3,23,-21,-14,-118,-2,1,2009
186,186,09/12/2009,Oregon State,23,35,184,31,25,198,0,0,Nevada-Las Vegas,21,25,82,35,24,228,1,1,V,6.5,2,10,102,-4,1,-30,-1,-1,2009
187,187,09/12/2009,Penn State,28,35,78,31,20,240,1,2,Syracuse,7,29,65,25,18,135,2,0,H,29,21,6,13,6,2,105,-1,2,2009
188,188,09/12/2009,Pittsburgh,54,28,209,30,21,172,0,0,Buffalo,27,30,67,39,26,433,1,3,V,12,27,-2,142,-9,-5,-261,-1,-3,2009
189,189,09/12/2009,Purdue,36,44,170,42,25,281,2,1,Oregon,38,41,193,21,11,163,0,2,V,-13,-2,3,-23,21,14,118,2,-1,2009
190,190,09/12/2009,Rice,10,35,60,41,25,197,1,1,Texas Tech,55,14,52,63,40,508,0,0,V,-28,-45,21,8,-22,-15,-311,1,1,2009
191,191,09/12/2009,Rutgers,45,44,245,14,8,223,0,1,Howard,7,35,113,27,12,151,0,3,H, ,38,9,132,-13,-4,72,0,-2,2009
192,192,09/12/2009,S-M-U,35,29,84,47,28,353,2,2,U-A-B,33,34,222,37,18,226,4,1,V,-11,2,-5,-138,10,10,127,-2,1,2009
193,193,09/12/2009,San Diego State,35,37,149,30,20,287,0,2,Southern Utah,19,29,114,29,15,165,3,0,H, ,16,8,35,1,5,122,-3,2,2009
194,194,09/12/2009,San Jose State,14,22,22,35,22,269,1,0,Utah,24,40,251,32,18,248,0,2,H,-14,-10,-18,-229,3,4,21,1,-2,2009
195,195,09/12/2009,South Carolina,37,30,114,53,31,313,1,0,Georgia,41,29,107,24,17,201,1,2,V,-7,-4,1,7,29,14,112,0,-2,2009
196,196,09/12/2009,South Florida,35,42,253,22,13,208,1,1,Western Kentucky,13,37,200,26,13,84,1,0,V,24.5,22,5,53,-4,0,124,0,1,2009
197,197,09/12/2009,Southern Cal,18,40,118,32,15,195,1,0,Ohio State,15,30,88,25,11,177,1,0,V,7,3,10,30,7,4,18,0,0,2009
198,198,09/12/2009,Southern Miss,26,42,131,31,23,253,0,1,U-C-F,19,27,15,30,17,179,0,2,H,15.5,7,15,116,1,6,74,0,-1,2009
199,199,09/12/2009,Stanford,17,26,115,34,23,276,1,1,Wake Forest,24,45,251,27,19,207,0,0,V,-3,-7,-19,-136,7,4,69,1,1,2009
200,200,09/12/2009,Syracuse,7,29,65,25,18,135,2,0,Penn State,28,35,78,31,20,240,1,2,V,-29,-21,-6,-13,-6,-2,-105,1,-2,2009
201,201,09/12/2009,Tennessee,15,44,115,26,13,93,3,1,U.C.L.A.,19,36,85,23,11,101,0,1,H,11,-4,8,30,3,2,-8,3,0,2009
202,202,09/12/2009,Texas,41,36,191,50,32,353,1,0,Wyoming,10,34,85,50,23,188,0,1,V,33,31,2,106,0,9,165,1,-1,2009
203,203,09/12/2009,Texas Christian,30,50,203,21,15,177,0,1,Virginia,14,33,57,18,8,120,1,0,V,13,16,17,146,3,7,57,-1,1,2009
204,204,09/12/2009,Texas Tech,55,14,52,63,40,508,0,0,Rice,10,35,60,41,25,197,1,1,H,28,45,-21,-8,22,15,311,-1,-1,2009
205,205,09/12/2009,Troy,6,35,73,24,8,66,1,2,Florida,56,46,291,36,25,372,0,3,V,-37,-50,-11,-218,-12,-17,-306,1,-1,2009
206,206,09/12/2009,Tulane,3,24,37,28,20,125,2,2,Brigham Young,54,45,206,34,26,321,1,0,H,-18.5,-51,-21,-169,-6,-6,-196,1,2,2009
207,207,09/12/2009,Tulsa,44,44,151,36,23,338,0,1,New Mexico,10,25,55,30,17,116,1,3,V,17,34,19,96,6,6,222,-1,-2,2009
208,208,09/12/2009,U-A-B,33,34,222,37,18,226,4,1,S-M-U,35,29,84,47,28,353,2,2,H,11,-2,5,138,-10,-10,-127,2,-1,2009
209,209,09/12/2009,U-C-F,19,27,15,30,17,179,0,2,Southern Miss,26,42,131,31,23,253,0,1,V,-15.5,-7,-15,-116,-1,-6,-74,0,1,2009
210,210,09/12/2009,U.C.L.A.,19,36,85,23,11,101,0,1,Tennessee,15,44,115,26,13,93,3,1,V,-11,4,-8,-30,-3,-2,8,-3,0,2009
211,211,09/12/2009,UL-Lafayette,17,29,102,36,20,185,1,2,Kansas State,15,46,196,30,14,181,1,1,H,-6.5,2,-17,-94,6,6,4,0,1,2009
212,212,09/12/2009,UL-Monroe,58,53,345,23,19,247,0,0,Texas Southern,0,21,6,34,18,97,0,4,H, ,58,32,339,-11,1,150,0,-4,2009
213,213,09/12/2009,UTEP,7,20,4,29,17,204,1,0,Kansas,34,42,255,43,27,321,1,1,H,-13,-27,-22,-251,-14,-10,-117,0,-1,2009
214,214,09/12/2009,Utah,24,40,251,32,18,248,0,2,San Jose State,14,22,22,35,22,269,1,0,V,14,10,18,229,-3,-4,-21,-1,2,2009
215,215,09/12/2009,Vanderbilt,9,39,122,24,11,88,1,0,Louisiana State,23,42,178,30,21,148,0,1,V,-14,-14,-3,-56,-6,-10,-60,1,-1,2009
216,216,09/12/2009,Virginia,14,33,57,18,8,120,1,0,Texas Christian,30,50,203,20,15,177,0,1,H,-13,-16,-17,-146,-2,-7,-57,1,-1,2009
217,217,09/12/2009,Virginia Tech,52,53,444,19,9,161,1,0,Marshall,10,28,126,33,16,126,0,1,H,20,42,25,318,-14,-7,35,1,-1,2009
218,218,09/12/2009,Wake Forest,24,45,251,27,19,207,0,0,Stanford,17,26,115,34,23,276,1,1,H,3,7,19,136,-7,-4,-69,-1,-1,2009
219,219,09/12/2009,Washington,42,33,121,25,17,253,0,1,Idaho,23,23,63,40,26,349,1,0,H,21,19,10,58,-15,-9,-96,-1,1,2009
220,220,09/12/2009,Washington State,20,39,176,38,20,227,3,4,Hawaii,38,26,137,37,27,489,0,4,N,-2.5,-18,13,39,1,-7,-262,3,0,2009
221,221,09/12/2009,West Virginia,35,37,175,31,24,334,1,3,East Carolina,20,27,62,40,16,175,1,0,H,5.5,15,10,113,-9,8,159,0,3,2009
222,222,09/12/2009,Western Kentucky,13,37,200,26,13,84,1,0,South Florida,35,42,253,22,13,208,1,1,H,-24.5,-22,-5,-53,4,0,-124,0,-1,2009
223,223,09/12/2009,Western Michigan,19,29,22,43,28,266,0,3,Indiana,23,33,187,29,18,185,0,0,V,-1,-4,-4,-165,14,10,81,0,3,2009
224,224,09/12/2009,Wisconsin,34,39,188,28,17,225,0,0,Fresno State,31,39,179,38,22,289,3,0,H,7.5,3,0,9,-10,-5,-64,-3,0,2009
225,225,09/12/2009,Wyoming,10,34,85,50,23,188,0,1,Texas,41,36,191,50,32,353,1,0,H,-33,-31,-2,-106,0,-9,-165,-1,1,2009
226,226,09/17/2009,Georgia Tech,17,39,95,15,6,133,0,0,Miami-Florida,33,39,184,25,20,270,0,0,V,-4,-16,0,-89,-10,-14,-137,0,0,2009
227,227,09/17/2009,Miami-Florida,33,40,176,25,20,278,0,0,Georgia Tech,17,40,86,15,6,141,0,0,H,4,16,0,90,10,14,137,0,0,2009
228,228,09/18/2009,Boise State,51,29,299,26,18,181,0,1,Fresno State,34,39,320,30,14,187,2,0,V,8,17,-10,-21,-4,4,-6,-2,1,2009
229,229,09/18/2009,Fresno State,34,39,320,30,14,187,2,0,Boise State,51,29,299,26,18,181,0,1,H,-8,-17,10,21,4,-4,6,2,-1,2009
230,230,09/19/2009,Air Force,37,72,298,7,4,73,0,1,New Mexico,13,29,188,23,12,102,3,1,V,17,24,43,110,-16,-8,-29,-3,0,2009
231,231,09/19/2009,Akron,21,30,106,23,14,165,4,0,Indiana,38,46,180,31,20,175,1,1,H,3,-17,-16,-74,-8,-6,-10,3,-1,2009
232,232,09/19/2009,Alabama,53,45,260,28,22,263,0,1,North Texas,7,26,61,23,16,126,0,0,H,38.5,46,19,199,5,6,137,0,1,2009
233,233,09/19/2009,Arizona,17,25,148,26,10,105,1,0,Iowa,27,42,133,32,20,205,1,0,V,-4,-10,-17,15,-6,-10,-100,0,0,2009
234,234,09/19/2009,Arizona State,38,34,118,33,19,220,0,0,UL-Monroe,14,33,136,23,10,126,2,1,H,21.5,24,1,-18,10,9,94,-2,-1,2009
235,235,09/19/2009,Arkansas,41,24,77,39,21,408,0,1,Georgia,52,36,155,26,18,375,1,2,H,2,-11,-12,-78,13,3,33,-1,-1,2009
236,236,09/19/2009,Army,24,57,207,8,3,58,0,1,Ball State,17,28,121,35,19,254,4,0,H,9,7,29,86,-27,-16,-196,-4,1,2009
237,237,09/19/2009,Auburn,41,41,100,33,17,300,1,0,West Virginia,30,39,207,41,24,302,5,1,H,7,11,2,-107,-8,-7,-2,-4,-1,2009
238,238,09/19/2009,Ball State,17,28,121,35,19,254,4,0,Army,24,57,207,8,3,58,0,1,V,-9,-7,-29,-86,27,16,196,4,-1,2009
239,239,09/19/2009,Baylor,22,21,147,27,17,119,1,2,Connecticut,30,58,235,23,12,147,0,0,H,10.5,-8,-37,-88,4,5,-28,1,2,2009
240,240,09/19/2009,Boston College,7,28,29,21,5,25,3,1,Clemson,25,50,151,28,14,102,2,1,V,-8,-18,-22,-122,-7,-9,-77,1,0,2009
241,241,09/19/2009,Bowling Green,10,20,10,62,43,383,0,1,Marshall,17,37,246,21,11,100,1,0,V,3,-7,-17,-236,41,32,283,-1,1,2009
242,242,09/19/2009,Brigham Young,28,19,108,34,23,365,3,2,Florida State,54,49,313,28,22,199,0,0,H,9,-26,-30,-205,6,1,166,3,2,2009
243,243,09/19/2009,Buffalo,17,32,86,36,23,218,1,3,U-C-F,23,42,170,20,15,141,0,2,V,-6,-6,-10,-84,16,8,77,1,1,2009
244,244,09/19/2009,California,35,43,165,25,16,252,0,1,Minnesota,21,22,40,34,22,242,3,1,V,13.5,14,21,125,-9,-6,10,-3,0,2009
245,245,09/19/2009,Central Michigan,48,44,178,23,16,141,0,0,Alcorn State,0,39,36,17,8,100,0,1,H, ,48,5,142,6,8,41,0,-1,2009
246,246,09/19/2009,Cincinnati,28,23,76,49,31,332,1,0,Oregon State,18,36,104,45,29,240,1,0,V,1.5,10,-13,-28,4,2,92,0,0,2009
247,247,09/19/2009,Clemson,25,50,151,28,14,102,2,1,Boston College,7,28,29,21,5,25,3,1,H,8,18,22,122,7,9,77,-1,0,2009
248,248,09/19/2009,Colorado,24,45,151,31,17,175,0,1,Wyoming,0,35,76,36,15,154,0,1,H,7,24,10,75,-5,2,21,0,0,2009
249,249,09/19/2009,Colorado State,35,40,179,21,11,190,0,0,Nevada-Reno,20,31,169,38,25,251,2,3,H,-5,15,9,10,-17,-14,-61,-2,-3,2009
250,250,09/19/2009,Connecticut,30,58,235,23,12,147,0,0,Baylor,22,21,147,27,17,119,1,2,V,-10.5,8,37,88,-4,-5,28,-1,-2,2009
251,251,09/19/2009,Duke,16,33,95,50,30,299,2,0,Kansas,44,31,152,41,28,338,0,0,V,-24,-28,2,-57,9,2,-39,2,0,2009
252,252,09/19/2009,East Carolina,17,30,55,31,20,192,0,1,North Carolina,31,37,148,26,21,285,0,1,V,-8,-14,-7,-93,5,-1,-93,0,0,2009
253,253,09/19/2009,Eastern Michigan,17,48,179,26,15,106,1,1,Michigan,45,39,380,17,7,68,2,0,V,-24,-28,9,-201,9,8,38,-1,1,2009
254,254,09/19/2009,Florida,23,44,208,19,14,115,1,1,Tennessee,13,32,117,19,11,93,2,0,H,30,10,12,91,0,3,22,-1,1,2009
255,255,09/19/2009,Florida Atlantic,16,35,96,38,22,211,1,2,South Carolina,38,35,287,28,21,229,0,1,V,-20.5,-22,0,-191,10,1,-18,1,1,2009
256,256,09/19/2009,Florida Intl,15,23,42,40,26,218,2,1,Rutgers,23,41,160,31,12,234,0,0,V,-16.5,-8,-18,-118,9,14,-16,2,1,2009
257,257,09/19/2009,Florida State,54,49,313,28,22,199,0,0,Brigham Young,28,19,108,34,23,365,3,2,V,-9,26,30,205,-6,-1,-166,-3,-2,2009
258,258,09/19/2009,Georgia,52,36,155,26,18,375,1,2,Arkansas,41,24,77,39,21,408,0,1,V,-2,11,12,78,-13,-3,-33,1,1,2009
259,259,09/19/2009,Hawaii,33,15,28,48,31,477,1,0,Nevada-Las Vegas,34,35,120,43,28,340,2,0,V,-7.5,-1,-20,-92,5,3,137,-1,0,2009
260,260,09/19/2009,Idaho,34,41,147,30,17,232,0,0,San Diego State,20,23,55,41,25,241,1,1,H,-3,14,18,92,-11,-8,-9,-1,-1,2009
261,261,09/19/2009,Indiana,38,46,180,31,20,175,1,1,Akron,21,30,106,23,14,165,4,0,V,-3,17,16,74,8,6,10,-3,1,2009
262,262,09/19/2009,Iowa,27,42,133,32,20,205,1,0,Arizona,17,25,148,26,10,105,1,0,H,4,10,17,-15,6,10,100,0,0,2009
263,263,09/19/2009,Iowa State,34,42,234,28,16,170,1,3,Kent State,14,32,47,32,21,255,1,4,V,3,20,10,187,-4,-5,-85,0,-1,2009
264,264,09/19/2009,Kansas,44,31,152,41,28,338,0,0,Duke,16,33,95,50,30,299,2,0,H,24,28,-2,57,-9,-2,39,-2,0,2009
265,265,09/19/2009,Kansas State,9,37,69,35,21,199,2,0,U.C.L.A.,23,34,173,24,13,186,1,1,V,-12,-14,3,-104,11,8,13,1,-1,2009
266,266,09/19/2009,Kent State,14,32,47,32,21,255,1,4,Iowa State,34,42,234,28,16,170,1,3,H,-3,-20,-10,-187,4,5,85,0,1,2009
267,267,09/19/2009,Kentucky,31,33,168,28,20,178,1,2,Louisville,27,40,133,29,15,245,1,1,H,12.5,4,-7,35,-1,5,-67,0,1,2009
268,268,09/19/2009,Louisiana State,31,36,164,26,17,166,1,0,UL-Lafayette,3,29,109,37,17,163,2,1,H,27,28,7,55,-11,0,3,-1,-1,2009
269,269,09/19/2009,Louisiana Tech,48,40,185,33,22,373,0,1,Nicholls State,13,39,161,22,10,110,3,1,H, ,35,1,24,11,12,263,-3,0,2009
270,270,09/19/2009,Louisville,27,40,133,29,15,245,1,1,Kentucky,31,33,168,28,20,178,1,2,V,-12.5,-4,7,-35,1,-5,67,0,-1,2009
271,271,09/19/2009,Marshall,17,37,246,21,11,100,1,0,Bowling Green,10,20,10,62,43,383,0,1,H,-3,7,17,236,-41,-32,-283,1,-1,2009
272,272,09/19/2009,Maryland,31,40,161,30,19,297,1,3,Middle Tennessee,32,35,89,46,28,351,2,1,H,7.5,-1,5,72,-16,-9,-54,-1,2,2009
273,273,09/19/2009,Memphis,41,37,144,32,24,316,1,2,Tennessee-Martin,14,34,137,36,15,269,0,1,H, ,27,3,7,-4,9,47,1,1,2009
274,274,09/19/2009,Miami-Ohio,26,26,59,49,28,362,1,4,Western Michigan,48,45,152,35,21,218,1,1,V,-16,-22,-19,-93,14,7,144,0,3,2009
275,275,09/19/2009,Michigan,45,39,380,17,7,68,2,0,Eastern Michigan,17,48,179,26,15,106,1,1,H,24,28,-9,201,-9,-8,-38,1,-1,2009
276,276,09/19/2009,Michigan State,30,25,105,40,26,354,1,1,Notre Dame,33,37,133,34,24,304,1,0,V,-11,-3,-12,-28,6,2,50,0,1,2009
277,277,09/19/2009,Middle Tennessee,32,36,87,46,28,351,2,1,Maryland,31,39,158,30,19,288,1,3,V,-7.5,1,-3,-71,16,9,63,1,-2,2009
278,278,09/19/2009,Minnesota,21,21,37,34,22,233,3,1,California,35,44,163,25,16,252,0,1,H,-13.5,-14,-23,-126,9,6,-19,3,0,2009
279,279,09/19/2009,Mississippi,52,35,258,31,18,242,0,2,S E Louisiana,6,30,86,34,21,216,2,3,H, ,46,5,172,-3,-3,26,-2,-1,2009
280,280,09/19/2009,Mississippi State,15,56,260,18,10,81,0,1,Vanderbilt,3,29,33,32,12,124,1,1,V,-8.5,12,27,227,-14,-2,-43,-1,0,2009
281,281,09/19/2009,Missouri,52,36,196,35,23,329,0,0,Furman,12,34,93,40,25,305,1,1,H, ,40,2,103,-5,-2,24,-1,-1,2009
282,282,09/19/2009,Navy,14,46,129,22,6,89,0,0,Pittsburgh,27,37,126,26,19,243,0,1,V,-8,-13,9,3,-4,-13,-154,0,-1,2009
283,283,09/19/2009,Nebraska,15,36,207,30,11,136,2,0,Virginia Tech,16,37,86,27,12,192,0,0,V,-6.6,-1,-1,121,3,-1,-56,2,0,2009
284,284,09/19/2009,Nevada-Las Vegas,34,35,120,43,28,340,2,0,Hawaii,33,15,28,48,31,477,1,0,H,7.5,1,20,92,-5,-3,-137,1,0,2009
285,285,09/19/2009,Nevada-Reno,20,31,169,38,25,251,2,3,Colorado State,35,40,179,21,11,190,0,0,V,5,-15,-9,-10,17,14,61,2,3,2009
286,286,09/19/2009,New Mexico,13,29,188,23,12,102,3,1,Air Force,37,72,298,7,4,73,0,1,H,-17,-24,-43,-110,16,8,29,3,0,2009
287,287,09/19/2009,New Mexico State,12,40,187,23,10,97,2,1,UTEP,38,34,156,33,15,182,0,0,H,-14.5,-26,6,31,-10,-5,-85,2,1,2009
288,288,09/19/2009,No Carolina State,45,31,112,40,29,365,0,1,Gardner-Webb,14,36,101,22,14,112,0,0,H, ,31,-5,11,18,15,253,0,1,2009
289,289,09/19/2009,North Carolina,31,37,148,26,21,285,0,1,East Carolina,17,30,55,31,20,192,0,1,H,8,14,7,93,-5,1,93,0,0,2009
290,290,09/19/2009,North Texas,7,26,61,23,16,126,0,0,Alabama,53,45,260,28,22,263,0,1,V,-38.5,-46,-19,-199,-5,-6,-137,0,-1,2009
291,291,09/19/2009,Northern Illinois,28,57,280,26,15,174,1,1,Purdue,21,23,147,33,20,188,0,3,V,-11.5,7,34,133,-7,-5,-14,1,-2,2009
292,292,09/19/2009,Northwestern,34,28,52,43,36,414,1,2,Syracuse,37,32,125,36,24,346,1,1,V,1.5,-3,-4,-73,7,12,68,0,1,2009
293,293,09/19/2009,Notre Dame,33,37,133,34,24,304,1,0,Michigan State,30,25,105,40,26,354,1,1,H,11,3,12,28,-6,-2,-50,0,-1,2009
294,294,09/19/2009,Ohio,28,31,186,29,15,244,1,1,Cal-San Luis Obispo,10,54,239,11,1,12,2,1,H, ,18,-23,-53,18,14,232,-1,0,2009
295,295,09/19/2009,Ohio State,38,46,247,32,18,275,2,0,Toledo,0,13,13,45,22,197,1,1,N,22,38,33,234,-13,-4,78,1,-1,2009
296,296,09/19/2009,Oklahoma,45,45,193,37,25,336,2,0,Tulsa,0,36,116,37,16,153,2,1,H,18.5,45,9,77,0,9,183,0,-1,2009
297,297,09/19/2009,Oklahoma State,41,36,124,20,14,227,0,2,Rice,24,32,76,51,28,301,1,1,H,33,17,4,48,-31,-14,-74,-1,1,2009
298,298,09/19/2009,Oregon,31,51,217,16,4,95,1,3,Utah,24,33,119,42,20,178,2,0,H,3.5,7,18,98,-26,-16,-83,-1,3,2009
299,299,09/19/2009,Oregon State,18,36,104,45,29,240,1,0,Cincinnati,28,23,76,49,31,332,1,0,H,-1.5,-10,13,28,-4,-2,-92,0,0,2009
300,300,09/19/2009,Penn State,31,36,186,29,17,173,1,0,Temple,6,29,46,34,15,205,0,1,H,29.5,25,7,140,-5,2,-32,1,-1,2009
301,301,09/19/2009,Pittsburgh,27,37,126,26,19,243,0,1,Navy,14,46,129,22,6,89,0,0,H,8,13,-9,-3,4,13,154,0,1,2009
302,302,09/19/2009,Purdue,21,23,147,33,20,188,0,3,Northern Illinois,28,57,280,26,15,174,1,1,H,11.5,-7,-34,-133,7,5,14,-1,2,2009
303,303,09/19/2009,Rice,24,32,76,51,28,301,1,1,Oklahoma State,41,36,124,20,14,227,0,2,V,-33,-17,-4,-48,31,14,74,1,-1,2009
304,304,09/19/2009,Rutgers,23,41,160,31,12,234,0,0,Florida Intl,15,23,42,40,26,218,2,1,H,16.5,8,18,118,-9,-14,16,-2,-1,2009
305,305,09/19/2009,S-M-U,27,27,80,57,40,424,4,1,Washington State,30,17,37,53,24,239,2,1,V,4.5,-3,10,43,4,16,185,2,0,2009
306,306,09/19/2009,San Diego State,20,23,55,41,25,241,1,1,Idaho,34,41,147,30,17,232,0,0,V,3,-14,-18,-92,11,8,9,1,1,2009
307,307,09/19/2009,San Jose State,17,28,24,38,22,177,1,1,Stanford,42,40,211,15,11,171,1,3,V,-19,-25,-12,-187,23,11,6,0,-2,2009
308,308,09/19/2009,South Carolina,38,35,287,28,21,229,0,1,Florida Atlantic,16,35,96,38,22,211,1,2,H,20.5,22,0,191,-10,-1,18,-1,-1,2009
309,309,09/19/2009,South Florida,59,46,249,27,21,298,0,0,Charleston Southern,0,17,53,30,15,135,1,1,H, ,59,29,196,-3,6,163,-1,-1,2009
310,310,09/19/2009,Southern Cal,13,33,250,22,13,110,1,2,Washington,16,33,56,35,21,237,0,0,V,20,-3,0,194,-13,-8,-127,1,2,2009
311,311,09/19/2009,Southern Miss,37,41,214,27,14,130,1,2,Virginia,34,43,78,47,24,312,1,1,H,13.5,3,-2,136,-20,-10,-182,0,1,2009
312,312,09/19/2009,Stanford,42,40,211,15,11,171,1,3,San Jose State,17,28,24,39,23,204,1,1,H,19,25,12,187,-24,-12,-33,0,2,2009
313,313,09/19/2009,Syracuse,37,32,125,36,24,346,1,1,Northwestern,34,28,52,43,36,414,1,2,H,-1.5,3,4,73,-7,-12,-68,0,-1,2009
314,314,09/19/2009,Temple,6,29,46,34,15,205,0,1,Penn State,31,36,186,29,17,173,1,0,V,-29.5,-25,-7,-140,5,-2,32,-1,1,2009
315,315,09/19/2009,Tennessee,13,32,117,19,11,93,2,0,Florida,23,44,208,19,14,115,1,1,V,-30,-10,-12,-91,0,-3,-22,1,-1,2009
316,316,09/19/2009,Texas,34,41,135,34,24,205,2,0,Texas Tech,24,18,-6,62,46,420,1,2,H,20,10,23,141,-28,-22,-215,1,-2,2009
317,317,09/19/2009,Texas A+M,38,44,251,41,21,322,0,0,Utah State,30,46,187,48,24,334,0,2,H,20.5,8,-2,64,-7,-3,-12,0,-2,2009
318,318,09/19/2009,Texas Christian,56,46,286,24,18,222,1,1,Texas State,21,24,30,39,18,219,1,1,H, ,35,22,256,-15,0,3,0,0,2009
319,319,09/19/2009,Texas Tech,24,18,-6,62,46,420,1,2,Texas,34,41,135,34,24,205,2,0,V,-20,-10,-23,-141,28,22,215,-1,2,2009
320,320,09/19/2009,Toledo,0,13,13,45,22,197,1,1,Ohio State,38,46,247,32,18,275,2,0,N,-22,-38,-33,-234,13,4,-78,-1,1,2009
321,321,09/19/2009,Troy,27,32,138,32,24,413,1,1,U-A-B,14,35,176,29,15,109,1,0,H,6.5,13,-3,-38,3,9,304,0,1,2009
322,322,09/19/2009,Tulsa,0,36,116,37,16,153,2,1,Oklahoma,45,45,193,37,25,336,2,0,V,-18.5,-45,-9,-77,0,-9,-183,0,1,2009
323,323,09/19/2009,U-A-B,14,35,176,29,15,109,1,0,Troy,27,32,138,32,24,413,1,1,V,-6.5,-13,3,38,-3,-9,-304,0,-1,2009
324,324,09/19/2009,U-C-F,23,42,170,20,15,141,0,2,Buffalo,17,32,86,36,23,218,1,3,H,6,6,10,84,-16,-8,-77,-1,-1,2009
325,325,09/19/2009,U.C.L.A.,23,34,173,24,13,186,1,1,Kansas State,9,37,69,35,21,199,2,0,H,12,14,-3,104,-11,-8,-13,-1,1,2009
326,326,09/19/2009,UL-Lafayette,3,29,109,37,17,163,2,1,Louisiana State,31,36,164,26,17,166,1,0,V,-27,-28,-7,-55,11,0,-3,1,1,2009
327,327,09/19/2009,UL-Monroe,14,33,136,23,10,126,2,1,Arizona State,38,34,118,33,19,220,0,0,V,-21.5,-24,-1,18,-10,-9,-94,2,1,2009
328,328,09/19/2009,UTEP,38,34,156,33,15,182,0,0,New Mexico State,12,40,187,23,10,97,2,1,V,14.5,26,-6,-31,10,5,85,-2,-1,2009
329,329,09/19/2009,Utah,24,33,119,42,20,178,2,0,Oregon,31,51,217,15,3,68,1,3,V,-3.5,-7,-18,-98,27,17,110,1,-3,2009
330,330,09/19/2009,Utah State,30,46,187,48,24,334,0,2,Texas A+M,38,44,251,41,21,322,0,0,V,-20.5,-8,2,-64,7,3,12,0,2,2009
331,331,09/19/2009,Vanderbilt,3,29,33,32,12,124,1,1,Mississippi State,15,56,260,18,10,81,0,1,H,8.5,-12,-27,-227,14,2,43,1,0,2009
332,332,09/19/2009,Virginia,34,43,78,47,24,312,1,1,Southern Miss,37,41,214,27,14,130,1,2,V,-13.5,-3,2,-136,20,10,182,0,-1,2009
333,333,09/19/2009,Virginia Tech,16,37,86,27,12,192,0,0,Nebraska,15,36,207,30,11,136,2,0,H,6.6,1,1,-121,-3,1,56,-2,0,2009
334,334,09/19/2009,Wake Forest,35,45,132,24,15,294,1,0,Elon,7,27,68,43,24,195,0,0,H, ,28,18,64,-19,-9,99,1,0,2009
335,335,09/19/2009,Washington,16,33,56,35,21,237,0,0,Southern Cal,13,33,250,22,13,110,1,2,H,-20,3,0,-194,13,8,127,-1,-2,2009
336,336,09/19/2009,Washington State,30,17,37,53,24,239,2,1,S-M-U,27,27,80,57,40,424,4,1,H,-4.5,3,-10,-43,-4,-16,-185,-2,0,2009
337,337,09/19/2009,West Virginia,30,39,207,41,24,302,5,1,Auburn,41,41,100,33,17,300,1,0,V,-7,-11,-2,107,8,7,2,4,1,2009
338,338,09/19/2009,Western Kentucky,7,40,146,36,17,141,1,2,Central Arkansas,28,31,193,24,20,214,1,1,H, ,-21,9,-47,12,-3,-73,0,1,2009
339,339,09/19/2009,Western Michigan,48,45,152,35,21,218,1,1,Miami-Ohio,26,26,59,49,28,362,1,4,H,16,22,19,93,-14,-7,-144,0,-3,2009
340,340,09/19/2009,Wisconsin,44,42,258,21,16,172,0,3,Wofford,14,55,214,7,3,45,1,3,H, ,30,-13,44,14,13,127,-1,0,2009
341,341,09/19/2009,Wyoming,0,35,76,36,15,154,0,1,Colorado,24,45,151,31,17,175,0,1,V,-7,-24,-10,-75,5,-2,-21,0,0,2009
342,342,09/24/2009,Mississippi,10,40,139,22,8,109,0,1,South Carolina,16,34,65,34,16,220,0,1,V,4,-6,6,74,-12,-8,-111,0,0,2009
343,343,09/24/2009,South Carolina,16,34,65,34,16,220,0,1,Mississippi,10,40,139,22,8,109,0,1,H,-4,6,-6,-74,12,8,111,0,0,2009
344,344,09/25/2009,Missouri,31,34,78,40,25,414,0,1,Nevada-Reno,21,45,218,29,17,146,0,2,V,7.5,10,-11,-140,11,8,268,0,-1,2009
345,345,09/25/2009,Nevada-Reno,21,45,218,29,17,146,0,2,Missouri,31,34,78,40,25,414,0,1,H,-7.5,-10,11,140,-11,-8,-268,0,1,2009
346,346,09/26/2009,Air Force,26,58,243,7,3,51,0,0,San Diego State,14,25,39,41,25,284,4,2,H,17.5,12,33,204,-34,-22,-233,-4,-2,2009
347,347,09/26/2009,Akron,21,37,69,19,12,127,0,1,Central Michigan,48,53,326,31,23,197,1,0,V,-15,-27,-16,-257,-12,-11,-70,-1,1,2009
348,348,09/26/2009,Alabama,35,41,134,24,17,291,0,0,Arkansas,7,26,63,41,16,191,1,0,H,17.5,28,15,71,-17,1,100,-1,0,2009
349,349,09/26/2009,Arizona,37,33,134,34,25,254,0,0,Oregon State,32,30,104,49,31,303,2,0,V,-3,5,3,30,-15,-6,-49,-2,0,2009
350,350,09/26/2009,Arizona State,17,29,77,31,10,116,1,0,Georgia,20,31,92,31,17,242,2,1,V,-13.5,-3,-2,-15,0,-7,-126,-1,-1,2009
351,351,09/26/2009,Arkansas,7,26,63,41,16,191,1,0,Alabama,35,41,134,24,17,291,0,0,V,-17.5,-28,-15,-71,17,-1,-100,1,0,2009
352,352,09/26/2009,Arkansas State,27,25,70,27,15,235,0,3,Troy,30,37,134,49,34,373,0,3,H,3,-3,-12,-64,-22,-19,-138,0,0,2009
353,353,09/26/2009,Army,10,48,186,26,11,130,1,0,Iowa State,31,43,201,20,11,175,0,0,V,-10,-21,5,-15,6,0,-45,1,0,2009
354,354,09/26/2009,Auburn,54,34,254,29,21,306,1,1,Ball State,30,44,146,30,18,114,0,2,H,30.5,24,-10,108,-1,3,192,1,-1,2009
355,355,09/26/2009,Ball State,30,44,146,30,18,114,0,2,Auburn,54,34,254,29,21,306,1,1,V,-30.5,-24,10,-108,1,-3,-192,-1,1,2009
356,356,09/26/2009,Baylor,68,33,283,25,16,284,0,1,Northwestern St(LA),13,43,133,31,19,115,2,2,H, ,55,-10,150,-6,-3,169,-2,-1,2009
357,357,09/26/2009,Boise State,49,35,267,25,19,262,0,0,Bowling Green,14,33,93,42,21,189,2,1,V,17,35,2,174,-17,-2,73,-2,-1,2009
358,358,09/26/2009,Boston College,27,45,170,29,18,228,1,0,Wake Forest,24,31,142,35,25,354,1,2,H,1,3,14,28,-6,-7,-126,0,-2,2009
359,359,09/26/2009,Bowling Green,14,33,93,42,21,189,2,1,Boise State,49,35,267,25,19,262,0,0,H,-17,-35,-2,-174,17,2,-73,2,1,2009
360,360,09/26/2009,Brigham Young,42,34,132,29,18,243,2,0,Colorado State,23,28,66,50,30,372,2,0,H,19.5,19,6,66,-21,-12,-129,0,0,2009
361,361,09/26/2009,Buffalo,13,28,86,38,24,269,4,1,Temple,37,42,185,20,8,83,1,-1,V,-3.5,-24,-14,-99,18,16,186,3,2,2009
362,362,09/26/2009,California,3,32,77,36,13,130,0,2,Oregon,42,52,236,32,25,288,0,3,V,5.5,-39,-20,-159,4,-12,-158,0,-1,2009
363,363,09/26/2009,Central Michigan,48,53,326,31,23,197,1,0,Akron,21,37,69,19,12,127,0,1,H,15,27,16,257,12,11,70,1,-1,2009
364,364,09/26/2009,Cincinnati,28,16,57,26,18,300,0,0,Fresno State,20,57,290,27,16,153,1,0,H,17,8,-41,-233,-1,2,147,-1,0,2009
365,365,09/26/2009,Clemson,10,32,117,37,17,192,0,0,Texas Christian,14,40,162,26,17,226,0,0,H,2.5,-4,-8,-45,11,0,-34,0,0,2009
366,366,09/26/2009,Colorado State,23,28,66,50,30,372,2,0,Brigham Young,42,34,132,29,18,241,2,0,V,-19.5,-19,-6,-66,21,12,131,0,0,2009
367,367,09/26/2009,Connecticut,52,42,199,30,23,289,0,3,Rhode Island,10,32,29,23,14,119,2,1,H, ,42,10,170,7,9,170,-2,2,2009
368,368,09/26/2009,Duke,49,41,233,37,25,254,1,0,No Carolina Central,14,28,70,19,8,111,0,1,H, ,35,13,163,18,17,143,1,-1,2009
369,369,09/26/2009,East Carolina,19,38,110,41,27,293,1,2,U-C-F,14,24,70,34,21,266,4,1,H,8.5,5,14,40,7,6,27,-3,1,2009
370,370,09/26/2009,Florida,41,52,362,16,9,133,0,1,Kentucky,7,32,86,31,14,93,2,0,V,20,34,20,276,-15,-5,40,-2,1,2009
371,371,09/26/2009,Florida Atlantic,25,33,151,51,30,347,0,1,UL-Monroe,27,40,157,25,18,207,0,1,H,3.5,-2,-7,-6,26,12,140,0,0,2009
372,372,09/26/2009,Florida Intl,31,42,148,43,19,224,0,2,Toledo,41,34,223,32,18,343,1,0,H,1,-10,8,-75,11,1,-119,-1,2,2009
373,373,09/26/2009,Florida State,7,27,19,37,25,269,0,4,South Florida,17,42,153,21,8,217,2,0,H,14,-10,-15,-134,16,17,52,-2,4,2009
374,374,09/26/2009,Fresno State,20,57,290,27,16,153,1,0,Cincinnati,28,16,57,26,18,300,0,0,V,-17,-8,41,233,1,-2,-147,1,0,2009
375,375,09/26/2009,Georgia,20,31,92,31,17,242,2,1,Arizona State,17,28,88,32,10,116,1,0,H,13.5,3,3,4,-1,7,126,1,1,2009
376,376,09/26/2009,Georgia Tech,24,69,317,11,7,89,0,0,North Carolina,7,18,17,26,11,137,2,1,H,3,17,51,300,-15,-4,-48,-2,-1,2009
377,377,09/26/2009,Houston,29,36,144,58,38,435,1,0,Texas Tech,28,32,163,47,30,321,0,2,H,-2.5,1,4,-19,11,8,114,1,-2,2009
378,378,09/26/2009,Idaho,34,41,212,23,18,270,0,0,Northern Illinois,31,30,128,24,17,184,0,0,V,-14.5,3,11,84,-1,1,86,0,0,2009
379,379,09/26/2009,Illinois,0,34,82,29,15,88,3,0,Ohio State,30,46,236,13,8,82,0,2,V,-14,-30,-12,-154,16,7,6,3,-2,2009
380,380,09/26/2009,Indiana,33,33,197,38,21,270,1,0,Michigan,36,50,149,24,13,223,1,1,V,-18,-3,-17,48,14,8,47,0,-1,2009
381,381,09/26/2009,Iowa,21,37,163,26,11,135,2,0,Penn State,10,33,109,32,12,198,3,1,V,-9.5,11,4,54,-6,-1,-63,-1,-1,2009
382,382,09/26/2009,Iowa State,31,43,201,20,11,175,0,0,Army,10,48,186,26,11,130,1,0,H,10,21,-5,15,-6,0,45,-1,0,2009
383,383,09/26/2009,Kansas,35,45,102,42,30,331,1,1,Southern Miss,28,26,64,42,28,331,1,1,H,11.5,7,19,38,0,2,0,0,0,2009
384,384,09/26/2009,Kansas State,49,60,296,11,10,152,0,0,Tennessee Tech,7,25,-19,19,12,126,1,0,H, ,42,35,315,-8,-2,26,-1,0,2009
385,385,09/26/2009,Kent State,29,41,173,11,5,77,0,0,Miami-Ohio,19,38,215,53,31,337,2,3,H,7,10,3,-42,-42,-26,-260,-2,-3,2009
386,386,09/26/2009,Kentucky,7,32,86,31,14,93,2,0,Florida,41,52,362,16,9,133,0,1,H,-20,-34,-20,-276,15,5,-40,2,-1,2009
387,387,09/26/2009,Louisiana State,30,31,30,28,15,233,0,0,Mississippi State,26,46,151,40,17,223,3,1,V,12,4,-15,-121,-12,-2,10,-3,-1,2009
388,388,09/26/2009,Louisville,14,35,80,33,15,181,1,2,Utah,30,42,214,22,17,202,1,0,V,-14,-16,-7,-134,11,-2,-21,0,2,2009
389,389,09/26/2009,Marshall,27,41,243,19,11,124,0,1,Memphis,16,27,119,35,17,232,2,0,V,-3,11,14,124,-16,-6,-108,-2,1,2009
390,390,09/26/2009,Maryland,13,24,28,38,21,271,3,2,Rutgers,34,49,207,13,4,42,0,0,H,1,-21,-25,-179,25,17,229,3,2,2009
391,391,09/26/2009,Memphis,16,27,119,35,17,232,2,0,Marshall,27,41,243,19,11,124,0,1,H,3,-11,-14,-124,16,6,108,2,-1,2009
392,392,09/26/2009,Miami-Florida,7,34,59,25,9,150,1,1,Virginia Tech,31,55,272,9,4,98,0,1,V,2.5,-24,-21,-213,16,5,52,1,0,2009
393,393,09/26/2009,Miami-Ohio,19,38,215,53,31,337,2,3,Kent State,29,41,173,11,5,77,0,0,V,-7,-10,-3,42,42,26,260,2,3,2009
394,394,09/26/2009,Michigan,36,50,149,24,13,223,1,1,Indiana,33,33,197,38,21,270,1,0,H,18,3,17,-48,-14,-8,-47,0,1,2009
395,395,09/26/2009,Michigan State,30,22,90,46,24,396,3,1,Wisconsin,38,50,193,31,19,243,0,1,V,-1.5,-8,-28,-103,15,5,153,3,0,2009
396,396,09/26/2009,Middle Tennessee,37,45,187,43,21,269,0,0,North Texas,21,25,157,54,35,313,3,2,V,6,16,20,30,-11,-14,-44,-3,-2,2009
397,397,09/26/2009,Minnesota,35,42,166,26,15,186,1,0,Northwestern,24,29,64,47,32,309,1,2,V,1,11,13,102,-21,-17,-123,0,-2,2009
398,398,09/26/2009,Mississippi State,26,46,151,40,17,223,3,1,Louisiana State,30,31,30,28,15,233,0,0,H,-12,-4,15,121,12,2,-10,3,1,2009
399,399,09/26/2009,Navy,38,64,373,5,4,100,0,1,Western Kentucky,22,33,158,29,22,276,2,1,H,30.5,16,31,215,-24,-18,-176,-2,0,2009
400,400,09/26/2009,Nebraska,55,34,133,26,22,300,0,0,UL-Lafayette,0,37,102,27,15,120,1,2,H,30,55,-3,31,-1,7,180,-1,-2,2009
401,401,09/26/2009,Nevada-Las Vegas,27,32,126,45,26,260,2,2,Wyoming,30,32,109,39,25,248,0,0,V,3.5,-3,0,17,6,1,12,2,2,2009
402,402,09/26/2009,New Mexico,17,25,150,28,16,206,1,0,New Mexico State,20,56,122,24,14,96,1,1,H,11.5,-3,-31,28,4,2,110,0,-1,2009
403,403,09/26/2009,New Mexico State,20,56,122,24,14,96,1,1,New Mexico,17,25,150,28,16,206,1,0,V,-11.5,3,31,-28,-4,-2,-110,0,1,2009
404,404,09/26/2009,No Carolina State,38,46,208,35,21,322,0,1,Pittsburgh,31,23,94,23,12,206,0,0,H,-2,7,23,114,12,9,116,0,1,2009
405,405,09/26/2009,North Carolina,7,18,17,26,11,137,2,1,Georgia Tech,24,69,317,11,7,89,0,0,V,-3,-17,-51,-300,15,4,48,2,1,2009
406,406,09/26/2009,North Texas,21,25,157,54,35,313,3,2,Middle Tennessee,37,45,187,43,21,269,0,0,H,-6,-16,-20,-30,11,14,44,3,2,2009
407,407,09/26/2009,Northern Illinois,31,30,128,24,17,184,0,0,Idaho,34,41,212,23,18,270,0,0,H,14.5,-3,-11,-84,1,-1,-86,0,0,2009
408,408,09/26/2009,Northwestern,24,29,64,47,32,309,1,2,Minnesota,35,42,166,26,15,186,1,0,H,-1,-11,-13,-102,21,17,123,0,2,2009
409,409,09/26/2009,Notre Dame,24,43,167,36,20,216,1,0,Purdue,21,26,74,38,22,289,1,1,V,6.5,3,17,93,-2,-2,-73,0,-1,2009
410,410,09/26/2009,Ohio,23,17,21,52,30,319,1,1,Tennessee,34,39,177,34,17,222,1,1,V,-22,-11,-22,-156,18,13,97,0,0,2009
411,411,09/26/2009,Ohio State,30,46,236,13,8,82,0,2,Illinois,0,34,82,29,15,88,3,0,H,14,30,12,154,-16,-7,-6,-3,2,2009
412,412,09/26/2009,Oklahoma State,56,43,321,23,17,266,2,2,Grambling,6,42,156,26,11,104,1,1,H, ,50,1,165,-3,6,162,1,1,2009
413,413,09/26/2009,Oregon,42,52,236,32,25,288,0,3,California,3,32,77,36,13,130,0,2,H,-5.5,39,20,159,-4,12,158,0,1,2009
414,414,09/26/2009,Oregon State,32,30,104,49,31,303,2,0,Arizona,37,33,134,34,25,254,0,0,H,3,-5,-3,-30,15,6,49,2,0,2009
415,415,09/26/2009,Penn State,10,33,109,32,12,198,3,1,Iowa,21,37,163,26,11,135,2,0,H,9.5,-11,-4,-54,6,1,63,1,1,2009
416,416,09/26/2009,Pittsburgh,31,23,94,23,12,206,0,0,No Carolina State,38,46,208,35,21,322,0,1,V,2,-7,-23,-114,-12,-9,-116,0,-1,2009
417,417,09/26/2009,Purdue,21,26,74,38,22,289,1,1,Notre Dame,24,43,167,36,20,216,1,0,H,-6.5,-3,-17,-93,2,2,73,0,1,2009
418,418,09/26/2009,Rice,17,40,160,32,12,122,4,0,Vanderbilt,36,43,216,41,23,268,1,0,H,-7.5,-19,-3,-56,-9,-11,-146,3,0,2009
419,419,09/26/2009,Rutgers,34,49,207,13,4,42,0,0,Maryland,13,24,28,38,21,271,3,2,V,-1,21,25,179,-25,-17,-229,-3,-2,2009
420,420,09/26/2009,San Diego State,14,25,39,41,25,284,4,2,Air Force,26,58,243,7,3,51,0,0,V,-17.5,-12,-33,-204,34,22,233,4,2,2009
421,421,09/26/2009,San Jose State,19,31,242,32,18,172,1,0,Cal-San Luis Obispo,9,43,179,26,10,135,1,1,H, ,10,-12,63,6,8,37,0,-1,2009
422,422,09/26/2009,South Florida,17,42,153,21,8,215,2,0,Florida State,7,27,19,37,25,269,0,4,V,-14,10,15,134,-16,-17,-54,2,-4,2009
423,423,09/26/2009,Southern Cal,27,29,156,22,13,247,0,2,Washington State,6,46,85,31,16,144,1,2,H,45,21,-17,71,-9,-3,103,-1,0,2009
424,424,09/26/2009,Southern Miss,28,26,64,42,28,331,1,1,Kansas,35,45,102,42,30,331,1,1,V,-11.5,-7,-19,-38,0,-2,0,0,0,2009
425,425,09/26/2009,Stanford,34,50,321,14,7,103,0,2,Washington,14,28,99,31,16,191,2,1,H,9,20,22,222,-17,-9,-88,-2,1,2009
426,426,09/26/2009,Syracuse,41,31,115,28,21,270,0,1,Maine,24,28,90,36,25,340,2,0,H, ,17,3,25,-8,-4,-70,-2,1,2009
427,427,09/26/2009,Temple,37,40,198,17,6,95,1,0,Buffalo,13,30,99,41,26,281,4,1,H,3.5,24,10,99,-24,-20,-186,-3,-1,2009
428,428,09/26/2009,Tennessee,34,39,177,34,17,222,1,1,Ohio,23,17,21,52,30,319,1,1,H,22,11,22,156,-18,-13,-97,0,0,2009
429,429,09/26/2009,Texas,64,42,304,41,33,335,1,2,UTEP,7,25,9,26,9,44,4,1,H,37,57,17,295,15,24,291,-3,1,2009
430,430,09/26/2009,Texas A+M,56,51,236,31,25,308,0,1,U-A-B,19,35,229,25,9,74,0,0,H,14.5,37,16,7,6,16,234,0,1,2009
431,431,09/26/2009,Texas Christian,14,40,162,26,17,226,0,0,Clemson,10,32,117,37,17,192,0,0,V,-2.5,4,8,45,-11,0,34,0,0,2009
432,432,09/26/2009,Texas Tech,28,32,163,47,30,321,0,2,Houston,29,36,144,58,38,435,1,0,V,2.5,-1,-4,19,-11,-8,-114,-1,2,2009
433,433,09/26/2009,Toledo,41,34,223,32,18,343,1,0,Florida Intl,31,42,148,43,19,224,0,2,V,-1,10,-8,75,-11,-1,119,1,-2,2009
434,434,09/26/2009,Troy,30,37,134,49,34,373,0,3,Arkansas State,27,25,70,27,15,235,0,3,V,-3,3,12,64,22,19,138,0,0,2009
435,435,09/26/2009,Tulane,42,39,205,13,10,222,2,0,McNeese State,32,48,252,25,16,221,0,2,H, ,10,-9,-47,-12,-6,1,2,-2,2009
436,436,09/26/2009,Tulsa,56,44,238,19,14,278,0,1,Sam Houston State,3,42,141,21,8,100,0,2,H, ,53,2,97,-2,6,178,0,-1,2009
437,437,09/26/2009,U-A-B,19,35,229,25,9,74,0,0,Texas A+M,56,51,236,31,25,308,0,1,V,-14.5,-37,-16,-7,-6,-16,-234,0,-1,2009
438,438,09/26/2009,U-C-F,14,26,57,37,23,254,4,0,East Carolina,19,36,97,38,25,281,1,2,V,-8.5,-5,-10,-40,-1,-2,-27,3,-2,2009
439,439,09/26/2009,UL-Lafayette,0,37,102,27,15,120,1,2,Nebraska,55,34,133,26,22,300,0,0,V,-30,-55,3,-31,1,-7,-180,1,2,2009
440,440,09/26/2009,UL-Monroe,27,40,157,25,18,207,0,1,Florida Atlantic,25,34,140,50,30,347,0,1,V,-3.5,2,6,17,-25,-12,-140,0,0,2009
441,441,09/26/2009,UTEP,7,25,9,26,9,44,4,1,Texas,64,42,304,41,33,335,1,2,V,-37,-57,-17,-295,-15,-24,-291,3,-1,2009
442,442,09/26/2009,Utah,30,42,214,22,17,202,1,0,Louisville,14,35,80,33,15,181,1,2,H,14,16,7,134,-11,2,21,0,-2,2009
443,443,09/26/2009,Utah State,53,44,259,22,16,345,0,3,Southern Utah,34,31,105,53,26,262,2,1,H, ,19,13,154,-31,-10,83,-2,2,2009
444,444,09/26/2009,Vanderbilt,36,43,216,41,23,268,1,0,Rice,17,40,160,32,12,122,4,0,V,7.5,19,3,56,9,11,146,-3,0,2009
445,445,09/26/2009,Virginia Tech,31,55,272,9,4,98,0,1,Miami-Florida,7,34,59,25,9,150,1,1,H,-2.5,24,21,213,-16,-5,-52,-1,0,2009
446,446,09/26/2009,Wake Forest,24,31,142,35,25,354,1,2,Boston College,27,45,170,29,18,228,1,0,V,-1,-3,-14,-28,6,7,126,0,2,2009
447,447,09/26/2009,Washington,14,28,99,31,16,191,2,1,Stanford,34,50,321,14,7,103,0,2,V,-9,-20,-22,-222,17,9,88,2,-1,2009
448,448,09/26/2009,Washington State,6,46,85,31,16,144,1,2,Southern Cal,27,29,156,22,13,247,0,2,V,-45,-21,17,-71,9,3,-103,1,0,2009
449,449,09/26/2009,Western Kentucky,22,33,158,29,22,276,2,1,Navy,38,64,373,5,4,100,0,1,V,-30.5,-16,-31,-215,24,18,176,2,0,2009
450,450,09/26/2009,Western Michigan,24,32,133,43,34,338,1,2,Hofstra,10,35,140,30,18,189,0,2,H, ,14,-3,-7,13,16,149,1,0,2009
451,451,09/26/2009,Wisconsin,38,50,193,31,19,243,0,1,Michigan State,30,22,90,46,24,396,3,1,H,1.5,8,28,103,-15,-5,-153,-3,0,2009
452,452,09/26/2009,Wyoming,30,32,109,39,25,248,0,0,Nevada-Las Vegas,27,32,126,45,26,260,2,2,H,-3.5,3,0,-17,-6,-1,-12,-2,-2,2009
453,453,09/30/2009,Hawaii,6,16,-7,45,25,308,2,1,Louisiana Tech,27,57,352,22,13,97,0,0,V,-6,-21,-41,-359,23,12,211,2,1,2009
454,454,09/30/2009,Louisiana Tech,27,57,352,22,13,97,0,0,Hawaii,6,16,-7,45,25,308,2,1,H,6,21,41,359,-23,-12,-211,-2,-1,2009
455,455,10/01/2009,Colorado,24,30,100,54,27,292,3,0,West Virginia,35,42,257,19,12,148,0,4,V,-16.5,-11,-12,-157,35,15,144,3,-4,2009
456,456,10/01/2009,Southern Miss,17,29,111,35,25,234,1,2,U-A-B,30,47,222,13,6,23,0,0,V,10.5,-13,-18,-111,22,19,211,1,2,2009
457,457,10/01/2009,U-A-B,30,47,222,13,6,23,0,0,Southern Miss,17,29,111,35,25,234,1,2,H,-10.5,13,18,111,-22,-19,-211,-1,-2,2009
458,458,10/01/2009,West Virginia,35,42,257,19,12,148,0,4,Colorado,24,30,100,54,27,292,3,0,H,16.5,11,12,157,-35,-15,-144,-3,4,2009
459,459,10/02/2009,Brigham Young,35,43,213,23,16,218,2,1,Utah State,17,37,109,31,21,213,0,1,H,24,18,6,104,-8,-5,5,2,0,2009
460,460,10/02/2009,Louisville,10,37,101,31,19,204,0,1,Pittsburgh,35,38,162,23,16,242,0,1,H,-7,-25,-1,-61,8,3,-38,0,0,2009
461,461,10/02/2009,Pittsburgh,35,38,162,23,16,242,0,1,Louisville,10,37,101,31,19,204,0,1,V,7,25,1,61,-8,-3,38,0,0,2009
462,462,10/02/2009,Utah State,17,37,109,30,20,213,0,1,Brigham Young,35,43,213,23,16,218,2,1,V,-24,-18,-6,-104,7,4,-5,-2,0,2009
463,463,10/03/2009,Air Force,13,53,183,14,6,57,1,1,Navy,16,56,173,4,3,36,1,1,V,-3,-3,-3,10,10,3,21,0,0,2009
464,464,10/03/2009,Alabama,38,42,204,26,15,148,0,0,Kentucky,20,38,133,32,17,168,3,1,V,16.5,18,4,71,-6,-2,-20,-3,-1,2009
465,465,10/03/2009,Arizona State,17,31,68,58,32,338,1,1,Oregon State,28,24,79,30,18,216,1,0,H,5.5,-11,7,-11,28,14,122,0,1,2009
466,466,10/03/2009,Arkansas,47,31,163,27,17,271,1,2,Texas A+M,19,35,113,58,30,345,0,2,N,2,28,-4,50,-31,-13,-74,1,0,2009
467,467,10/03/2009,Arkansas State,21,25,80,40,22,216,1,1,Iowa,24,33,124,27,18,296,2,0,V,-21,-3,-8,-44,13,4,-80,-1,1,2009
468,468,10/03/2009,Army,16,56,196,5,3,26,1,0,Tulane,17,32,128,23,13,164,0,1,H,6,-1,24,68,-18,-10,-138,1,-1,2009
469,469,10/03/2009,Auburn,26,48,224,35,20,235,0,0,Tennessee,22,29,151,44,20,259,0,1,V,-2.5,4,19,73,-9,0,-24,0,-1,2009
470,470,10/03/2009,Ball State,30,38,76,41,25,234,1,0,Toledo,37,24,57,38,30,422,1,2,H,-5.5,-7,14,19,3,-5,-188,0,-2,2009
471,471,10/03/2009,Baylor,31,45,158,27,20,216,0,1,Kent State,15,25,165,46,25,259,2,1,H,23,16,20,-7,-19,-5,-43,-2,0,2009
472,472,10/03/2009,Boise State,34,33,101,31,22,285,1,0,UC-Davis,16,17,28,36,24,206,0,0,H, ,18,16,73,-5,-2,79,1,0,2009
473,473,10/03/2009,Boston College,28,39,196,21,12,203,0,2,Florida State,21,29,70,42,29,341,0,1,H,-4,7,10,126,-21,-17,-138,0,1,2009
474,474,10/03/2009,Bowling Green,37,33,84,53,28,390,0,1,Ohio,44,35,216,19,11,203,0,1,H,2.5,-7,-2,-132,34,17,187,0,0,2009
475,475,10/03/2009,Buffalo,13,39,236,35,18,222,1,0,Central Michigan,20,33,157,25,20,280,1,2,H,-10,-7,6,79,10,-2,-58,0,-2,2009
476,476,10/03/2009,California,3,25,86,40,15,199,1,1,Southern Cal,30,42,174,35,20,283,1,0,H,-4.5,-27,-17,-88,5,-5,-84,0,1,2009
477,477,10/03/2009,Central Michigan,20,35,144,28,22,268,1,1,Buffalo,13,37,223,32,16,210,1,0,V,10,7,-2,-79,-4,6,58,0,1,2009
478,478,10/03/2009,Cincinnati,37,19,164,42,23,270,1,0,Miami-Ohio,13,35,30,47,33,286,2,0,V,29.5,24,-16,134,-5,-10,-16,-1,0,2009
479,479,10/03/2009,Clemson,21,30,81,40,22,193,1,2,Maryland,24,45,69,26,19,215,0,2,V,12.5,-3,-15,12,14,3,-22,1,0,2009
480,480,10/03/2009,Colorado State,29,32,139,36,20,297,1,0,Idaho,31,33,70,38,25,333,1,0,V,4.5,-2,-1,69,-2,-5,-36,0,0,2009
481,481,10/03/2009,Duke,26,31,38,40,22,359,0,0,Virginia Tech,34,39,150,22,17,327,0,1,H,-17,-8,-8,-112,18,5,32,0,-1,2009
482,482,10/03/2009,East Carolina,21,35,155,23,14,131,1,0,Marshall,17,38,179,32,16,127,2,0,V,2,4,-3,-24,-9,-2,4,-1,0,2009
483,483,10/03/2009,Eastern Michigan,12,29,50,37,25,230,1,1,Temple,24,44,242,18,9,123,0,1,H,-6.5,-12,-15,-192,19,16,107,1,0,2009
484,484,10/03/2009,Florida Atlantic,28,29,104,30,19,261,0,1,Wyoming,30,46,198,38,29,223,1,1,H,5,-2,-17,-94,-8,-10,38,-1,0,2009
485,485,10/03/2009,Florida Intl,35,27,77,46,28,314,2,0,UL-Monroe,48,53,304,36,19,273,2,1,V,-6.5,-13,-26,-227,10,9,41,0,-1,2009
486,486,10/03/2009,Florida State,21,29,70,42,29,341,0,1,Boston College,28,39,196,21,12,203,0,2,V,4,-7,-10,-126,21,17,138,0,-1,2009
487,487,10/03/2009,Georgia,13,24,45,34,18,229,1,0,Louisiana State,20,45,156,27,18,212,1,0,H,3.5,-7,-21,-111,7,0,17,0,0,2009
488,488,10/03/2009,Georgia Tech,42,54,213,14,11,266,0,1,Mississippi State,31,38,209,30,20,278,1,4,V,5.5,11,16,4,-16,-9,-12,-1,-3,2009
489,489,10/03/2009,Houston,41,27,128,76,51,536,0,2,UTEP,58,41,305,30,19,276,0,0,V,14.5,-17,-14,-177,46,32,260,0,2,2009
490,490,10/03/2009,Idaho,31,33,70,38,25,333,1,0,Colorado State,29,32,139,35,19,297,1,0,H,-4.5,2,1,-69,3,6,36,0,0,2009
491,491,10/03/2009,Illinois,17,35,130,37,20,263,1,1,Penn State,35,40,338,25,17,175,0,1,H,-7.5,-18,-5,-208,12,3,88,1,0,2009
492,492,10/03/2009,Indiana,14,26,18,34,20,210,2,1,Ohio State,33,47,219,27,16,159,1,1,H,-18,-19,-21,-201,7,4,51,1,0,2009
493,493,10/03/2009,Iowa,24,33,124,27,18,296,2,0,Arkansas State,21,25,80,40,22,216,1,1,H,21,3,8,44,-13,-4,80,1,-1,2009
494,494,10/03/2009,Iowa State,23,42,209,26,12,162,0,2,Kansas State,24,42,154,23,16,206,1,1,N,2.5,-1,0,55,3,-4,-44,-1,1,2009
495,495,10/03/2009,Kansas State,24,42,154,23,16,206,1,1,Iowa State,23,41,207,27,13,164,0,2,N,-2.5,1,1,-53,-4,3,42,1,-1,2009
496,496,10/03/2009,Kent State,15,25,165,46,25,259,2,1,Baylor,31,45,158,27,20,216,0,1,V,-23,-16,-20,7,19,5,43,2,0,2009
497,497,10/03/2009,Kentucky,20,38,133,32,17,168,3,1,Alabama,38,42,204,26,15,148,0,0,H,-16.5,-18,-4,-71,6,2,20,3,1,2009
498,498,10/03/2009,Louisiana State,20,45,156,27,18,212,1,0,Georgia,13,24,45,34,18,229,1,0,V,-3.5,7,21,111,-7,0,-17,0,0,2009
499,499,10/03/2009,Marshall,17,38,179,32,16,127,2,0,East Carolina,21,35,155,23,14,131,1,0,H,-2,-4,3,24,9,2,-4,1,0,2009
500,500,10/03/2009,Maryland,24,45,69,26,19,215,0,2,Clemson,21,30,81,40,22,193,1,2,H,-12.5,3,15,-12,-14,-3,22,-1,0,2009
501,501,10/03/2009,Memphis,14,26,67,31,16,258,2,0,U-C-F,32,50,261,28,16,214,1,0,V,-7,-18,-24,-194,3,0,44,1,0,2009
502,502,10/03/2009,Miami-Florida,21,32,140,28,19,202,2,0,Oklahoma,20,42,153,30,18,188,0,1,H,-7.5,1,-10,-13,-2,1,14,2,-1,2009
503,503,10/03/2009,Miami-Ohio,13,35,30,47,33,286,2,0,Cincinnati,37,19,164,42,23,270,1,0,H,-29.5,-24,16,-134,5,10,16,1,0,2009
504,504,10/03/2009,Michigan,20,28,28,32,17,223,1,1,Michigan State,26,49,197,29,20,220,2,1,V,-4,-6,-21,-169,3,-3,3,-1,0,2009
505,505,10/03/2009,Michigan State,26,49,197,29,20,220,2,1,Michigan,20,28,28,32,17,223,1,1,H,4,6,21,169,-3,3,-3,1,0,2009
506,506,10/03/2009,Minnesota,28,28,57,30,16,271,1,2,Wisconsin,31,49,295,26,16,159,1,2,H,2.5,-3,-21,-238,4,0,112,0,0,2009
507,507,10/03/2009,Mississippi,23,43,160,34,19,237,3,0,Vanderbilt,7,38,171,27,10,69,1,0,V,10,16,5,-11,7,9,168,2,0,2009
508,508,10/03/2009,Mississippi State,31,38,209,30,20,278,1,4,Georgia Tech,42,54,213,14,11,266,0,1,H,-5.5,-11,-16,-4,16,9,12,1,3,2009
509,509,10/03/2009,Navy,16,56,173,4,3,36,1,1,Air Force,13,53,183,14,6,57,1,1,H,3,3,3,-10,-10,-3,-21,0,0,2009
510,510,10/03/2009,Nevada-Las Vegas,28,27,70,50,26,276,0,1,Nevada-Reno,63,55,559,19,16,214,0,4,V,-7,-35,-28,-489,31,10,62,0,-3,2009
511,511,10/03/2009,Nevada-Reno,63,55,559,19,16,214,0,4,Nevada-Las Vegas,28,27,70,50,26,276,0,1,H,7,35,28,489,-31,-10,-62,0,3,2009
512,512,10/03/2009,New Mexico,28,35,115,56,30,316,0,2,Texas Tech,48,23,34,46,29,453,3,2,V,-35,-20,12,81,10,1,-137,-3,0,2009
513,513,10/03/2009,New Mexico State,17,47,88,26,15,146,2,2,San Diego State,34,31,108,28,8,144,1,0,V,-17.5,-17,16,-20,-2,7,2,1,2,2009
514,514,10/03/2009,No Carolina State,24,26,104,43,20,275,2,1,Wake Forest,30,35,30,45,31,361,2,1,V,-3,-6,-9,74,-2,-11,-86,0,0,2009
515,515,10/03/2009,North Carolina,3,23,39,36,20,135,2,1,Virginia,16,43,106,27,16,148,0,0,H,12.5,-13,-20,-67,9,4,-13,2,1,2009
516,516,10/03/2009,Northern Illinois,38,50,255,15,9,135,0,0,Western Michigan,3,23,73,37,19,178,3,1,H,6.5,35,27,182,-22,-10,-43,-3,-1,2009
517,517,10/03/2009,Northwestern,27,43,87,45,28,224,0,1,Purdue,21,28,62,29,20,313,1,5,V,-7,6,15,25,16,8,-89,-1,-4,2009
518,518,10/03/2009,Notre Dame,37,29,108,31,23,422,1,1,Washington,30,39,176,39,22,281,0,1,H,11,7,-10,-68,-8,1,141,1,0,2009
519,519,10/03/2009,Ohio,44,35,216,19,11,203,0,1,Bowling Green,37,33,84,53,28,390,0,1,V,-2.5,7,2,132,-34,-17,-187,0,0,2009
520,520,10/03/2009,Ohio State,33,47,219,27,16,159,1,1,Indiana,14,26,18,34,20,210,2,1,V,18,19,21,201,-7,-4,-51,-1,0,2009
521,521,10/03/2009,Oklahoma,20,42,153,30,18,188,0,1,Miami-Florida,21,32,140,28,19,202,2,0,V,7.5,-1,10,13,2,-1,-14,-2,1,2009
522,522,10/03/2009,Oregon,52,59,318,27,21,196,0,1,Washington State,6,32,107,15,8,51,2,1,H,35,46,27,211,12,13,145,-2,0,2009
523,523,10/03/2009,Oregon State,28,24,79,30,18,216,1,0,Arizona State,17,31,68,58,32,338,1,1,V,-5.5,11,-7,11,-28,-14,-122,0,-1,2009
524,524,10/03/2009,Penn State,35,40,338,25,17,175,0,1,Illinois,17,35,130,37,20,263,1,1,V,7.5,18,5,208,-12,-3,-88,-1,0,2009
525,525,10/03/2009,Purdue,21,28,62,29,20,313,1,5,Northwestern,27,43,87,45,28,224,0,1,H,7,-6,-15,-25,-16,-8,89,1,4,2009
526,526,10/03/2009,Rice,10,30,47,43,17,144,1,0,Tulsa,27,45,134,32,21,251,0,1,H,-17.5,-17,-15,-87,11,-4,-107,1,-1,2009
527,527,10/03/2009,S-M-U,14,18,-16,38,17,240,2,1,Texas Christian,39,53,229,20,12,189,1,2,V,-28,-25,-35,-245,18,5,51,1,-1,2009
528,528,10/03/2009,San Diego State,34,31,108,28,8,144,1,0,New Mexico State,17,47,88,26,15,146,2,2,H,17.5,17,-16,20,2,-7,-2,-1,-2,2009
529,529,10/03/2009,South Carolina,38,35,213,24,16,164,0,1,So Carolina State,14,41,170,25,15,156,1,0,H, ,24,-6,43,-1,1,8,-1,1,2009
530,530,10/03/2009,South Florida,34,37,125,20,12,208,0,3,Syracuse,20,30,75,46,25,269,5,2,V,7.5,14,7,50,-26,-13,-61,-5,1,2009
531,531,10/03/2009,Southern Cal,30,42,174,35,20,283,1,0,California,3,25,86,40,15,199,1,1,V,4.5,27,17,88,-5,5,84,0,-1,2009
532,532,10/03/2009,Stanford,24,44,174,20,14,198,0,1,U.C.L.A.,16,26,95,34,22,204,0,0,H,4.5,8,18,79,-14,-8,-6,0,1,2009
533,533,10/03/2009,Syracuse,20,30,75,46,25,269,5,2,South Florida,34,37,125,20,12,208,0,3,H,-7.5,-14,-7,-50,26,13,61,5,-1,2009
534,534,10/03/2009,Temple,24,44,242,18,9,123,0,1,Eastern Michigan,12,29,50,37,25,230,1,1,V,6.5,12,15,192,-19,-16,-107,-1,0,2009
535,535,10/03/2009,Tennessee,22,29,151,44,20,259,0,1,Auburn,26,48,224,35,20,235,0,0,H,2.5,-4,-19,-73,9,0,24,0,1,2009
536,536,10/03/2009,Texas A+M,19,35,113,58,30,345,0,2,Arkansas,47,31,163,27,17,271,1,2,N,-2,-28,4,-50,31,13,74,-1,0,2009
537,537,10/03/2009,Texas Christian,39,53,229,20,12,189,1,2,S-M-U,14,18,-16,38,17,240,2,1,H,28,25,35,245,-18,-5,-51,-1,1,2009
538,538,10/03/2009,Texas Tech,48,23,34,46,29,453,3,2,New Mexico,28,35,115,56,30,316,0,2,H,35,20,-12,-81,-10,-1,137,3,0,2009
539,539,10/03/2009,Toledo,37,24,57,38,30,422,1,2,Ball State,30,38,76,41,25,234,1,0,V,5.5,7,-14,-19,-3,5,188,0,2,2009
540,540,10/03/2009,Tulane,17,31,126,24,14,166,0,1,Army,16,56,196,5,3,26,1,0,V,-6,1,-25,-70,19,11,140,-1,1,2009
541,541,10/03/2009,Tulsa,27,45,134,32,21,251,0,1,Rice,10,30,47,43,17,144,1,0,V,17.5,17,15,87,-11,4,107,-1,1,2009
542,542,10/03/2009,U-C-F,32,48,274,25,14,226,1,1,Memphis,14,28,80,34,18,270,2,0,H,7,18,20,194,-9,-4,-44,-1,1,2009
543,543,10/03/2009,U.C.L.A.,16,26,95,34,22,204,0,0,Stanford,24,44,174,20,14,198,0,1,V,-4.5,-8,-18,-79,14,8,6,0,-1,2009
544,544,10/03/2009,UL-Monroe,48,53,304,36,19,273,2,1,Florida Intl,35,28,68,45,28,314,2,0,H,6.5,13,25,236,-9,-9,-41,0,1,2009
545,545,10/03/2009,UTEP,58,41,305,30,19,276,0,0,Houston,41,27,128,76,51,536,0,2,H,-14.5,17,14,177,-46,-32,-260,0,-2,2009
546,546,10/03/2009,Vanderbilt,7,38,171,27,10,69,1,0,Mississippi,23,43,160,34,19,237,3,0,H,-10,-16,-5,11,-7,-9,-168,-2,0,2009
547,547,10/03/2009,Virginia,16,43,106,27,16,148,0,0,North Carolina,3,23,39,36,20,135,2,1,V,-12.5,13,20,67,-9,-4,13,-2,-1,2009
548,548,10/03/2009,Virginia Tech,34,39,150,22,17,327,0,1,Duke,26,31,38,40,22,359,0,0,V,17,8,8,112,-18,-5,-32,0,1,2009
549,549,10/03/2009,Wake Forest,30,35,30,45,31,361,2,1,No Carolina State,24,26,104,43,20,275,2,1,H,3,6,9,-74,2,11,86,0,0,2009
550,550,10/03/2009,Washington,30,39,176,39,22,281,0,1,Notre Dame,37,29,108,31,23,422,1,1,V,-11,-7,10,68,8,-1,-141,-1,0,2009
551,551,10/03/2009,Washington State,6,32,107,15,8,51,2,1,Oregon,52,59,318,27,21,196,0,1,V,-35,-46,-27,-211,-12,-13,-145,2,0,2009
552,552,10/03/2009,Western Michigan,3,22,104,37,19,178,3,1,Northern Illinois,38,50,255,15,9,135,0,0,V,-6.5,-35,-28,-151,22,10,43,3,1,2009
553,553,10/03/2009,Wisconsin,31,49,295,26,16,159,1,2,Minnesota,28,28,57,30,16,271,1,2,V,-2.5,3,21,238,-4,0,-112,0,0,2009
554,554,10/03/2009,Wyoming,30,46,198,38,29,223,1,1,Florida Atlantic,28,28,113,31,19,261,0,1,V,-5,2,18,85,7,10,-38,1,0,2009
555,555,10/06/2009,Middle Tennessee,7,28,109,44,24,245,0,1,Troy,31,49,264,30,18,191,0,1,V,-6.5,-24,-21,-155,14,6,54,0,0,2009
556,556,10/06/2009,Troy,31,49,264,30,18,191,0,1,Middle Tennessee,7,28,109,44,24,245,0,1,H,6.5,24,21,155,-14,-6,-54,0,0,2009
557,557,10/08/2009,Missouri,12,35,91,43,17,134,2,1,Nebraska,27,33,105,33,14,158,0,2,H,-3.5,-15,2,-14,10,3,-24,2,-1,2009
558,558,10/08/2009,Nebraska,27,33,105,33,14,158,0,2,Missouri,12,35,91,43,17,134,2,1,V,3.5,15,-2,14,-10,-3,24,-2,1,2009
559,559,10/09/2009,Louisiana Tech,14,32,127,17,8,129,1,0,Nevada-Reno,37,51,345,22,15,166,0,0,V,-11,-23,-19,-218,-5,-7,-37,1,0,2009
560,560,10/09/2009,Nevada-Reno,37,51,345,22,15,166,0,0,Louisiana Tech,14,32,127,17,8,129,1,0,H,11,23,19,218,5,7,37,-1,0,2009
561,561,10/10/2009,Air Force,17,45,229,18,7,58,0,0,Texas Christian,20,52,195,28,16,198,1,2,H,-10,-3,-7,34,-10,-9,-140,-1,-2,2009
562,562,10/10/2009,Akron,7,34,159,42,19,187,2,3,Ohio,19,41,160,21,11,132,1,1,H,-3.5,-12,-7,-1,21,8,55,1,2,2009
563,563,10/10/2009,Alabama,22,41,200,35,16,154,0,1,Mississippi,3,23,72,34,11,140,4,1,V,4,19,18,128,1,5,14,-4,0,2009
564,564,10/10/2009,Arizona,33,30,77,53,39,384,2,0,Washington,36,24,116,23,12,140,1,0,V,4,-3,6,-39,30,27,244,1,0,2009
565,565,10/10/2009,Arizona State,27,37,220,33,22,190,3,3,Washington State,14,32,-54,34,17,235,2,2,V,20.5,13,5,274,-1,5,-45,1,1,2009
566,566,10/10/2009,Arkansas,44,45,221,37,24,274,1,0,Auburn,23,35,242,29,15,133,0,3,H,-2,21,10,-21,8,9,141,1,-3,2009
567,567,10/10/2009,Army,16,57,222,16,7,47,0,1,Vanderbilt,13,37,154,24,11,144,2,1,H,-10,3,20,68,-8,-4,-97,-2,0,2009
568,568,10/10/2009,Auburn,23,35,242,29,15,133,0,3,Arkansas,44,45,221,37,24,274,1,0,V,2,-21,-10,21,-8,-9,-141,-1,3,2009
569,569,10/10/2009,Ball State,19,23,53,37,22,237,2,3,Temple,24,50,106,30,17,186,0,1,V,-14.5,-5,-27,-53,7,5,51,2,2,2009
570,570,10/10/2009,Baylor,7,17,6,43,23,262,2,0,Oklahoma,33,50,197,49,27,389,0,0,V,-27.5,-26,-33,-191,-6,-4,-127,2,0,2009
571,571,10/10/2009,Boston College,14,28,37,29,12,126,2,1,Virginia Tech,48,51,236,12,8,205,0,1,V,-13.5,-34,-23,-199,17,4,-79,2,0,2009
572,572,10/10/2009,Bowling Green,36,29,43,64,44,505,1,0,Kent State,35,31,202,21,10,141,0,1,V,1.5,1,-2,-159,43,34,364,1,-1,2009
573,573,10/10/2009,Brigham Young,59,43,291,27,21,320,0,0,Nevada-Las Vegas,21,19,45,41,25,292,3,0,V,17,38,24,246,-14,-4,28,-3,0,2009
574,574,10/10/2009,Buffalo,40,47,250,26,19,258,0,0,Gardner-Webb,3,25,51,31,17,164,0,1,H, ,37,22,199,-5,2,94,0,-1,2009
575,575,10/10/2009,Central Michigan,56,39,203,22,16,318,0,0,Eastern Michigan,8,34,128,32,17,127,0,0,H,24,48,5,75,-10,-1,191,0,0,2009
576,576,10/10/2009,Colorado,14,34,42,23,9,85,2,0,Texas,38,25,46,40,33,267,1,1,V,-33.5,-24,9,-4,-17,-24,-182,1,-1,2009
577,577,10/10/2009,Colorado State,17,31,150,24,12,184,3,0,Utah,24,40,209,32,24,248,1,1,H,-9,-7,-9,-59,-8,-12,-64,2,-1,2009
578,578,10/10/2009,Connecticut,21,31,106,23,17,197,0,1,Pittsburgh,24,40,221,31,21,268,2,0,V,-6.5,-3,-9,-115,-8,-4,-71,-2,1,2009
579,579,10/10/2009,Duke,49,35,43,50,40,459,0,1,No Carolina State,28,23,142,30,16,196,2,2,V,-15,21,12,-99,20,24,263,-2,-1,2009
580,580,10/10/2009,East Carolina,21,44,176,34,20,181,1,1,S-M-U,28,21,28,29,17,266,0,1,V,4.5,-7,23,148,5,3,-85,1,0,2009
581,581,10/10/2009,Eastern Michigan,8,34,128,32,17,127,0,0,Central Michigan,56,39,203,22,16,318,0,0,V,-24,-48,-5,-75,10,1,-191,0,0,2009
582,582,10/10/2009,Florida,13,48,193,16,11,134,1,0,Louisiana State,3,30,66,17,11,96,1,0,V,10,10,18,127,-1,0,38,0,0,2009
583,583,10/10/2009,Florida Intl,37,49,206,22,14,280,0,1,Western Kentucky,20,43,263,26,16,118,1,1,V,6,17,6,-57,-4,-2,162,-1,0,2009
584,584,10/10/2009,Florida State,44,30,181,36,26,358,0,2,Georgia Tech,49,56,393,9,5,139,0,3,H,3,-5,-26,-212,27,21,219,0,-1,2009
585,585,10/10/2009,Fresno State,42,47,277,17,14,135,0,2,Hawaii,17,18,85,52,24,283,2,1,V,11,25,29,192,-35,-10,-148,-2,1,2009
586,586,10/10/2009,Georgia,19,22,89,40,20,152,2,1,Tennessee,45,37,162,27,20,310,1,0,V,1.5,-26,-15,-73,13,0,-158,1,1,2009
587,587,10/10/2009,Georgia Tech,49,57,401,8,4,131,0,3,Florida State,44,30,180,36,26,359,0,2,V,-3,5,27,221,-28,-22,-228,0,1,2009
588,588,10/10/2009,Hawaii,17,18,85,52,24,283,2,1,Fresno State,42,47,277,17,14,155,0,2,H,-11,-25,-29,-192,35,10,128,2,-1,2009
589,589,10/10/2009,Houston,31,25,119,52,39,434,2,0,Mississippi State,24,51,330,25,15,160,2,2,V,-2.5,7,-26,-211,27,24,274,0,-2,2009
590,590,10/10/2009,Idaho,29,42,274,27,15,227,3,1,San Jose State,25,21,45,43,31,302,2,1,V,-6,4,21,229,-16,-16,-75,1,0,2009
591,591,10/10/2009,Illinois,14,32,132,28,9,140,1,0,Michigan State,24,45,193,25,13,179,1,1,H,-4,-10,-13,-61,3,-4,-39,0,-1,2009
592,592,10/10/2009,Indiana,7,29,82,36,23,190,1,1,Virginia,47,44,224,32,22,312,0,0,V,-7,-40,-15,-142,4,1,-122,1,1,2009
593,593,10/10/2009,Iowa,30,34,83,38,20,284,1,0,Michigan,28,45,195,23,11,124,2,3,H,8,2,-11,-112,15,9,160,-1,-3,2009
594,594,10/10/2009,Iowa State,36,43,219,41,25,293,0,0,Kansas,41,31,109,49,37,442,1,0,V,-20,-5,12,110,-8,-12,-149,-1,0,2009
595,595,10/10/2009,Kansas,41,31,109,49,37,442,1,0,Iowa State,36,43,219,41,25,293,0,0,H,20,5,-12,-110,8,12,149,1,0,2009
596,596,10/10/2009,Kansas State,14,28,116,24,16,168,0,2,Texas Tech,66,26,185,49,39,554,1,0,V,-16.5,-52,2,-69,-25,-23,-386,-1,2,2009
597,597,10/10/2009,Kent State,35,31,202,21,10,141,0,1,Bowling Green,36,29,43,64,44,505,1,0,H,-1.5,-1,2,159,-43,-34,-364,-1,1,2009
598,598,10/10/2009,Kentucky,26,47,205,22,11,155,0,0,South Carolina,28,33,128,23,16,233,1,1,V,-9.5,-2,14,77,-1,-5,-78,-1,-1,2009
599,599,10/10/2009,Louisiana State,3,30,66,17,11,96,1,0,Florida,13,48,193,16,11,134,1,0,H,-10,-10,-18,-127,1,0,-38,0,0,2009
600,600,10/10/2009,Louisville,25,29,180,27,15,259,1,0,Southern Miss,23,42,181,31,22,229,0,0,H,-2.5,2,-13,-1,-4,-7,30,1,0,2009
601,601,10/10/2009,Marshall,31,27,116,24,18,207,1,0,Tulane,10,39,189,41,23,215,2,2,V,3.5,21,-12,-73,-17,-5,-8,-1,-2,2009
602,602,10/10/2009,Maryland,32,30,62,44,24,307,1,0,Wake Forest,42,39,156,33,24,360,0,0,V,-13.5,-10,-9,-94,11,0,-53,1,0,2009
603,603,10/10/2009,Memphis,35,50,255,32,19,216,1,0,UTEP,20,27,123,40,21,319,2,1,H,-1.5,15,23,132,-8,-2,-103,-1,-1,2009
604,604,10/10/2009,Miami-Florida,48,38,215,27,19,255,2,0,Florida A+M,16,35,118,25,10,144,1,0,H, ,32,3,97,2,9,111,1,0,2009
605,605,10/10/2009,Miami-Ohio,6,42,126,37,17,176,3,1,Northwestern,16,41,128,31,15,191,1,0,V,-17,-10,1,-2,6,2,-15,2,1,2009
606,606,10/10/2009,Michigan,28,45,195,23,11,124,2,3,Iowa,30,34,83,38,20,284,1,0,V,-8,-2,11,112,-15,-9,-160,1,3,2009
607,607,10/10/2009,Michigan State,24,45,193,25,13,179,1,1,Illinois,14,32,132,28,9,140,1,0,V,4,10,13,61,-3,4,39,0,1,2009
608,608,10/10/2009,Minnesota,35,44,207,10,5,74,2,0,Purdue,20,30,103,47,25,299,2,1,H,3.5,15,14,104,-37,-20,-225,0,-1,2009
609,609,10/10/2009,Mississippi,3,23,72,34,11,140,4,1,Alabama,22,42,185,34,16,154,0,1,H,-4,-19,-19,-113,0,-5,-14,4,0,2009
610,610,10/10/2009,Mississippi State,24,51,330,25,15,160,2,2,Houston,31,25,119,52,39,434,2,0,H,2.5,-7,26,211,-27,-24,-274,0,2,2009
611,611,10/10/2009,Navy,63,80,471,3,2,66,0,0,Rice,14,16,21,38,21,251,2,0,V,10,49,64,450,-35,-19,-185,-2,0,2009
612,612,10/10/2009,Nevada-Las Vegas,21,19,45,41,25,292,3,0,Brigham Young,59,43,291,27,21,320,0,0,H,-17,-38,-24,-246,14,4,-28,3,0,2009
613,613,10/10/2009,New Mexico,13,32,47,40,26,252,2,0,Wyoming,37,43,179,31,15,232,0,0,V,-10,-24,-11,-132,9,11,20,2,0,2009
614,614,10/10/2009,New Mexico State,20,41,149,25,8,81,1,0,Utah State,17,45,258,26,16,171,0,1,H,-10.5,3,-4,-109,-1,-8,-90,1,-1,2009
615,615,10/10/2009,No Carolina State,28,23,142,30,16,196,2,2,Duke,49,35,43,50,40,459,0,1,H,15,-21,-12,99,-20,-24,-263,2,1,2009
616,616,10/10/2009,North Carolina,42,50,164,24,16,125,1,2,Georgia Southern,12,33,95,32,16,75,4,2,H, ,30,17,69,-8,0,50,-3,0,2009
617,617,10/10/2009,North Texas,34,43,235,38,24,209,3,1,UL-Lafayette,38,38,173,29,13,122,0,1,V,-5,-4,5,62,9,11,87,3,0,2009
618,618,10/10/2009,Northwestern,16,41,128,31,15,191,1,0,Miami-Ohio,6,42,126,37,17,176,3,1,H,17,10,-1,2,-6,-2,15,-2,-1,2009
619,619,10/10/2009,Ohio,19,41,160,21,11,132,1,1,Akron,7,34,159,42,19,187,2,3,V,3.5,12,7,1,-21,-8,-55,-1,-2,2009
620,620,10/10/2009,Ohio State,31,26,90,14,6,94,1,0,Wisconsin,13,44,118,45,27,250,2,0,H,14,18,-18,-28,-31,-21,-156,-1,0,2009
621,621,10/10/2009,Oklahoma,33,50,197,49,27,389,0,0,Baylor,7,17,6,43,23,262,2,0,H,27.5,26,33,191,6,4,127,-2,0,2009
622,622,10/10/2009,Oklahoma State,36,48,169,25,14,279,1,0,Texas A+M,31,41,109,42,22,273,0,1,V,5.5,5,7,60,-17,-8,6,1,-1,2009
623,623,10/10/2009,Oregon,24,43,221,17,9,82,1,0,U.C.L.A.,10,33,66,35,18,145,2,1,V,3,14,10,155,-18,-9,-63,-1,-1,2009
624,624,10/10/2009,Oregon State,38,43,173,32,22,290,0,0,Stanford,28,31,149,30,12,226,0,0,H,-2,10,12,24,2,10,64,0,0,2009
625,625,10/10/2009,Penn State,52,36,285,26,17,268,1,0,Eastern Illinois,3,32,59,31,15,147,1,1,H, ,49,4,226,-5,2,121,0,-1,2009
626,626,10/10/2009,Pittsburgh,24,40,221,31,21,268,2,0,Connecticut,21,31,106,23,17,197,0,1,H,6.5,3,9,115,8,4,71,2,-1,2009
627,627,10/10/2009,Purdue,20,30,103,47,25,299,2,1,Minnesota,35,44,207,10,5,74,2,0,V,-3.5,-15,-14,-104,37,20,225,0,1,2009
628,628,10/10/2009,Rice,14,16,21,38,21,251,2,0,Navy,63,80,471,3,2,66,0,0,H,-10,-49,-64,-450,35,19,185,2,0,2009
629,629,10/10/2009,Rutgers,42,42,253,22,15,164,0,0,Texas Southern,0,24,-25,27,13,151,2,2,H, ,42,18,278,-5,2,13,-2,-2,2009
630,630,10/10/2009,S-M-U,28,21,28,29,17,266,0,1,East Carolina,21,44,176,34,20,181,1,1,H,-4.5,7,-23,-148,-5,-3,85,-1,0,2009
631,631,10/10/2009,San Jose State,25,21,45,43,31,302,2,1,Idaho,29,42,274,27,15,227,3,1,H,6,-4,-21,-229,16,16,75,-1,0,2009
632,632,10/10/2009,South Carolina,28,33,128,23,16,233,1,1,Kentucky,26,47,205,22,11,155,0,0,H,9.5,2,-14,-77,1,5,78,1,1,2009
633,633,10/10/2009,Southern Miss,23,42,181,31,22,229,0,0,Louisville,25,29,180,27,15,259,1,0,V,2.5,-2,13,1,4,7,-30,-1,0,2009
634,634,10/10/2009,Stanford,28,31,149,30,12,226,0,0,Oregon State,38,43,173,32,22,290,0,0,V,2,-10,-12,-24,-2,-10,-64,0,0,2009
635,635,10/10/2009,Syracuse,13,24,72,25,12,150,1,1,West Virginia,34,40,127,34,25,258,0,1,H,-10.5,-21,-16,-55,-9,-13,-108,1,0,2009
636,636,10/10/2009,Temple,24,50,106,30,17,186,0,1,Ball State,19,23,53,37,22,237,2,3,H,14.5,5,27,53,-7,-5,-51,-2,-2,2009
637,637,10/10/2009,Tennessee,45,37,162,27,20,310,1,0,Georgia,19,22,89,40,20,152,2,1,H,-1.5,26,15,73,-13,0,158,-1,-1,2009
638,638,10/10/2009,Texas,38,25,46,40,33,267,1,1,Colorado,14,34,42,23,9,85,2,0,H,33.5,24,-9,4,17,24,182,-1,1,2009
639,639,10/10/2009,Texas A+M,31,41,109,42,22,273,0,1,Oklahoma State,36,48,169,25,14,279,1,0,H,-5.5,-5,-7,-60,17,8,-6,-1,1,2009
640,640,10/10/2009,Texas Christian,20,52,195,28,16,198,1,2,Air Force,17,45,229,18,7,58,0,0,V,10,3,7,-34,10,9,140,1,2,2009
641,641,10/10/2009,Texas Tech,66,26,185,49,39,554,1,0,Kansas State,14,28,116,24,16,168,0,2,H,16.5,52,-2,69,25,23,386,1,-2,2009
642,642,10/10/2009,Toledo,26,45,209,44,23,240,0,1,Western Michigan,58,31,252,27,17,282,0,1,H,7.5,-32,14,-43,17,6,-42,0,0,2009
643,643,10/10/2009,Tulane,10,39,183,41,23,215,2,2,Marshall,31,27,116,24,18,207,1,0,H,-3.5,-21,12,67,17,5,8,1,2,2009
644,644,10/10/2009,U.C.L.A.,10,33,66,35,18,145,2,1,Oregon,24,43,221,17,9,82,1,0,H,-3,-14,-10,-155,18,9,63,1,1,2009
645,645,10/10/2009,UL-Lafayette,38,38,173,29,13,122,0,1,North Texas,34,43,235,38,24,209,3,1,H,5,4,-5,-62,-9,-11,-87,-3,0,2009
646,646,10/10/2009,UTEP,20,27,123,40,21,319,2,1,Memphis,35,49,270,33,19,216,1,0,V,1.5,-15,-22,-147,7,2,103,1,1,2009
647,647,10/10/2009,Utah,24,40,209,32,24,248,1,1,Colorado State,17,31,150,24,12,184,3,0,V,9,7,9,59,8,12,64,-2,1,2009
648,648,10/10/2009,Utah State,17,45,258,26,16,171,0,1,New Mexico State,20,41,149,25,8,81,1,0,V,10.5,-3,4,109,1,8,90,-1,1,2009
649,649,10/10/2009,Vanderbilt,13,37,160,24,11,144,2,1,Army,16,57,222,16,7,47,0,1,V,10,-3,-20,-62,8,4,97,2,0,2009
650,650,10/10/2009,Virginia,47,45,231,31,21,305,0,0,Indiana,7,29,82,36,23,190,1,1,H,7,40,16,149,-5,-2,115,-1,-1,2009
651,651,10/10/2009,Virginia Tech,48,51,235,12,8,206,0,1,Boston College,14,29,45,28,11,118,2,1,H,13.5,34,22,190,-16,-3,88,-2,0,2009
652,652,10/10/2009,Wake Forest,42,39,156,33,24,360,0,0,Maryland,32,30,62,44,24,307,1,0,H,13.5,10,9,94,-11,0,53,-1,0,2009
653,653,10/10/2009,Washington,36,24,116,23,12,140,1,0,Arizona,33,30,77,53,39,384,2,0,H,-4,3,-6,39,-30,-27,-244,-1,0,2009
654,654,10/10/2009,Washington State,14,32,-54,34,17,255,2,2,Arizona State,27,37,220,33,22,190,3,3,H,-20.5,-13,-5,-274,1,-5,65,-1,-1,2009
655,655,10/10/2009,West Virginia,34,40,127,34,25,258,0,1,Syracuse,13,24,72,25,12,150,1,1,V,10.5,21,16,55,9,13,108,-1,0,2009
656,656,10/10/2009,Western Kentucky,20,43,263,26,16,118,1,1,Florida Intl,37,49,206,22,14,280,0,1,H,-6,-17,-6,57,4,2,-162,1,0,2009
657,657,10/10/2009,Western Michigan,58,31,252,27,17,282,0,1,Toledo,26,45,209,44,23,240,0,1,V,-7.5,32,-14,43,-17,-6,42,0,0,2009
658,658,10/10/2009,Wisconsin,13,44,118,45,27,250,2,0,Ohio State,31,27,97,13,5,87,1,0,V,-14,-18,17,21,32,22,163,1,0,2009
659,659,10/10/2009,Wyoming,37,43,179,31,15,232,0,0,New Mexico,13,32,47,40,26,252,2,0,H,10,24,11,132,-9,-11,-20,-2,0,2009
660,660,10/13/2009,Arkansas State,10,34,29,39,20,234,2,1,UL-Monroe,16,41,124,17,8,150,1,0,V,-2.5,-6,-7,-95,22,12,84,1,1,2009
661,661,10/13/2009,UL-Monroe,16,41,124,17,8,150,1,0,Arkansas State,10,34,29,39,20,234,2,1,H,2.5,6,7,95,-22,-12,-84,-1,-1,2009
662,662,10/14/2009,Boise State,28,44,193,32,22,187,0,2,Tulsa,21,26,88,28,15,207,0,0,V,9,7,18,105,4,7,-20,0,2,2009
663,663,10/14/2009,Tulsa,21,26,88,28,15,207,0,0,Boise State,28,44,193,32,22,187,0,2,H,-9,-7,-18,-105,-4,-7,20,0,-2,2009
664,664,10/15/2009,Cincinnati,34,37,189,32,16,212,1,0,South Florida,17,36,168,34,15,208,2,0,V,1.5,17,1,21,-2,1,4,-1,0,2009
665,665,10/15/2009,South Florida,17,36,168,34,15,208,2,0,Cincinnati,34,37,189,32,16,212,1,0,H,-1.5,-17,-1,-21,2,-1,-4,1,0,2009
666,666,10/16/2009,Pittsburgh,24,46,223,24,16,153,0,2,Rutgers,17,20,38,41,23,248,1,1,V,6.5,7,26,185,-17,-7,-95,-1,1,2009
667,667,10/16/2009,Rutgers,17,20,38,41,23,248,1,1,Pittsburgh,24,46,223,24,16,153,0,2,H,-6.5,-7,-26,-185,17,7,95,1,-1,2009
668,668,10/17/2009,Air Force,10,69,267,5,1,2,0,0,Wyoming,0,35,100,31,14,74,1,0,H,11,10,34,167,-26,-13,-72,-1,0,2009
669,669,10/17/2009,Akron,17,30,134,34,17,200,2,1,Buffalo,21,37,107,35,20,205,2,0,V,-8,-4,-7,27,-1,-3,-5,0,1,2009
670,670,10/17/2009,Alabama,20,38,264,20,10,92,2,2,South Carolina,6,28,49,46,20,214,1,1,H,18,14,10,215,-26,-10,-122,1,1,2009
671,671,10/17/2009,Arizona,43,14,138,52,40,415,0,2,Stanford,38,40,150,36,22,434,1,1,H,4,5,-26,-12,16,18,-19,-1,1,2009
672,672,10/17/2009,Arizona State,24,27,169,36,22,295,0,1,Washington,17,27,99,38,22,279,2,1,H,6.5,7,0,70,-2,0,16,-2,0,2009
673,673,10/17/2009,Arkansas,20,34,133,27,12,224,0,0,Florida,23,46,136,27,17,255,0,4,V,-24.5,-3,-12,-3,0,-5,-31,0,-4,2009
674,674,10/17/2009,Army,13,48,181,8,6,75,0,1,Temple,27,38,80,17,8,115,1,0,V,-10.5,-14,10,101,-9,-2,-40,-1,1,2009
675,675,10/17/2009,Auburn,14,49,220,25,11,95,1,0,Kentucky,21,49,282,22,9,75,0,0,H,13.5,-7,0,-62,3,2,20,1,0,2009
676,676,10/17/2009,Ball State,17,42,273,30,10,131,1,0,Bowling Green,31,24,79,41,28,376,0,0,H,-3,-14,18,194,-11,-18,-245,1,0,2009
677,677,10/17/2009,Baylor,10,21,89,46,26,275,3,0,Iowa State,24,46,240,36,25,214,1,0,V,-1.5,-14,-25,-151,10,1,61,2,0,2009
678,678,10/17/2009,Boston College,52,43,293,25,13,187,0,0,No Carolina State,20,27,79,55,31,315,2,1,H,2.5,32,16,214,-30,-18,-128,-2,-1,2009
679,679,10/17/2009,Bowling Green,31,24,79,41,28,376,0,0,Ball State,17,42,273,30,10,131,1,0,V,3,14,-18,-194,11,18,245,-1,0,2009
680,680,10/17/2009,Brigham Young,38,52,166,39,27,346,0,0,San Diego State,28,16,20,34,22,322,1,0,V,17,10,36,146,5,5,24,-1,0,2009
681,681,10/17/2009,Buffalo,21,37,107,35,20,205,2,0,Akron,17,30,134,34,17,200,2,1,H,8,4,7,-27,1,3,5,0,-1,2009
682,682,10/17/2009,California,45,41,289,23,14,205,0,0,U.C.L.A.,26,26,137,42,21,311,1,1,V,3.5,19,15,152,-19,-7,-106,-1,-1,2009
683,683,10/17/2009,Central Michigan,34,32,188,30,18,238,0,1,Western Michigan,23,26,87,66,40,410,1,0,V,7,11,6,101,-36,-22,-172,-1,1,2009
684,684,10/17/2009,Clemson,38,33,195,24,15,187,0,2,Wake Forest,3,44,81,26,12,97,2,0,H,7.5,35,-11,114,-2,3,90,-2,2,2009
685,685,10/17/2009,Colorado,34,43,147,25,14,175,1,2,Kansas,30,22,-8,54,32,431,1,1,H,-9.5,4,21,155,-29,-18,-256,0,1,2009
686,686,10/17/2009,Colorado State,6,35,70,20,10,112,0,1,Texas Christian,44,46,275,24,16,224,0,1,V,-22.5,-38,-11,-205,-4,-6,-112,0,0,2009
687,687,10/17/2009,Connecticut,38,42,208,21,14,273,1,0,Louisville,25,47,162,31,24,295,2,2,H,13,13,-5,46,-10,-10,-22,-1,-2,2009
688,688,10/17/2009,East Carolina,49,43,173,30,22,286,2,1,Rice,13,26,78,50,29,263,2,1,H,18.5,36,17,95,-20,-7,23,0,0,2009
689,689,10/17/2009,Eastern Michigan,6,44,183,19,10,75,1,1,Kent State,28,41,152,25,11,195,2,0,H,-6.5,-22,3,31,-6,-1,-120,-1,1,2009
690,690,10/17/2009,Florida,23,46,136,27,17,255,0,4,Arkansas,20,34,133,27,12,224,0,0,H,24.5,3,12,3,0,5,31,0,4,2009
691,691,10/17/2009,Florida Atlantic,44,40,220,40,21,308,0,0,North Texas,40,36,270,24,17,246,0,2,V,1,4,4,-50,16,4,62,0,-2,2009
692,692,10/17/2009,Florida Intl,33,36,38,50,28,265,1,0,Troy,42,39,174,38,28,391,0,3,H,-8.5,-9,-3,-136,12,0,-126,1,-3,2009
693,693,10/17/2009,Fresno State,41,43,302,17,10,124,0,1,San Jose State,21,31,124,35,20,221,1,0,H,20,20,12,178,-18,-10,-97,-1,1,2009
694,694,10/17/2009,Georgia,34,37,173,31,16,226,1,0,Vanderbilt,10,36,122,34,17,174,1,0,V,7.5,24,1,51,-3,-1,52,0,0,2009
695,695,10/17/2009,Georgia Tech,28,63,309,7,1,51,1,1,Virginia Tech,23,31,175,14,10,159,2,0,H,-3.5,5,32,134,-7,-9,-108,-1,1,2009
696,696,10/17/2009,Hawaii,23,24,77,45,31,367,1,1,Idaho,35,39,194,17,14,226,0,1,V,-8,-12,-15,-117,28,17,141,1,0,2009
697,697,10/17/2009,Houston,44,36,182,43,30,334,0,0,Tulane,16,43,187,34,22,250,1,0,V,17,28,-7,-5,9,8,84,-1,0,2009
698,698,10/17/2009,Idaho,35,39,194,17,14,226,0,1,Hawaii,23,24,77,45,31,367,1,1,H,8,12,15,117,-28,-17,-141,-1,0,2009
699,699,10/17/2009,Illinois,14,41,185,37,22,258,0,3,Indiana,27,31,149,40,23,333,0,1,V,3,-13,10,36,-3,-1,-75,0,2,2009
700,700,10/17/2009,Indiana,27,31,149,40,23,333,0,1,Illinois,14,41,185,37,22,258,0,3,H,-3,13,-10,-36,3,1,75,0,-2,2009
701,701,10/17/2009,Iowa,20,39,65,23,17,218,0,1,Wisconsin,10,33,87,25,15,143,3,0,V,-2,10,6,-22,-2,2,75,-3,1,2009
702,702,10/17/2009,Iowa State,24,46,240,36,25,214,1,0,Baylor,10,21,89,46,26,275,3,0,H,1.5,14,25,151,-10,-1,-61,-2,0,2009
703,703,10/17/2009,Kansas,30,22,-8,54,32,431,1,1,Colorado,34,43,147,25,14,175,1,2,V,9.5,-4,-21,-155,29,18,256,0,-1,2009
704,704,10/17/2009,Kansas State,62,52,232,19,15,192,0,0,Texas A+M,14,23,-13,45,21,314,3,2,H,-6,48,29,245,-26,-6,-122,-3,-2,2009
705,705,10/17/2009,Kent State,28,41,152,25,11,195,2,0,Eastern Michigan,6,44,183,19,10,75,1,1,V,6.5,22,-3,-31,6,1,120,1,-1,2009
706,706,10/17/2009,Kentucky,21,49,282,22,9,75,0,0,Auburn,14,49,220,25,11,95,1,0,V,-13.5,7,0,62,-3,-2,-20,-1,0,2009
707,707,10/17/2009,Louisiana Tech,45,56,315,24,14,225,0,1,New Mexico State,7,25,74,20,13,68,2,1,H,20.5,38,31,241,4,1,157,-2,0,2009
708,708,10/17/2009,Louisville,25,47,162,31,24,295,2,2,Connecticut,38,42,208,21,14,273,1,0,V,-13,-13,5,-46,10,10,22,1,2,2009
709,709,10/17/2009,Marshall,7,34,58,35,17,149,2,2,West Virginia,24,31,147,23,16,166,0,2,V,-20.5,-17,3,-89,12,1,-17,2,0,2009
710,710,10/17/2009,Maryland,9,33,126,38,16,158,2,2,Virginia,20,38,63,26,14,138,0,1,H,-3.5,-11,-5,63,12,2,20,2,1,2009
711,711,10/17/2009,Memphis,16,35,170,42,26,255,2,0,Southern Miss,36,46,205,21,10,155,1,0,V,-16,-20,-11,-35,21,16,100,1,0,2009
712,712,10/17/2009,Miami-Florida,27,46,70,27,20,293,0,0,U-C-F,7,24,53,31,13,176,1,0,V,13.5,20,22,17,-4,7,117,-1,0,2009
713,713,10/17/2009,Miami-Ohio,7,30,52,30,19,166,2,2,Ohio,28,33,226,32,16,172,1,0,V,-14,-21,-3,-174,-2,3,-6,1,2,2009
714,714,10/17/2009,Michigan,63,54,461,18,15,266,0,1,Delaware State,6,26,65,34,18,151,0,0,H, ,57,28,396,-16,-3,115,0,1,2009
715,715,10/17/2009,Michigan State,24,34,94,31,21,281,0,1,Northwestern,14,29,79,47,34,291,0,2,H,14,10,5,15,-16,-13,-10,0,-1,2009
716,716,10/17/2009,Middle Tennessee,6,25,42,39,19,206,4,0,Mississippi State,27,50,178,20,14,155,0,0,H,-5,-21,-25,-136,19,5,51,4,0,2009
717,717,10/17/2009,Minnesota,0,18,37,22,10,101,1,0,Penn State,20,43,177,32,21,287,0,0,V,-17,-20,-25,-140,-10,-11,-186,1,0,2009
718,718,10/17/2009,Mississippi,48,34,148,31,21,338,0,0,U-A-B,13,40,230,21,12,121,1,0,H,22,35,-6,-82,10,9,217,-1,0,2009
719,719,10/17/2009,Mississippi State,27,50,178,20,14,155,0,0,Middle Tennessee,6,25,42,39,19,206,4,0,V,5,21,25,136,-19,-5,-51,-4,0,2009
720,720,10/17/2009,Missouri,17,24,68,44,22,325,3,1,Oklahoma State,33,35,124,36,22,227,0,0,V,-7,-16,-11,-56,8,0,98,3,1,2009
721,721,10/17/2009,Navy,38,60,331,9,4,68,0,1,S-M-U,35,27,176,41,19,200,0,0,V,6.5,3,33,155,-32,-15,-132,0,1,2009
722,722,10/17/2009,Nebraska,10,30,70,38,23,215,1,1,Texas Tech,31,25,25,32,23,234,0,0,H,10.5,-21,5,45,6,0,-19,1,1,2009
723,723,10/17/2009,Nevada-Las Vegas,15,33,91,47,25,236,2,0,Utah,35,31,153,24,17,174,0,2,H,-16.5,-20,2,-62,23,8,62,2,-2,2009
724,724,10/17/2009,Nevada-Reno,35,46,313,24,10,189,1,1,Utah State,32,34,74,42,25,353,0,1,V,7.5,3,12,239,-18,-15,-164,1,0,2009
725,725,10/17/2009,New Mexico State,7,25,74,20,13,68,2,1,Louisiana Tech,45,56,315,24,14,225,0,1,V,-20.5,-38,-31,-241,-4,-1,-157,2,0,2009
726,726,10/17/2009,No Carolina State,20,27,79,55,31,315,2,1,Boston College,52,43,293,25,13,187,0,0,V,-2.5,-32,-16,-214,30,18,128,2,1,2009
727,727,10/17/2009,North Texas,40,36,270,24,17,246,0,2,Florida Atlantic,44,40,220,40,21,308,0,0,H,-1,-4,-4,50,-16,-4,-62,0,2,2009
728,728,10/17/2009,Northern Illinois,19,37,164,26,15,157,1,0,Toledo,20,34,157,26,19,230,1,2,V,7,-1,3,7,0,-4,-73,0,-2,2009
729,729,10/17/2009,Northwestern,14,29,79,47,34,291,0,2,Michigan State,24,34,94,31,21,281,0,1,V,-14,-10,-5,-15,16,13,10,0,1,2009
730,730,10/17/2009,Notre Dame,27,31,82,44,25,285,0,0,Southern Cal,34,33,121,29,19,380,1,0,H,-10,-7,-2,-39,15,6,-95,-1,0,2009
731,731,10/17/2009,Ohio,28,33,226,32,16,172,1,0,Miami-Ohio,7,30,52,30,19,166,2,2,H,14,21,3,174,2,-3,6,-1,-2,2009
732,732,10/17/2009,Ohio State,18,28,66,31,17,221,2,3,Purdue,26,31,80,52,31,281,2,1,V,13.5,-8,-3,-14,-21,-14,-60,0,2,2009
733,733,10/17/2009,Oklahoma,13,22,-16,49,26,327,2,3,Texas,16,40,142,40,21,127,1,2,N,-3,-3,-18,-158,9,5,200,1,1,2009
734,734,10/17/2009,Oklahoma State,33,35,124,36,22,227,0,0,Missouri,17,24,68,44,22,325,3,1,H,7,16,11,56,-8,0,-98,-3,-1,2009
735,735,10/17/2009,Penn State,20,43,177,32,21,287,0,0,Minnesota,0,18,37,22,10,101,1,0,H,17,20,25,140,10,11,186,-1,0,2009
736,736,10/17/2009,Purdue,26,31,80,52,31,281,2,1,Ohio State,18,28,66,31,17,221,2,3,H,-13.5,8,3,14,21,14,60,0,-2,2009
737,737,10/17/2009,Rice,13,26,78,50,29,263,2,1,East Carolina,49,43,173,30,22,286,2,1,V,-18.5,-36,-17,-95,20,7,-23,0,0,2009
738,738,10/17/2009,S-M-U,35,27,176,41,19,200,0,0,Navy,38,60,331,9,4,68,0,1,H,-6.5,-3,-33,-155,32,15,132,0,-1,2009
739,739,10/17/2009,San Diego State,28,16,20,34,22,322,1,0,Brigham Young,38,52,166,39,27,346,0,0,H,-17,-10,-36,-146,-5,-5,-24,1,0,2009
740,740,10/17/2009,San Jose State,21,31,124,35,20,221,1,0,Fresno State,41,43,302,17,10,124,0,1,V,-20,-20,-12,-178,18,10,97,1,-1,2009
741,741,10/17/2009,South Carolina,6,27,64,46,20,214,1,1,Alabama,20,38,264,20,10,92,2,2,V,-18,-14,-11,-200,26,10,122,-1,-1,2009
742,742,10/17/2009,Southern Cal,34,33,121,29,19,380,1,0,Notre Dame,27,31,82,44,25,285,0,0,V,10,7,2,39,-15,-6,95,1,0,2009
743,743,10/17/2009,Southern Miss,36,46,205,21,10,155,1,0,Memphis,16,35,170,42,26,255,2,0,H,16,20,11,35,-21,-16,-100,-1,0,2009
744,744,10/17/2009,Stanford,38,40,150,36,22,434,1,1,Arizona,43,14,138,52,40,415,0,2,V,-4,-5,26,12,-16,-18,19,1,-1,2009
745,745,10/17/2009,Temple,27,38,80,17,8,115,1,0,Army,13,48,181,8,6,75,0,1,H,10.5,14,-10,-101,9,2,40,1,-1,2009
746,746,10/17/2009,Texas,16,40,142,40,21,127,1,2,Oklahoma,13,22,-16,49,26,327,2,3,N,3,3,18,158,-9,-5,-200,-1,-1,2009
747,747,10/17/2009,Texas A+M,14,23,-13,45,21,314,3,2,Kansas State,62,52,232,19,15,192,0,0,V,6,-48,-29,-245,26,6,122,3,2,2009
748,748,10/17/2009,Texas Christian,44,46,275,24,16,224,0,1,Colorado State,6,35,70,20,10,112,0,1,H,22.5,38,11,205,4,6,112,0,0,2009
749,749,10/17/2009,Texas Tech,31,25,25,32,23,234,0,0,Nebraska,10,30,70,38,23,215,1,1,V,-10.5,21,-5,-45,-6,0,19,-1,-1,2009
750,750,10/17/2009,Toledo,20,34,157,26,19,230,1,2,Northern Illinois,19,37,164,26,15,157,1,0,H,-7,1,-3,-7,0,4,73,0,2,2009
751,751,10/17/2009,Troy,42,39,174,38,28,391,0,3,Florida Intl,33,36,38,50,28,265,1,0,V,8.5,9,3,136,-12,0,126,-1,3,2009
752,752,10/17/2009,Tulane,16,43,187,34,22,250,1,0,Houston,44,36,182,43,30,334,0,0,H,-17,-28,7,5,-9,-8,-84,1,0,2009
753,753,10/17/2009,U-A-B,13,40,230,21,12,121,1,0,Mississippi,48,33,163,31,21,338,0,0,V,-22,-35,7,67,-10,-9,-217,1,0,2009
754,754,10/17/2009,U-C-F,7,24,53,31,13,176,1,0,Miami-Florida,27,46,70,27,20,293,0,0,H,-13.5,-20,-22,-17,4,-7,-117,1,0,2009
755,755,10/17/2009,U.C.L.A.,26,26,137,42,21,311,1,1,California,45,41,289,23,14,205,0,0,H,-3.5,-19,-15,-152,19,7,106,1,1,2009
756,756,10/17/2009,UL-Lafayette,30,58,230,25,16,204,0,1,Western Kentucky,22,33,167,17,9,141,2,1,V,7.5,8,25,63,8,7,63,-2,0,2009
757,757,10/17/2009,Utah,35,31,153,24,17,174,0,2,Nevada-Las Vegas,15,33,91,47,25,236,2,0,V,16.5,20,-2,62,-23,-8,-62,-2,2,2009
758,758,10/17/2009,Utah State,32,34,74,42,25,353,0,1,Nevada-Reno,35,46,313,24,10,189,1,1,H,-7.5,-3,-12,-239,18,15,164,-1,0,2009
759,759,10/17/2009,Vanderbilt,10,36,122,34,17,174,1,0,Georgia,34,37,173,31,16,226,1,0,H,-7.5,-24,-1,-51,3,1,-52,0,0,2009
760,760,10/17/2009,Virginia,20,38,63,26,14,138,0,1,Maryland,9,33,126,38,16,158,2,2,V,3.5,11,5,-63,-12,-2,-20,-2,-1,2009
761,761,10/17/2009,Virginia Tech,23,31,175,14,10,159,2,0,Georgia Tech,28,63,309,7,1,51,1,1,V,3.5,-5,-32,-134,7,9,108,1,-1,2009
762,762,10/17/2009,Wake Forest,3,44,81,26,12,97,2,0,Clemson,38,33,195,24,15,187,0,2,V,-7.5,-35,11,-114,2,-3,-90,2,-2,2009
763,763,10/17/2009,Washington,17,27,99,38,22,279,2,1,Arizona State,24,27,169,36,22,295,0,1,V,-6.5,-7,0,-70,2,0,-16,2,0,2009
764,764,10/17/2009,West Virginia,24,31,147,23,16,166,0,2,Marshall,7,34,58,35,17,149,2,2,H,20.5,17,-3,89,-12,-1,17,-2,0,2009
765,765,10/17/2009,Western Kentucky,22,33,167,17,9,141,2,1,UL-Lafayette,30,58,230,25,16,204,0,1,H,-7.5,-8,-25,-63,-8,-7,-63,2,0,2009
766,766,10/17/2009,Western Michigan,23,26,87,66,40,410,1,0,Central Michigan,34,32,188,30,18,238,0,1,H,-7,-11,-6,-101,36,22,172,1,-1,2009
767,767,10/17/2009,Wisconsin,10,33,87,25,15,143,3,0,Iowa,20,39,65,23,17,218,0,1,H,2,-10,-6,22,2,-2,-75,3,-1,2009
768,768,10/17/2009,Wyoming,0,35,100,31,14,74,1,0,Air Force,10,69,267,5,1,2,0,0,V,-11,-10,-34,-167,26,13,72,1,0,2009
769,769,10/21/2009,Tulsa,24,45,204,25,12,224,0,1,UTEP,28,33,175,38,17,271,2,0,V,8.5,-4,12,29,-13,-5,-47,-2,1,2009
770,770,10/21/2009,UTEP,28,33,175,38,17,271,2,0,Tulsa,24,45,204,25,12,224,0,1,H,-8.5,4,-12,-29,13,5,47,2,-1,2009
771,771,10/22/2009,Florida State,30,25,43,40,33,395,0,1,North Carolina,27,41,238,27,13,95,1,0,V,-1.5,3,-16,-195,13,20,300,-1,1,2009
772,772,10/22/2009,North Carolina,27,41,238,27,13,95,1,0,Florida State,30,25,43,40,33,395,0,1,H,1.5,-3,16,195,-13,-20,-300,1,-1,2009
773,773,10/23/2009,Army,10,40,197,9,2,16,0,3,Rutgers,27,40,132,22,11,197,0,1,H,-10.5,-17,0,65,-13,-9,-181,0,2,2009
774,774,10/23/2009,Rutgers,27,40,132,22,11,197,0,1,Army,10,40,197,9,2,16,0,3,V,10.5,17,0,-65,13,9,181,0,-2,2009
775,775,10/24/2009,Air Force,16,75,254,10,7,64,0,1,Utah,23,30,100,21,11,167,0,2,V,-9.5,-7,45,154,-11,-4,-103,0,-1,2009
776,776,10/24/2009,Akron,14,24,0,25,16,191,0,2,Syracuse,28,46,234,18,12,105,0,2,V,-10.5,-14,-22,-234,7,4,86,0,0,2009
777,777,10/24/2009,Alabama,12,30,136,29,18,120,0,1,Tennessee,10,35,76,37,21,265,1,0,H,14,2,-5,60,-8,-3,-145,-1,1,2009
778,778,10/24/2009,Arizona,27,46,209,35,22,247,3,2,U.C.L.A.,13,23,65,35,15,146,0,2,H,7.5,14,23,144,0,7,101,3,0,2009
779,779,10/24/2009,Arizona State,14,25,129,30,13,161,0,1,Stanford,33,46,237,28,17,236,0,0,V,-6.5,-19,-21,-108,2,-4,-75,0,1,2009
780,780,10/24/2009,Arkansas,17,22,45,34,12,254,0,0,Mississippi,30,47,221,33,22,332,2,1,V,-6.5,-13,-25,-176,1,-10,-78,-2,-1,2009
781,781,10/24/2009,Arkansas State,27,48,276,22,14,154,1,1,Florida Intl,10,25,32,34,18,191,1,1,H,10.5,17,23,244,-12,-4,-37,0,0,2009
782,782,10/24/2009,Auburn,10,41,112,20,11,81,1,2,Louisiana State,31,32,122,34,22,254,0,1,V,-7.5,-21,9,-10,-14,-11,-173,1,1,2009
783,783,10/24/2009,Ball State,29,57,463,10,2,1,1,2,Eastern Michigan,27,33,153,24,8,86,0,0,V,2.5,2,24,310,-14,-6,-85,1,2,2009
784,784,10/24/2009,Baylor,7,19,43,39,24,241,1,0,Oklahoma State,34,43,195,27,23,250,0,0,H,-9.5,-27,-24,-152,12,1,-9,1,0,2009
785,785,10/24/2009,Boise State,54,40,193,32,20,279,0,0,Hawaii,9,18,93,47,27,214,3,3,V,25.5,45,22,100,-15,-7,65,-3,-3,2009
786,786,10/24/2009,Boston College,16,29,70,35,17,279,3,2,Notre Dame,20,37,106,39,26,246,0,0,V,-7.5,-4,-8,-36,-4,-9,33,3,2,2009
787,787,10/24/2009,Bowling Green,10,20,20,57,36,343,1,1,Central Michigan,24,44,259,22,16,147,0,0,H,-9,-14,-24,-239,35,20,196,1,1,2009
788,788,10/24/2009,Brigham Young,7,37,110,33,20,188,1,1,Texas Christian,38,37,127,25,14,285,0,0,H,-2.5,-31,0,-17,8,6,-97,1,1,2009
789,789,10/24/2009,Buffalo,31,28,214,51,26,327,2,0,Western Michigan,34,33,155,55,34,350,0,2,V,-5,-3,-5,59,-4,-8,-23,2,-2,2009
790,790,10/24/2009,California,49,39,309,21,15,250,1,0,Washington State,17,28,55,43,29,385,0,0,H,35.5,32,11,254,-22,-14,-135,1,0,2009
791,791,10/24/2009,Central Michigan,24,41,249,23,16,147,0,0,Bowling Green,10,20,20,57,36,343,1,1,V,9,14,21,229,-34,-20,-196,-1,-1,2009
792,792,10/24/2009,Cincinnati,41,34,182,23,19,286,0,0,Louisville,10,40,130,25,14,145,1,1,H,17.5,31,-6,52,-2,5,141,-1,-1,2009
793,793,10/24/2009,Clemson,40,34,84,37,25,326,1,2,Miami-Florida,37,35,177,27,17,256,3,1,V,-4.5,3,-1,-93,10,8,70,-2,1,2009
794,794,10/24/2009,Colorado,6,31,60,37,17,184,2,2,Kansas State,20,42,204,18,9,80,0,1,V,-4.5,-14,-11,-144,19,8,104,2,1,2009
795,795,10/24/2009,Colorado State,28,28,151,28,14,205,2,0,San Diego State,42,32,72,43,29,459,0,0,H,7,-14,-4,79,-15,-15,-254,2,0,2009
796,796,10/24/2009,Connecticut,24,37,123,41,25,378,3,1,West Virginia,28,40,234,27,16,153,1,1,V,-7.5,-4,-3,-111,14,9,225,2,0,2009
797,797,10/24/2009,Duke,17,28,23,43,30,371,1,2,Maryland,13,31,67,23,16,182,1,1,H,4,4,-3,-44,20,14,189,0,1,2009
798,798,10/24/2009,Eastern Michigan,27,34,150,24,8,86,0,0,Ball State,29,57,463,10,2,1,1,2,H,-2.5,-2,-23,-313,14,6,85,-1,-2,2009
799,799,10/24/2009,Florida,29,47,249,22,12,127,2,0,Mississippi State,19,35,92,23,15,145,3,0,V,22.5,10,12,157,-1,-3,-18,-1,0,2009
800,800,10/24/2009,Florida Atlantic,51,41,252,30,19,372,0,1,UL-Lafayette,29,39,163,31,19,209,1,1,V,-3,22,2,89,-1,0,163,-1,0,2009
801,801,10/24/2009,Florida Intl,10,25,32,34,18,191,1,1,Arkansas State,27,48,276,22,14,154,1,1,V,-10.5,-17,-23,-244,12,4,37,0,0,2009
802,802,10/24/2009,Fresno State,34,39,189,20,11,221,1,2,New Mexico State,3,43,238,15,7,45,1,0,V,24,31,-4,-49,5,4,176,0,2,2009
803,803,10/24/2009,Georgia Tech,34,71,362,8,4,85,0,1,Virginia,9,12,30,32,18,168,0,1,V,5.5,25,59,332,-24,-14,-83,0,0,2009
804,804,10/24/2009,Hawaii,9,18,93,47,27,214,3,3,Boise State,54,40,193,32,20,279,0,0,H,-25.5,-45,-22,-100,15,7,-65,3,3,2009
805,805,10/24/2009,Houston,38,34,124,39,28,270,0,0,S-M-U,15,34,197,30,18,200,0,3,H,16,23,0,-73,9,10,70,0,-3,2009
806,806,10/24/2009,Idaho,45,25,90,33,22,404,1,1,Nevada-Reno,70,53,484,21,13,178,0,0,V,-15.5,-25,-28,-394,12,9,226,1,1,2009
807,807,10/24/2009,Illinois,14,37,180,27,14,142,1,0,Purdue,24,39,220,24,15,166,0,0,V,-11,-10,-2,-40,3,-1,-24,1,0,2009
808,808,10/24/2009,Indiana,28,27,133,29,17,172,0,0,Northwestern,29,41,162,46,26,312,3,0,V,-5,-1,-14,-29,-17,-9,-140,-3,0,2009
809,809,10/24/2009,Iowa,15,39,138,27,11,138,0,0,Michigan State,13,30,85,32,16,225,0,0,V,-1.5,2,9,53,-5,-5,-87,0,0,2009
810,810,10/24/2009,Iowa State,9,48,137,19,9,102,0,0,Nebraska,7,28,114,37,20,248,3,5,V,-20.5,2,20,23,-18,-11,-146,-3,-5,2009
811,811,10/24/2009,Kansas,13,31,81,42,22,224,3,0,Oklahoma,35,31,85,38,26,252,1,1,H,-8,-22,0,-4,4,-4,-28,2,-1,2009
812,812,10/24/2009,Kansas State,20,42,204,18,9,80,0,1,Colorado,6,31,60,37,17,184,2,3,H,4.5,14,11,144,-19,-8,-104,-2,-2,2009
813,813,10/24/2009,Kent State,20,38,99,38,23,273,1,2,Ohio,11,30,-12,30,15,173,3,0,V,-9.5,9,8,111,8,8,100,-2,2,2009
814,814,10/24/2009,Kentucky,36,32,185,23,13,145,2,1,UL-Monroe,13,36,110,46,21,267,3,0,H,14,23,-4,75,-23,-8,-122,-1,1,2009
815,815,10/24/2009,Louisiana State,31,32,122,34,22,254,0,1,Auburn,10,41,112,20,11,81,1,2,H,7.5,21,-9,10,14,11,173,-1,-1,2009
816,816,10/24/2009,Louisiana Tech,21,38,118,26,17,155,1,1,Utah State,23,37,157,32,17,188,0,0,V,-1.5,-2,1,-39,-6,0,-33,1,1,2009
817,817,10/24/2009,Louisville,10,40,130,25,14,145,1,1,Cincinnati,41,34,182,23,19,286,0,0,V,-17.5,-31,6,-52,2,-5,-141,1,1,2009
818,818,10/24/2009,Marshall,27,38,135,38,25,315,0,1,U-A-B,7,34,232,27,16,200,0,0,H,7,20,4,-97,11,9,115,0,1,2009
819,819,10/24/2009,Maryland,13,31,67,23,16,182,1,1,Duke,17,28,23,43,30,371,1,2,V,-4,-4,3,44,-20,-14,-189,0,-1,2009
820,820,10/24/2009,Miami-Florida,37,35,177,27,17,256,3,1,Clemson,40,34,84,37,25,326,1,2,H,4.5,-3,1,93,-10,-8,-70,2,-1,2009
821,821,10/24/2009,Miami-Ohio,22,27,-11,38,27,348,0,0,Northern Illinois,27,39,202,10,6,60,0,1,H,-11,-5,-12,-213,28,21,288,0,-1,2009
822,822,10/24/2009,Michigan,10,40,110,33,13,140,2,2,Penn State,35,40,166,27,16,230,0,0,H,-4.5,-25,0,-56,6,-3,-90,2,2,2009
823,823,10/24/2009,Michigan State,13,30,85,32,16,225,0,0,Iowa,15,39,138,27,11,138,0,0,H,1.5,-2,-9,-53,5,5,87,0,0,2009
824,824,10/24/2009,Middle Tennessee,62,41,229,41,27,417,0,0,Western Kentucky,24,40,100,23,10,150,1,3,H,18,38,1,129,18,17,267,-1,-3,2009
825,825,10/24/2009,Minnesota,7,30,123,29,15,163,2,2,Ohio State,38,49,270,26,13,239,1,0,V,-16,-31,-19,-147,3,2,-76,1,2,2009
826,826,10/24/2009,Mississippi,30,47,221,33,22,332,2,1,Arkansas,17,22,45,34,12,254,0,0,H,6.5,13,25,176,-1,10,78,2,1,2009
827,827,10/24/2009,Mississippi State,19,35,92,23,15,145,3,0,Florida,29,47,249,22,12,127,2,0,H,-22.5,-10,-12,-157,1,3,18,1,0,2009
828,828,10/24/2009,Missouri,7,29,74,24,12,99,2,0,Texas,41,43,131,34,26,269,1,0,H,-13,-34,-14,-57,-10,-14,-170,1,0,2009
829,829,10/24/2009,Navy,13,64,338,0,0,0,0,1,Wake Forest,10,35,135,25,13,173,0,0,H,-2,3,29,203,-25,-13,-173,0,1,2009
830,830,10/24/2009,Nebraska,7,28,114,37,20,248,3,5,Iowa State,9,48,137,19,9,102,0,0,H,20.5,-2,-20,-23,18,11,146,3,5,2009
831,831,10/24/2009,Nevada-Las Vegas,34,44,210,34,23,213,0,0,New Mexico,17,25,68,31,20,219,0,2,V,1,17,19,142,3,3,-6,0,-2,2009
832,832,10/24/2009,Nevada-Reno,70,53,484,21,13,178,0,0,Idaho,45,25,90,33,22,404,1,1,H,15.5,25,28,394,-12,-9,-226,-1,-1,2009
833,833,10/24/2009,New Mexico,17,25,68,31,20,219,0,2,Nevada-Las Vegas,34,44,210,34,23,213,0,0,H,-1,-17,-19,-142,-3,-3,6,0,2,2009
834,834,10/24/2009,New Mexico State,3,43,238,15,7,45,1,0,Fresno State,34,39,189,20,11,221,1,2,H,-24,-31,4,49,-5,-4,-176,0,-2,2009
835,835,10/24/2009,North Texas,26,26,128,33,22,267,1,0,Troy,50,44,205,50,30,492,0,2,V,-20.5,-24,-18,-77,-17,-8,-225,1,-2,2009
836,836,10/24/2009,Northern Illinois,27,39,202,10,6,60,0,1,Miami-Ohio,22,27,-11,38,27,348,0,0,V,11,5,12,213,-28,-21,-288,0,1,2009
837,837,10/24/2009,Northwestern,29,41,162,46,26,312,3,0,Indiana,28,27,133,29,17,172,0,0,H,5,1,14,29,17,9,140,3,0,2009
838,838,10/24/2009,Notre Dame,20,37,106,39,26,246,0,0,Boston College,16,29,70,36,17,279,3,2,H,7.5,4,8,36,3,9,-33,-3,-2,2009
839,839,10/24/2009,Ohio,11,29,-9,30,15,173,3,0,Kent State,20,38,99,38,23,273,1,2,H,9.5,-9,-9,-108,-8,-8,-100,2,-2,2009
840,840,10/24/2009,Ohio State,38,49,270,26,13,239,1,0,Minnesota,7,30,123,29,15,163,2,2,H,16,31,19,147,-3,-2,76,-1,-2,2009
841,841,10/24/2009,Oklahoma,35,31,85,38,26,252,1,1,Kansas,13,31,81,42,22,224,3,0,V,8,22,0,4,-4,4,28,-2,1,2009
842,842,10/24/2009,Oklahoma State,34,43,195,27,23,250,0,0,Baylor,7,19,43,39,24,241,1,0,V,9.5,27,24,152,-12,-1,9,-1,0,2009
843,843,10/24/2009,Oregon,43,40,259,22,14,157,0,1,Washington,19,34,129,45,23,266,2,1,V,10,24,6,130,-23,-9,-109,-2,0,2009
844,844,10/24/2009,Oregon State,36,34,153,43,30,329,0,1,Southern Cal,42,33,227,25,15,202,2,0,V,-20.5,-6,1,-74,18,15,127,-2,1,2009
845,845,10/24/2009,Penn State,35,40,166,27,16,230,0,0,Michigan,10,40,110,33,13,140,2,2,V,4.5,25,0,56,-6,3,90,-2,-2,2009
846,846,10/24/2009,Pittsburgh,41,42,214,30,20,272,1,0,South Florida,14,33,122,13,7,90,3,0,H,6.5,27,9,92,17,13,182,-2,0,2009
847,847,10/24/2009,Purdue,24,39,220,24,15,166,0,0,Illinois,14,37,180,27,14,142,1,0,H,11,10,2,40,-3,1,24,-1,0,2009
848,848,10/24/2009,Rice,7,38,104,37,25,178,1,3,U-C-F,49,39,213,18,12,252,0,0,H,-10,-42,-1,-109,19,13,-74,1,3,2009
849,849,10/24/2009,S-M-U,15,34,197,30,18,200,0,3,Houston,38,37,161,36,25,233,0,0,V,-16,-23,-3,36,-6,-7,-33,0,3,2009
850,850,10/24/2009,San Diego State,42,32,72,43,29,459,0,0,Colorado State,28,28,151,28,14,205,2,0,V,-7,14,4,-79,15,15,254,-2,0,2009
851,851,10/24/2009,South Carolina,14,37,119,33,22,312,0,0,Vanderbilt,10,36,141,33,16,132,0,0,H,13.5,4,1,-22,0,6,180,0,0,2009
852,852,10/24/2009,South Florida,14,33,122,13,7,90,3,0,Pittsburgh,41,42,214,30,20,272,1,0,V,-6.5,-27,-9,-92,-17,-13,-182,2,0,2009
853,853,10/24/2009,Southern Cal,42,33,227,25,15,202,2,0,Oregon State,36,34,153,43,30,329,0,1,H,20.5,6,-1,74,-18,-15,-127,2,-1,2009
854,854,10/24/2009,Southern Miss,43,43,253,15,13,127,0,2,Tulane,6,32,47,35,23,165,1,3,H,21,37,11,206,-20,-10,-38,-1,-1,2009
855,855,10/24/2009,Stanford,33,46,237,28,17,236,0,0,Arizona State,14,25,129,30,13,161,0,1,H,6.5,19,21,108,-2,4,75,0,-1,2009
856,856,10/24/2009,Syracuse,28,46,234,18,12,105,0,2,Akron,14,24,0,25,16,191,0,2,H,10.5,14,22,234,-7,-4,-86,0,0,2009
857,857,10/24/2009,Temple,40,51,211,22,12,132,0,1,Toledo,24,23,48,47,29,265,2,1,V,-2.5,16,28,163,-25,-17,-133,-2,0,2009
858,858,10/24/2009,Tennessee,10,35,76,37,21,265,1,0,Alabama,12,30,136,29,18,120,0,1,V,-14,-2,5,-60,8,3,145,1,-1,2009
859,859,10/24/2009,Texas,41,43,131,34,26,269,1,0,Missouri,7,29,74,24,12,99,2,0,V,13,34,14,57,10,14,170,-1,0,2009
860,860,10/24/2009,Texas A+M,52,59,321,28,19,238,0,2,Texas Tech,30,22,64,61,43,456,2,3,V,-22,22,37,257,-33,-24,-218,-2,-1,2009
861,861,10/24/2009,Texas Christian,38,37,127,25,14,285,0,0,Brigham Young,7,37,110,33,20,188,1,1,V,2.5,31,0,17,-8,-6,97,-1,-1,2009
862,862,10/24/2009,Texas Tech,30,22,64,61,43,456,2,3,Texas A+M,52,59,321,28,19,238,0,1,H,22,-22,-37,-257,33,24,218,2,2,2009
863,863,10/24/2009,Toledo,24,23,48,47,29,265,2,1,Temple,40,51,211,22,12,132,0,1,H,2.5,-16,-28,-163,25,17,133,2,0,2009
864,864,10/24/2009,Troy,50,44,205,50,30,492,0,2,North Texas,26,26,128,33,22,267,1,0,H,20.5,24,18,77,17,8,225,-1,2,2009
865,865,10/24/2009,Tulane,6,33,54,33,21,158,1,3,Southern Miss,43,40,216,18,16,164,0,2,V,-21,-37,-7,-162,15,5,-6,1,1,2009
866,866,10/24/2009,U-A-B,7,34,232,27,16,200,0,0,Marshall,27,38,135,38,25,315,0,1,V,-7,-20,-4,97,-11,-9,-115,0,-1,2009
867,867,10/24/2009,U-C-F,49,39,213,18,12,252,0,0,Rice,7,38,104,37,25,178,1,3,V,10,42,1,109,-19,-13,74,-1,-3,2009
868,868,10/24/2009,U.C.L.A.,13,23,65,35,15,146,0,2,Arizona,27,46,209,35,22,247,3,2,V,-7.5,-14,-23,-144,0,-7,-101,-3,0,2009
869,869,10/24/2009,UL-Lafayette,29,39,163,31,19,209,1,1,Florida Atlantic,51,41,252,30,19,372,0,1,H,3,-22,-2,-89,1,0,-163,1,0,2009
870,870,10/24/2009,UL-Monroe,13,36,110,46,21,267,3,0,Kentucky,36,32,185,23,13,145,2,1,V,-14,-23,4,-75,23,8,122,1,-1,2009
871,871,10/24/2009,Utah,23,30,100,21,11,167,0,2,Air Force,16,75,254,10,7,64,0,1,H,9.5,7,-45,-154,11,4,103,0,1,2009
872,872,10/24/2009,Utah State,23,37,157,32,17,188,0,0,Louisiana Tech,21,38,118,26,17,155,1,1,H,1.5,2,-1,39,6,0,33,-1,-1,2009
873,873,10/24/2009,Vanderbilt,10,36,141,33,16,132,0,0,South Carolina,14,37,119,33,22,312,0,0,V,-13.5,-4,-1,22,0,-6,-180,0,0,2009
874,874,10/24/2009,Virginia,9,12,30,32,18,168,0,1,Georgia Tech,34,71,362,8,4,85,0,1,H,-5.5,-25,-59,-332,24,14,83,0,0,2009
875,875,10/24/2009,Wake Forest,10,35,135,25,13,173,0,0,Navy,13,64,338,0,0,0,0,1,V,2,-3,-29,-203,25,13,173,0,-1,2009
876,876,10/24/2009,Washington,19,34,129,46,23,266,2,1,Oregon,43,40,259,22,14,157,0,1,H,-10,-24,-6,-130,24,9,109,2,0,2009
877,877,10/24/2009,Washington State,17,28,55,43,29,385,0,0,California,49,39,309,21,15,250,1,0,V,-35.5,-32,-11,-254,22,14,135,-1,0,2009
878,878,10/24/2009,West Virginia,28,40,234,27,16,153,1,1,Connecticut,24,37,123,41,25,378,3,1,H,7.5,4,3,111,-14,-9,-225,-2,0,2009
879,879,10/24/2009,Western Kentucky,24,40,100,23,10,150,1,3,Middle Tennessee,62,41,229,41,27,417,0,0,V,-18,-38,-1,-129,-18,-17,-267,1,3,2009
880,880,10/24/2009,Western Michigan,34,33,155,55,34,350,0,2,Buffalo,31,25,204,52,26,327,2,0,H,5,3,8,-49,3,8,23,-2,2,2009
881,881,10/27/2009,East Carolina,38,47,275,28,15,222,1,0,Memphis,19,25,84,49,33,313,1,3,V,6,19,22,191,-21,-18,-91,0,-3,2009
882,882,10/27/2009,Memphis,19,25,84,49,33,313,1,3,East Carolina,38,47,275,28,15,222,1,0,H,-6,-19,-22,-191,21,18,91,0,3,2009
883,883,10/29/2009,North Carolina,20,42,181,29,18,131,1,0,Virginia Tech,17,33,95,23,11,161,0,2,V,-14.5,3,9,86,6,7,-30,1,-2,2009
884,884,10/29/2009,Virginia Tech,17,33,95,23,11,161,0,2,North Carolina,20,42,181,29,18,131,1,0,H,14.5,-3,-9,-86,-6,-7,30,-1,2,2009
885,885,10/30/2009,South Florida,30,40,189,26,13,232,0,0,West Virginia,19,35,118,32,19,205,1,0,H,-3,11,5,71,-6,-6,27,-1,0,2009
886,886,10/30/2009,West Virginia,19,35,118,32,19,205,1,0,South Florida,30,40,189,26,13,232,0,0,V,3,-11,-5,-71,6,6,-27,1,0,2009
887,887,10/31/2009,Air Force,34,59,271,12,7,111,0,1,Colorado State,16,38,180,19,7,87,1,0,V,7,18,21,91,-7,0,24,-1,1,2009
888,888,10/31/2009,Akron,10,24,31,28,12,204,0,1,Northern Illinois,27,54,275,18,10,62,0,0,V,-12,-17,-30,-244,10,2,142,0,1,2009
889,889,10/31/2009,Arizona State,21,26,82,30,17,247,2,1,California,23,30,57,45,27,351,0,2,H,-6.5,-2,-4,25,-15,-10,-104,2,-1,2009
890,890,10/31/2009,Arkansas,63,30,292,27,19,297,1,2,Eastern Michigan,27,28,89,26,13,259,1,0,H,36,36,2,203,1,6,38,0,2,2009
891,891,10/31/2009,Arkansas State,13,25,45,41,23,303,2,0,Louisville,21,37,176,40,20,232,1,0,V,-3,-8,-12,-131,1,3,71,1,0,2009
892,892,10/31/2009,Auburn,33,43,175,24,13,226,0,1,Mississippi,20,39,219,35,16,175,2,1,H,-6.5,13,4,-44,-11,-3,51,-2,0,2009
893,893,10/31/2009,Ball State,17,38,169,9,6,78,1,0,Ohio,20,41,155,27,17,161,2,0,H,-5.5,-3,-3,14,-18,-11,-83,-1,0,2009
894,894,10/31/2009,Baylor,10,32,54,38,19,222,2,1,Nebraska,20,38,145,21,12,128,1,1,H,-14,-10,-6,-91,17,7,94,1,0,2009
895,895,10/31/2009,Boise State,45,32,140,39,25,290,0,1,San Jose State,7,29,92,32,16,131,1,1,H,36.5,38,3,48,7,9,159,-1,0,2009
896,896,10/31/2009,Boston College,31,33,150,28,18,262,0,0,Central Michigan,10,31,93,42,24,218,2,0,H,6,21,2,57,-14,-6,44,-2,0,2009
897,897,10/31/2009,California,23,30,57,45,27,351,0,2,Arizona State,21,26,82,30,17,247,2,1,V,6.5,2,4,-25,15,10,104,-2,1,2009
898,898,10/31/2009,Central Michigan,10,31,93,42,24,218,2,0,Boston College,31,33,150,28,18,262,0,0,V,-6,-21,-2,-57,14,6,-44,2,0,2009
899,899,10/31/2009,Cincinnati,28,34,127,29,22,295,0,0,Syracuse,7,29,101,27,19,182,1,1,V,16.5,21,5,26,2,3,113,-1,-1,2009
900,900,10/31/2009,Clemson,49,37,252,23,13,148,2,0,Coastal Carolina,3,46,143,17,5,27,2,0,H, ,46,-9,109,6,8,121,0,0,2009
901,901,10/31/2009,Colorado,17,24,-14,36,22,190,1,3,Missouri,36,45,184,30,18,216,2,0,H,-3,-19,-21,-198,6,4,-26,-1,3,2009
902,902,10/31/2009,Colorado State,16,38,180,19,7,87,1,0,Air Force,34,59,271,12,7,111,0,1,H,-7,-18,-21,-91,7,0,-24,1,-1,2009
903,903,10/31/2009,Connecticut,24,30,108,56,25,373,3,1,Rutgers,28,31,86,25,13,236,0,0,H,7.5,-4,-1,22,31,12,137,3,1,2009
904,904,10/31/2009,Duke,28,39,81,41,24,343,1,0,Virginia,17,28,89,38,13,107,1,1,V,-7,11,11,-8,3,11,236,0,-1,2009
905,905,10/31/2009,Eastern Michigan,27,28,89,26,13,259,1,0,Arkansas,63,30,292,27,19,297,1,2,V,-36,-36,-2,-203,-1,-6,-38,0,-2,2009
906,906,10/31/2009,Florida,41,40,210,21,15,164,0,0,Georgia,17,33,121,23,11,165,4,0,N,14.5,24,7,89,-2,4,-1,-4,0,2009
907,907,10/31/2009,Florida Atlantic,20,38,101,54,28,377,2,0,Middle Tennessee,27,34,239,22,7,90,0,1,H,2.5,-7,4,-138,32,21,287,2,-1,2009
908,908,10/31/2009,Florida Intl,20,49,145,43,22,250,1,3,UL-Lafayette,17,44,126,36,22,254,1,0,H,4.5,3,5,19,7,0,-4,0,3,2009
909,909,10/31/2009,Florida State,45,33,278,40,26,277,2,0,No Carolina State,42,38,189,31,20,349,2,1,H,10.5,3,-5,89,9,6,-72,0,-1,2009
910,910,10/31/2009,Fresno State,31,30,210,27,17,256,1,1,Utah State,27,50,263,31,20,240,0,0,H,17,4,-20,-53,-4,-3,16,1,1,2009
911,911,10/31/2009,Georgia,17,33,121,23,11,165,4,0,Florida,41,40,210,21,15,164,0,0,N,-14.5,-24,-7,-89,2,-4,1,4,0,2009
912,912,10/31/2009,Georgia Tech,56,69,404,13,6,193,0,1,Vanderbilt,31,29,218,24,14,179,0,3,V,11.5,25,40,186,-11,-8,14,0,-2,2009
913,913,10/31/2009,Hawaii,21,20,118,49,29,374,2,0,Nevada-Reno,31,49,312,21,12,184,0,1,V,-29,-10,-29,-194,28,17,190,2,-1,2009
914,914,10/31/2009,Houston,50,33,191,54,44,559,1,2,Southern Miss,43,47,248,35,21,360,0,1,H,7,7,-14,-57,19,23,199,1,1,2009
915,915,10/31/2009,Idaho,35,27,134,46,25,327,2,1,Louisiana Tech,34,47,222,47,27,325,0,0,H,3,1,-20,-88,-1,-2,2,2,1,2009
916,916,10/31/2009,Illinois,38,56,377,11,8,123,0,0,Michigan,13,43,113,24,14,264,0,3,H,-7,25,13,264,-13,-6,-141,0,-3,2009
917,917,10/31/2009,Indiana,24,27,79,41,23,227,3,0,Iowa,42,37,143,26,13,337,5,1,V,-17.5,-18,-10,-64,15,10,-110,-2,-1,2009
918,918,10/31/2009,Iowa,42,37,143,26,13,337,5,1,Indiana,24,27,79,41,23,227,3,0,H,17.5,18,10,64,-15,-10,110,2,1,2009
919,919,10/31/2009,Iowa State,10,34,169,27,18,155,2,0,Texas A+M,35,49,267,28,23,234,0,2,V,-6,-25,-15,-98,-1,-5,-79,2,-2,2009
920,920,10/31/2009,Kansas,21,33,71,37,21,187,0,4,Texas Tech,42,32,105,47,25,253,1,2,V,-6.5,-21,1,-34,-10,-4,-66,-1,2,2009
921,921,10/31/2009,Kansas State,30,29,149,31,20,215,1,0,Oklahoma,42,35,164,37,26,294,0,0,V,-28,-12,-6,-15,-6,-6,-79,1,0,2009
922,922,10/31/2009,Kent State,26,32,104,34,24,373,2,1,Western Michigan,14,23,38,49,31,255,1,0,H,2.5,12,9,66,-15,-7,118,1,1,2009
923,923,10/31/2009,Kentucky,24,48,189,19,11,119,1,2,Mississippi State,31,45,348,17,10,145,2,0,H,4,-7,3,-159,2,1,-26,-1,2,2009
924,924,10/31/2009,Louisiana State,42,41,267,20,13,188,1,0,Tulane,0,20,26,37,26,190,1,0,H,36,42,21,241,-17,-13,-2,0,0,2009
925,925,10/31/2009,Louisiana Tech,34,47,222,47,27,325,0,0,Idaho,35,27,134,46,25,327,2,1,V,-3,-1,20,88,1,2,-2,-2,-1,2009
926,926,10/31/2009,Louisville,21,37,176,40,20,232,1,0,Arkansas State,13,25,45,41,23,303,2,0,H,3,8,12,131,-1,-3,-71,-1,0,2009
927,927,10/31/2009,Miami-Florida,28,21,26,43,22,330,1,0,Wake Forest,27,33,147,53,35,408,1,3,V,7,1,-12,-121,-10,-13,-78,0,-3,2009
928,928,10/31/2009,Miami-Ohio,31,22,92,51,31,344,0,1,Toledo,24,44,216,30,18,228,1,1,H,-5.5,7,-22,-124,21,13,116,-1,0,2009
929,929,10/31/2009,Michigan,13,43,113,24,14,264,0,3,Illinois,38,56,377,11,8,123,0,0,V,7,-25,-13,-264,13,6,141,0,3,2009
930,930,10/31/2009,Michigan State,34,20,124,36,21,236,1,2,Minnesota,42,39,89,33,19,416,1,1,V,3.5,-8,-19,35,3,2,-180,0,1,2009
931,931,10/31/2009,Middle Tennessee,27,34,239,22,7,90,0,1,Florida Atlantic,20,38,101,54,28,377,2,0,V,-2.5,7,-4,138,-32,-21,-287,-2,1,2009
932,932,10/31/2009,Minnesota,42,39,89,33,19,416,1,1,Michigan State,34,20,124,36,21,236,1,2,H,-3.5,8,19,-35,-3,-2,180,0,-1,2009
933,933,10/31/2009,Mississippi,20,39,219,35,16,175,2,1,Auburn,33,43,175,24,13,226,0,1,V,6.5,-13,-4,44,11,3,-51,2,0,2009
934,934,10/31/2009,Mississippi State,31,45,348,17,10,145,2,0,Kentucky,24,48,189,19,11,119,1,2,V,-4,7,-3,159,-2,-1,26,1,-2,2009
935,935,10/31/2009,Missouri,36,45,184,30,18,216,2,0,Colorado,17,24,-14,36,22,190,1,3,V,3,19,21,198,-6,-4,26,1,-3,2009
936,936,10/31/2009,Navy,24,62,227,7,2,27,1,0,Temple,27,34,274,17,5,37,2,1,H,6.5,-3,28,-47,-10,-3,-10,-1,-1,2009
937,937,10/31/2009,Nebraska,20,38,145,21,12,128,1,1,Baylor,10,32,54,38,19,222,2,1,V,14,10,6,91,-17,-7,-94,-1,0,2009
938,938,10/31/2009,Nevada-Las Vegas,0,29,118,23,9,42,1,1,Texas Christian,41,48,390,22,13,188,0,2,V,-35,-41,-19,-272,1,-4,-146,1,-1,2009
939,939,10/31/2009,Nevada-Reno,31,49,312,21,12,184,0,1,Hawaii,21,20,118,49,29,374,2,0,H,29,10,29,194,-28,-17,-190,-2,1,2009
940,940,10/31/2009,New Mexico,20,37,109,52,27,277,0,0,San Diego State,23,29,50,38,22,253,0,1,V,-16,-3,8,59,14,5,24,0,-1,2009
941,941,10/31/2009,New Mexico State,0,30,40,15,6,22,1,2,Ohio State,45,49,310,33,14,249,0,1,V,-44,-45,-19,-270,-18,-8,-227,1,1,2009
942,942,10/31/2009,No Carolina State,42,38,189,31,20,349,2,1,Florida State,45,33,278,40,26,277,2,0,V,-10.5,-3,5,-89,-9,-6,72,0,1,2009
943,943,10/31/2009,North Texas,68,44,321,30,24,262,0,0,Western Kentucky,49,38,281,20,15,144,1,1,H,13.5,19,6,40,10,9,118,-1,-1,2009
944,944,10/31/2009,Northern Illinois,27,54,275,18,10,62,0,0,Akron,10,24,31,28,12,204,0,1,H,12,17,30,244,-10,-2,-142,0,-1,2009
945,945,10/31/2009,Northwestern,13,37,119,43,29,252,0,2,Penn State,34,27,163,31,22,274,0,0,H,-17,-21,10,-44,12,7,-22,0,2,2009
946,946,10/31/2009,Notre Dame,40,48,255,33,24,337,0,1,Washington State,14,26,102,23,12,104,2,0,N,27.5,26,22,153,10,12,233,-2,1,2009
947,947,10/31/2009,Ohio,20,41,155,27,17,161,2,0,Ball State,17,38,169,9,6,78,1,0,V,5.5,3,3,-14,18,11,83,1,0,2009
948,948,10/31/2009,Ohio State,45,49,310,33,14,249,0,1,New Mexico State,0,30,40,15,6,22,1,2,H,44,45,19,270,18,8,227,-1,-1,2009
949,949,10/31/2009,Oklahoma,42,35,164,37,26,294,0,0,Kansas State,30,29,149,31,20,215,1,0,H,28,12,6,15,6,6,79,-1,0,2009
950,950,10/31/2009,Oklahoma State,14,43,134,28,15,143,4,1,Texas,41,32,99,24,17,176,0,1,H,-9.5,-27,11,35,4,-2,-33,4,0,2009
951,951,10/31/2009,Oregon,47,49,391,31,19,222,0,1,Southern Cal,20,29,140,38,21,187,1,0,H,-3,27,20,251,-7,-2,35,-1,1,2009
952,952,10/31/2009,Oregon State,26,35,144,35,26,319,0,0,U.C.L.A.,19,29,51,34,22,323,0,0,H,10,7,6,93,1,4,-4,0,0,2009
953,953,10/31/2009,Penn State,34,27,163,31,22,274,0,0,Northwestern,13,37,119,43,29,252,0,2,V,17,21,-10,44,-12,-7,22,0,-2,2009
954,954,10/31/2009,Purdue,0,29,60,33,9,81,1,2,Wisconsin,37,53,266,19,9,115,1,0,V,-7.5,-37,-24,-206,14,0,-34,0,2,2009
955,955,10/31/2009,Rutgers,28,31,86,25,13,236,0,0,Connecticut,24,30,108,56,25,373,3,1,V,-7.5,4,1,-22,-31,-12,-137,-3,-1,2009
956,956,10/31/2009,S-M-U,27,41,75,30,20,354,0,2,Tulsa,13,32,106,32,11,216,2,0,V,-14.5,14,9,-31,-2,9,138,-2,2,2009
957,957,10/31/2009,San Diego State,23,29,50,38,22,253,0,1,New Mexico,20,37,109,52,27,277,0,0,H,16,3,-8,-59,-14,-5,-24,0,1,2009
958,958,10/31/2009,San Jose State,7,29,92,32,16,131,1,1,Boise State,45,32,140,39,25,290,0,1,V,-36.5,-38,-3,-48,-7,-9,-159,1,0,2009
959,959,10/31/2009,South Carolina,13,20,65,50,25,300,1,3,Tennessee,31,40,199,24,12,142,0,0,V,-6,-18,-20,-134,26,13,158,1,3,2009
960,960,10/31/2009,Southern Cal,20,29,140,38,21,187,1,0,Oregon,47,49,391,31,19,222,0,1,V,3,-27,-20,-251,7,2,-35,1,-1,2009
961,961,10/31/2009,Southern Miss,43,47,248,35,21,360,0,1,Houston,50,33,191,54,44,559,1,2,V,-7,-7,14,57,-19,-23,-199,-1,-1,2009
962,962,10/31/2009,Syracuse,7,29,101,27,19,182,1,1,Cincinnati,28,34,127,29,22,295,0,0,H,-16.5,-21,-5,-26,-2,-3,-113,1,1,2009
963,963,10/31/2009,Temple,27,34,274,17,5,37,2,1,Navy,24,62,227,7,2,27,1,0,V,-6.5,3,-28,47,10,3,10,1,1,2009
964,964,10/31/2009,Tennessee,31,40,199,24,12,142,0,0,South Carolina,13,20,65,50,25,300,1,3,H,6,18,20,134,-26,-13,-158,-1,-3,2009
965,965,10/31/2009,Texas,41,32,99,24,17,176,0,1,Oklahoma State,14,43,134,28,15,143,4,1,V,9.5,27,-11,-35,-4,2,33,-4,0,2009
966,966,10/31/2009,Texas A+M,35,49,267,28,23,234,0,2,Iowa State,10,34,169,27,18,155,2,0,H,6,25,15,98,1,5,79,-2,2,2009
967,967,10/31/2009,Texas Christian,41,48,390,22,13,188,0,2,Nevada-Las Vegas,0,29,118,23,9,42,1,1,H,35,41,19,272,-1,4,146,-1,1,2009
968,968,10/31/2009,Texas Tech,42,32,105,47,25,253,1,2,Kansas,21,33,71,37,21,187,0,4,H,6.5,21,-1,34,10,4,66,1,-2,2009
969,969,10/31/2009,Toledo,24,44,216,30,18,228,1,1,Miami-Ohio,31,22,92,51,31,344,0,1,V,5.5,-7,22,124,-21,-13,-116,1,0,2009
970,970,10/31/2009,Troy,42,25,50,43,28,378,1,0,UL-Monroe,21,34,117,37,23,279,3,1,H,14,21,-9,-67,6,5,99,-2,-1,2009
971,971,10/31/2009,Tulane,0,20,26,37,26,190,1,0,Louisiana State,42,41,267,20,13,188,1,0,V,-36,-42,-21,-241,17,13,2,0,0,2009
972,972,10/31/2009,Tulsa,13,32,106,32,11,216,2,0,S-M-U,27,41,75,30,20,354,0,2,H,14.5,-14,-9,31,2,-9,-138,2,-2,2009
973,973,10/31/2009,U-A-B,38,41,234,16,9,141,0,0,UTEP,33,39,188,44,23,397,2,1,V,-8,5,2,46,-28,-14,-256,-2,-1,2009
974,974,10/31/2009,U.C.L.A.,19,29,51,34,22,323,0,0,Oregon State,26,35,144,35,26,319,0,0,V,-10,-7,-6,-93,-1,-4,4,0,0,2009
975,975,10/31/2009,UL-Lafayette,17,44,126,36,22,254,1,0,Florida Intl,20,49,145,43,22,250,1,3,V,-4.5,-3,-5,-19,-7,0,4,0,-3,2009
976,976,10/31/2009,UL-Monroe,21,34,117,37,23,279,3,1,Troy,42,25,50,43,28,378,1,0,V,-14,-21,9,67,-6,-5,-99,2,1,2009
977,977,10/31/2009,UTEP,33,39,188,44,23,397,2,1,U-A-B,38,41,234,16,9,141,0,0,H,8,-5,-2,-46,28,14,256,2,1,2009
978,978,10/31/2009,Utah,22,38,152,28,20,211,0,0,Wyoming,10,25,51,31,20,151,1,0,H,17.5,12,13,101,-3,0,60,-1,0,2009
979,979,10/31/2009,Utah State,27,50,263,31,20,240,0,0,Fresno State,31,30,210,27,17,256,1,1,V,-17,-4,20,53,4,3,-16,-1,-1,2009
980,980,10/31/2009,Vanderbilt,31,29,218,24,14,179,0,3,Georgia Tech,56,69,404,13,6,193,0,1,H,-11.5,-25,-40,-186,11,8,-14,0,2,2009
981,981,10/31/2009,Virginia,17,28,89,38,13,107,1,1,Duke,28,39,81,41,24,343,1,0,H,7,-11,-11,8,-3,-11,-236,0,1,2009
982,982,10/31/2009,Wake Forest,27,33,147,53,35,408,1,3,Miami-Florida,28,21,26,43,22,330,1,0,H,-7,-1,12,121,10,13,78,0,3,2009
983,983,10/31/2009,Washington State,14,26,102,23,12,104,2,0,Notre Dame,40,48,255,33,24,337,0,1,N,-27.5,-26,-22,-153,-10,-12,-233,2,-1,2009
984,984,10/31/2009,Western Kentucky,49,38,281,20,15,144,1,1,North Texas,68,44,321,30,24,262,0,0,V,-13.5,-19,-6,-40,-10,-9,-118,1,1,2009
985,985,10/31/2009,Western Michigan,14,23,38,49,31,255,1,0,Kent State,26,32,104,34,24,373,2,1,V,-2.5,-12,-9,-66,15,7,-118,-1,-1,2009
986,986,10/31/2009,Wisconsin,37,53,266,19,9,115,1,0,Purdue,0,29,60,33,9,81,1,2,H,7.5,37,24,206,-14,0,34,0,-2,2009
987,987,10/31/2009,Wyoming,10,25,51,31,20,151,1,0,Utah,22,38,152,28,20,211,0,0,V,-17.5,-12,-13,-101,3,0,-60,1,0,2009
988,988,11/01/2009,Marshall,20,36,56,28,13,237,1,1,U-C-F,21,30,59,48,23,342,0,0,V,-7,-1,6,-3,-20,-10,-105,1,1,2009
989,989,11/01/2009,U-C-F,21,30,59,48,23,342,0,0,Marshall,20,36,56,28,13,237,1,1,H,7,1,-6,3,20,10,105,-1,-1,2009
990,990,11/03/2009,Bowling Green,30,25,48,41,22,313,1,1,Buffalo,29,47,262,27,13,149,0,0,V,-3,1,-22,-214,14,9,164,1,1,2009
991,991,11/03/2009,Buffalo,29,47,262,27,13,149,0,0,Bowling Green,30,25,48,41,22,313,1,1,H,3,-1,22,214,-14,-9,-164,-1,-1,2009
992,992,11/05/2009,East Carolina,3,31,110,35,16,167,1,2,Virginia Tech,16,45,242,30,17,137,0,1,H,-13,-13,-14,-132,5,-1,30,1,1,2009
993,993,11/05/2009,Eastern Michigan,6,31,100,22,5,82,1,1,Northern Illinois,50,54,418,7,4,119,1,1,V,-21,-44,-23,-318,15,1,-37,0,0,2009
994,994,11/05/2009,Miami-Ohio,32,22,52,51,31,426,1,1,Temple,34,54,224,11,6,143,0,1,V,-17.5,-2,-32,-172,40,25,283,1,0,2009
995,995,11/05/2009,Northern Illinois,50,54,418,7,4,119,1,1,Eastern Michigan,6,31,100,22,5,82,1,1,H,21,44,23,318,-15,-1,37,0,0,2009
996,996,11/05/2009,Temple,34,54,224,11,6,143,0,1,Miami-Ohio,32,22,52,51,31,426,1,1,H,17.5,2,32,172,-40,-25,-283,-1,0,2009
997,997,11/05/2009,Virginia Tech,16,45,242,30,17,137,0,1,East Carolina,3,31,110,35,16,167,1,2,V,13,13,14,132,-5,1,-30,-1,-1,2009
998,998,11/06/2009,Boise State,45,34,153,41,28,354,1,0,Louisiana Tech,35,43,136,21,10,114,1,0,V,20.5,10,-9,17,20,18,240,0,0,2009
999,999,11/06/2009,Louisiana Tech,35,43,136,21,10,114,1,0,Boise State,45,34,153,41,28,354,1,0,H,-20.5,-10,9,-17,-20,-18,-240,0,0,2009
1000,1000,11/07/2009,Air Force,35,51,160,7,4,131,0,0,Army,7,48,192,10,4,44,0,0,H,17,28,3,-32,-3,0,87,0,0,2009
1001,1001,11/07/2009,Akron,28,40,168,35,19,261,1,0,Kent State,20,21,38,59,30,377,2,0,H,-4,8,19,130,-24,-11,-116,-1,0,2009
1002,1002,11/07/2009,Alabama,24,38,176,34,19,276,1,0,Louisiana State,15,29,95,27,14,158,1,0,H,7,9,9,81,7,5,118,0,0,2009
1003,1003,11/07/2009,Arizona,48,54,294,24,15,177,0,0,Washington State,7,21,59,21,12,126,0,2,H,32.5,41,33,235,3,3,51,0,-2,2009
1004,1004,11/07/2009,Arizona State,9,33,81,50,23,266,3,1,Southern Cal,14,33,146,22,7,112,1,0,H,-10.5,-5,0,-65,28,16,154,2,1,2009
1005,1005,11/07/2009,Arkansas,33,36,76,27,23,329,0,0,South Carolina,16,25,53,34,20,327,1,0,H,7.5,17,11,23,-7,3,2,-1,0,2009
1006,1006,11/07/2009,Arkansas State,18,28,57,24,11,182,2,1,UL-Lafayette,21,39,147,40,28,229,0,2,H,13.5,-3,-11,-90,-16,-17,-47,2,-1,2009
1007,1007,11/07/2009,Army,7,48,192,10,4,44,0,0,Air Force,35,51,160,7,4,131,0,0,V,-17,-28,-3,32,3,0,-87,0,0,2009
1008,1008,11/07/2009,Auburn,63,39,282,30,27,373,0,2,Furman,31,31,87,28,14,179,1,0,H, ,32,8,195,2,13,194,-1,2,2009
1009,1009,11/07/2009,Baylor,40,28,38,43,32,427,0,0,Missouri,32,25,10,52,30,468,0,0,V,-15,8,3,28,-9,2,-41,0,0,2009
1010,1010,11/07/2009,Brigham Young,52,45,231,22,20,312,0,0,Wyoming,0,32,112,27,15,113,2,1,V,14,52,13,119,-5,5,199,-2,-1,2009
1011,1011,11/07/2009,California,14,24,39,34,19,200,1,0,Oregon State,31,39,94,39,29,342,1,0,H,6.5,-17,-15,-55,-5,-10,-142,0,0,2009
1012,1012,11/07/2009,Cincinnati,47,36,231,37,29,480,0,0,Connecticut,45,37,201,33,19,261,0,0,H,16,2,-1,30,4,10,219,0,0,2009
1013,1013,11/07/2009,Clemson,40,37,241,30,18,242,1,1,Florida State,24,36,128,35,21,264,4,1,H,8.5,16,1,113,-5,-3,-22,-3,0,2009
1014,1014,11/07/2009,Colorado,35,43,166,32,21,271,1,0,Texas A+M,34,34,132,36,20,242,1,1,H,-3,1,9,34,-4,1,29,0,-1,2009
1015,1015,11/07/2009,Colorado State,16,45,201,39,22,223,1,0,Nevada-Las Vegas,35,34,174,20,11,147,0,0,V,-1.05,-19,11,27,19,11,76,1,0,2009
1016,1016,11/07/2009,Connecticut,45,37,201,33,19,261,0,0,Cincinnati,47,36,231,37,29,480,0,0,V,-16,-2,1,-30,-4,-10,-219,0,0,2009
1017,1017,11/07/2009,Duke,6,19,12,35,16,113,2,0,North Carolina,19,51,192,28,16,119,1,0,V,-10,-13,-32,-180,7,0,-6,1,0,2009
1018,1018,11/07/2009,Florida,27,37,148,23,18,227,0,0,Vanderbilt,3,27,99,29,13,100,1,0,H,34.5,24,10,49,-6,5,127,-1,0,2009
1019,1019,11/07/2009,Florida Atlantic,29,34,130,40,26,310,2,0,U-A-B,56,35,330,19,14,292,0,0,V,-7,-27,-1,-200,21,12,18,2,0,2009
1020,1020,11/07/2009,Florida Intl,21,44,146,38,14,178,3,1,Middle Tennessee,48,56,385,29,14,202,3,0,V,-12.5,-27,-12,-239,9,0,-24,0,1,2009
1021,1021,11/07/2009,Florida State,24,36,128,35,21,264,4,1,Clemson,40,37,241,30,18,242,1,1,V,-8.5,-16,-1,-113,5,3,22,3,0,2009
1022,1022,11/07/2009,Fresno State,31,42,181,14,14,159,0,1,Idaho,21,30,230,25,12,240,0,1,V,8,10,12,-49,-11,2,-81,0,0,2009
1023,1023,11/07/2009,Georgia,38,39,304,18,14,165,1,0,Tennessee Tech,0,31,-13,16,11,68,0,0,H, ,38,8,317,2,3,97,1,0,2009
1024,1024,11/07/2009,Georgia Tech,30,62,412,14,4,51,1,0,Wake Forest,27,25,28,40,26,263,0,0,H,14,3,37,384,-26,-22,-212,1,0,2009
1025,1025,11/07/2009,Hawaii,49,37,360,38,21,337,2,0,Utah State,36,39,102,38,25,344,2,0,H,-2,13,-2,258,0,-4,-7,0,0,2009
1026,1026,11/07/2009,Houston,46,40,173,60,40,522,0,2,Tulsa,45,42,200,26,19,334,2,2,V,2,1,-2,-27,34,21,188,-2,0,2009
1027,1027,11/07/2009,Idaho,21,30,230,25,12,240,0,1,Fresno State,31,42,181,14,14,159,0,1,H,-8,-10,-12,49,11,-2,81,0,0,2009
1028,1028,11/07/2009,Illinois,35,42,113,25,15,238,0,1,Minnesota,32,36,50,31,14,221,1,1,V,-6.5,3,6,63,-6,1,17,-1,0,2009
1029,1029,11/07/2009,Indiana,28,26,63,35,25,323,2,0,Wisconsin,31,52,294,20,11,194,0,1,H,-13.5,-3,-26,-231,15,14,129,2,-1,2009
1030,1030,11/07/2009,Iowa,10,27,65,36,13,216,2,2,Northwestern,17,49,130,27,15,109,1,0,H,14,-7,-22,-65,9,-2,107,1,2,2009
1031,1031,11/07/2009,Iowa State,8,26,54,28,14,188,3,0,Oklahoma State,34,54,331,24,19,142,0,0,H,-8,-26,-28,-277,4,-5,46,3,0,2009
1032,1032,11/07/2009,Kansas,10,23,60,41,27,241,1,2,Kansas State,17,43,266,16,7,66,0,0,V,1,-7,-20,-206,25,20,175,1,2,2009
1033,1033,11/07/2009,Kansas State,17,43,266,16,7,66,0,0,Kansas,10,23,60,41,27,241,1,2,H,-1,7,20,206,-25,-20,-175,-1,-2,2009
1034,1034,11/07/2009,Kent State,20,21,38,59,30,377,2,0,Akron,28,40,168,35,19,261,1,0,V,4,-8,-19,-130,24,11,116,1,0,2009
1035,1035,11/07/2009,Kentucky,37,44,234,35,23,210,0,0,Eastern Kentucky,12,32,127,29,9,137,2,0,H, ,25,12,107,6,14,73,-2,0,2009
1036,1036,11/07/2009,Louisiana State,15,29,95,27,14,158,1,0,Alabama,24,38,176,34,19,276,1,0,V,-7,-9,-9,-81,-7,-5,-118,0,0,2009
1037,1037,11/07/2009,Louisville,9,43,201,26,14,100,0,1,West Virginia,17,39,173,18,10,100,1,1,V,-17.5,-8,4,28,8,4,0,-1,0,2009
1038,1038,11/07/2009,Maryland,31,27,108,33,17,162,1,0,No Carolina State,38,41,139,38,25,343,3,1,V,-6.5,-7,-14,-31,-5,-8,-181,-2,-1,2009
1039,1039,11/07/2009,Memphis,28,44,209,31,19,194,1,2,Tennessee,56,33,137,38,26,429,1,1,V,-25.5,-28,11,72,-7,-7,-235,0,1,2009
1040,1040,11/07/2009,Miami-Florida,52,49,268,34,19,247,1,0,Virginia,17,24,74,29,11,75,1,0,H,14.5,35,25,194,5,8,172,0,0,2009
1041,1041,11/07/2009,Michigan,36,44,215,24,15,212,0,1,Purdue,38,29,127,39,28,367,2,0,H,7,-2,15,88,-15,-13,-155,-2,1,2009
1042,1042,11/07/2009,Michigan State,49,43,219,35,28,383,0,0,Western Michigan,14,16,94,39,16,117,0,1,H,20.5,35,27,125,-4,12,266,0,-1,2009
1043,1043,11/07/2009,Middle Tennessee,48,56,385,29,14,202,3,0,Florida Intl,21,44,146,38,14,178,3,1,H,12.5,27,12,239,-9,0,24,0,-1,2009
1044,1044,11/07/2009,Minnesota,32,36,50,31,14,221,1,1,Illinois,35,42,113,25,15,238,0,1,H,6.5,-3,-6,-63,6,-1,-17,1,0,2009
1045,1045,11/07/2009,Mississippi,38,35,161,33,17,264,0,1,Northern Arizona,14,40,121,32,20,233,1,0,H, ,24,-5,40,1,-3,31,-1,1,2009
1046,1046,11/07/2009,Missouri,32,25,10,52,30,468,0,0,Baylor,40,28,38,43,32,427,0,0,H,15,-8,-3,-28,9,-2,41,0,0,2009
1047,1047,11/07/2009,Navy,23,57,348,3,2,56,0,0,Notre Dame,21,20,60,51,37,452,1,2,V,-13,2,37,288,-48,-35,-396,-1,-2,2009
1048,1048,11/07/2009,Nebraska,10,43,141,14,7,39,0,1,Oklahoma,3,29,80,58,26,245,5,0,H,-4.5,7,14,61,-44,-19,-206,-5,1,2009
1049,1049,11/07/2009,Nevada-Las Vegas,35,34,174,20,11,147,0,0,Colorado State,16,45,201,39,22,223,1,0,H,1.05,19,-11,-27,-19,-11,-76,-1,0,2009
1050,1050,11/07/2009,New Mexico,14,29,82,42,21,252,2,0,Utah,45,47,251,31,19,306,1,1,V,-27.5,-31,-18,-169,11,2,-54,1,-1,2009
1051,1051,11/07/2009,No Carolina State,38,41,139,38,25,343,3,1,Maryland,31,27,108,33,17,162,1,0,H,6.5,7,14,31,5,8,181,2,1,2009
1052,1052,11/07/2009,North Carolina,19,51,192,28,16,119,1,0,Duke,6,19,12,35,16,113,2,0,H,10,13,32,180,-7,0,6,-1,0,2009
1053,1053,11/07/2009,North Texas,6,28,79,37,21,189,3,0,UL-Monroe,33,41,172,22,14,282,1,0,H,-3,-27,-13,-93,15,7,-93,2,0,2009
1054,1054,11/07/2009,Northwestern,17,49,130,27,15,109,1,0,Iowa,10,27,65,36,13,216,2,2,V,-14,7,22,65,-9,2,-107,-1,-2,2009
1055,1055,11/07/2009,Notre Dame,21,20,60,51,37,452,1,2,Navy,23,57,348,3,2,56,0,0,H,13,-2,-37,-288,48,35,396,1,2,2009
1056,1056,11/07/2009,Ohio State,24,49,228,17,8,125,0,0,Penn State,7,30,76,28,12,125,1,0,V,-5.5,17,19,152,-11,-4,0,-1,0,2009
1057,1057,11/07/2009,Oklahoma,3,29,80,58,26,245,5,0,Nebraska,10,43,141,14,7,39,0,1,V,4.5,-7,-14,-61,44,19,206,5,-1,2009
1058,1058,11/07/2009,Oklahoma State,34,54,331,24,19,142,0,0,Iowa State,8,26,54,28,14,188,3,0,V,8,26,28,277,-4,5,-46,-3,0,2009
1059,1059,11/07/2009,Oregon,42,34,236,37,21,334,0,1,Stanford,51,52,254,20,12,251,0,1,V,7,-9,-18,-18,17,9,83,0,0,2009
1060,1060,11/07/2009,Oregon State,31,39,94,39,29,342,1,0,California,14,24,39,34,19,200,1,0,V,-6.5,17,15,55,5,10,142,0,0,2009
1061,1061,11/07/2009,Penn State,7,30,76,28,12,125,1,0,Ohio State,24,49,228,17,8,125,0,0,H,5.5,-17,-19,-152,11,4,0,1,0,2009
1062,1062,11/07/2009,Pittsburgh,37,40,247,25,17,234,0,1,Syracuse,10,32,144,34,17,141,3,0,H,21.5,27,8,103,-9,0,93,-3,1,2009
1063,1063,11/07/2009,Purdue,38,29,127,39,28,367,2,0,Michigan,36,44,215,24,15,212,0,1,V,-7,2,-15,-88,15,13,155,2,-1,2009
1064,1064,11/07/2009,Rice,28,30,77,44,29,250,0,3,S-M-U,31,34,96,24,17,234,1,1,V,-19,-3,-4,-19,20,12,16,-1,2,2009
1065,1065,11/07/2009,S-M-U,31,34,96,24,17,234,1,1,Rice,28,30,77,44,29,250,0,3,H,19,3,4,19,-20,-12,-16,1,-2,2009
1066,1066,11/07/2009,San Diego State,12,25,92,37,17,187,2,2,Texas Christian,55,53,312,20,14,239,0,0,H,-24.5,-43,-28,-220,17,3,-52,2,2,2009
1067,1067,11/07/2009,South Carolina,16,25,53,34,20,327,1,0,Arkansas,33,36,76,27,23,329,0,0,V,-7.5,-17,-11,-23,7,-3,-2,1,0,2009
1068,1068,11/07/2009,Southern Cal,14,33,146,22,7,112,1,0,Arizona State,9,33,81,50,23,266,3,1,V,10.5,5,0,65,-28,-16,-154,-2,-1,2009
1069,1069,11/07/2009,Stanford,51,52,254,20,12,251,0,1,Oregon,42,34,236,37,21,334,0,1,H,-7,9,18,18,-17,-9,-83,0,0,2009
1070,1070,11/07/2009,Syracuse,10,32,144,34,17,141,3,0,Pittsburgh,37,40,247,25,17,234,0,1,V,-21.5,-27,-8,-103,9,0,-93,3,-1,2009
1071,1071,11/07/2009,Tennessee,56,33,137,38,26,429,1,1,Memphis,28,44,209,31,19,194,1,2,H,25.5,28,-11,-72,7,7,235,0,-1,2009
1072,1072,11/07/2009,Texas,35,25,67,42,33,470,1,0,U-C-F,3,38,75,19,10,76,0,0,H,35.5,32,-13,-8,23,23,394,1,0,2009
1073,1073,11/07/2009,Texas A+M,34,34,132,36,20,242,1,1,Colorado,35,43,166,32,21,271,1,0,V,3,-1,-9,-34,4,-1,-29,0,1,2009
1074,1074,11/07/2009,Texas Christian,55,53,312,20,14,239,0,0,San Diego State,12,25,92,37,17,187,2,2,V,24.5,43,28,220,-17,-3,52,-2,-2,2009
1075,1075,11/07/2009,Troy,40,33,201,37,23,276,0,0,Western Kentucky,20,39,226,35,20,196,0,1,V,24,20,-6,-25,2,3,80,0,-1,2009
1076,1076,11/07/2009,Tulane,45,40,167,37,24,278,0,0,UTEP,38,47,260,26,12,226,0,0,H,-7,7,-7,-93,11,12,52,0,0,2009
1077,1077,11/07/2009,Tulsa,45,42,200,26,19,334,2,2,Houston,46,40,173,60,40,522,0,2,H,-2,-1,2,27,-34,-21,-188,2,0,2009
1078,1078,11/07/2009,U-A-B,56,35,330,19,14,292,0,0,Florida Atlantic,29,34,130,41,27,332,2,0,H,7,27,1,200,-22,-13,-40,-2,0,2009
1079,1079,11/07/2009,U-C-F,3,38,75,19,10,76,0,0,Texas,35,25,67,42,33,470,1,0,V,-35.5,-32,13,8,-23,-23,-394,-1,0,2009
1080,1080,11/07/2009,U.C.L.A.,24,40,84,31,23,371,2,3,Washington,23,25,152,40,23,235,1,0,H,5,1,15,-68,-9,0,136,1,3,2009
1081,1081,11/07/2009,UL-Lafayette,21,39,147,40,28,229,0,2,Arkansas State,18,28,57,24,11,182,2,1,V,-13.5,3,11,90,16,17,47,-2,1,2009
1082,1082,11/07/2009,UL-Monroe,33,41,172,22,14,282,1,0,North Texas,6,28,79,37,21,189,3,0,V,3,27,13,93,-15,-7,93,-2,0,2009
1083,1083,11/07/2009,UTEP,38,47,260,27,13,248,0,0,Tulane,45,40,167,37,24,278,0,0,V,7,-7,7,93,-10,-11,-30,0,0,2009
1084,1084,11/07/2009,Utah,45,47,251,31,19,306,1,1,New Mexico,14,29,82,42,21,252,2,0,H,27.5,31,18,169,-11,-2,54,-1,1,2009
1085,1085,11/07/2009,Utah State,36,39,102,38,25,344,2,0,Hawaii,49,37,360,38,21,337,2,0,V,2,-13,2,-258,0,4,7,0,0,2009
1086,1086,11/07/2009,Vanderbilt,3,27,99,29,13,100,1,0,Florida,27,37,148,23,18,227,0,0,V,-34.5,-24,-10,-49,6,-5,-127,1,0,2009
1087,1087,11/07/2009,Virginia,17,24,74,29,11,75,1,0,Miami-Florida,52,49,268,34,19,247,1,0,V,-14.5,-35,-25,-194,-5,-8,-172,0,0,2009
1088,1088,11/07/2009,Wake Forest,27,25,28,40,26,263,0,0,Georgia Tech,30,62,412,14,4,51,1,0,V,-14,-3,-37,-384,26,22,212,-1,0,2009
1089,1089,11/07/2009,Washington,23,25,152,40,23,235,1,0,U.C.L.A.,24,40,84,31,23,371,2,3,V,-5,-1,-15,68,9,0,-136,-1,-3,2009
1090,1090,11/07/2009,Washington State,7,21,59,21,12,126,0,2,Arizona,48,54,294,24,15,177,0,0,V,-32.5,-41,-33,-235,-3,-3,-51,0,2,2009
1091,1091,11/07/2009,West Virginia,17,39,173,18,10,100,1,1,Louisville,9,43,201,26,14,100,0,1,H,17.5,8,-4,-28,-8,-4,0,1,0,2009
1092,1092,11/07/2009,Western Kentucky,20,39,226,35,20,196,0,1,Troy,40,33,201,37,23,276,0,0,H,-24,-20,6,25,-2,-3,-80,0,1,2009
1093,1093,11/07/2009,Western Michigan,14,16,94,39,16,117,0,1,Michigan State,49,43,219,35,28,383,0,0,V,-20.5,-35,-27,-125,4,-12,-266,0,1,2009
1094,1094,11/07/2009,Wisconsin,31,52,294,20,11,194,0,1,Indiana,28,26,63,35,25,323,2,0,V,13.5,3,26,231,-15,-14,-129,-2,1,2009
1095,1095,11/07/2009,Wyoming,0,32,112,27,15,113,2,1,Brigham Young,52,45,231,22,20,312,0,0,H,-14,-52,-13,-119,5,-5,-199,2,1,2009
1096,1096,11/08/2009,Nevada-Reno,62,59,517,17,11,148,0,0,San Jose State,7,22,30,30,21,238,1,1,V,13.5,55,37,487,-13,-10,-90,-1,-1,2009
1097,1097,11/08/2009,San Jose State,7,22,30,30,21,238,1,1,Nevada-Reno,62,59,517,17,11,148,0,0,H,-13.5,-55,-37,-487,13,10,90,1,1,2009
1098,1098,11/10/2009,Buffalo,24,27,125,44,20,316,2,1,Ohio,27,33,115,29,23,269,1,1,H,1,-3,-6,10,15,-3,47,1,0,2009
1099,1099,11/10/2009,Ohio,27,33,115,29,23,269,1,1,Buffalo,24,27,125,44,20,316,2,1,V,-1,3,6,-10,-15,3,-47,-1,0,2009
1100,1100,11/11/2009,Central Michigan,56,38,166,37,29,341,0,0,Toledo,28,36,131,33,21,222,4,1,H,17.5,28,2,35,4,8,119,-4,-1,2009
1101,1101,11/11/2009,Toledo,28,36,131,33,21,222,4,1,Central Michigan,56,38,166,37,29,341,0,0,V,-17.5,-28,-2,-35,-4,-8,-119,4,1,2009
1102,1102,11/12/2009,Ball State,20,40,149,19,11,134,0,1,Northern Illinois,26,37,134,14,13,91,1,0,V,-16,-6,3,15,5,-2,43,-1,1,2009
1103,1103,11/12/2009,Bowling Green,35,34,146,35,22,203,0,2,Miami-Ohio,14,27,36,48,29,259,3,2,V,4.5,21,7,110,-13,-7,-56,-3,0,2009
1104,1104,11/12/2009,Miami-Ohio,14,27,36,48,29,259,3,2,Bowling Green,35,34,146,35,22,203,0,2,H,-4.5,-21,-7,-110,13,7,56,3,0,2009
1105,1105,11/12/2009,Northern Illinois,26,37,134,14,13,91,1,0,Ball State,20,40,149,19,11,134,0,1,H,16,6,-3,-15,-5,2,-43,1,-1,2009
1106,1106,11/12/2009,Rutgers,31,42,160,30,15,194,1,0,South Florida,0,32,30,17,7,129,2,2,H,1.5,31,10,130,13,8,65,-1,-2,2009
1107,1107,11/12/2009,South Florida,0,32,30,17,7,129,2,2,Rutgers,31,42,160,30,15,194,1,0,V,-1.5,-31,-10,-130,-13,-8,-65,1,2,2009
1108,1108,11/13/2009,Akron,17,29,112,34,19,135,1,1,Temple,56,54,258,12,6,145,1,1,H,-6,-39,-25,-146,22,13,-10,0,0,2009
1109,1109,11/13/2009,Cincinnati,24,30,216,28,19,221,1,1,West Virginia,21,46,202,25,17,188,0,0,H,10,3,-16,14,3,2,33,1,1,2009
1110,1110,11/13/2009,Temple,56,54,258,12,6,145,1,1,Akron,17,29,112,34,19,135,1,1,V,6,39,25,146,-22,-13,10,0,0,2009
1111,1111,11/13/2009,West Virginia,21,46,202,25,17,188,0,0,Cincinnati,24,30,216,28,19,221,1,1,V,-10,-3,16,-14,-3,-2,-33,-1,-1,2009
1112,1112,11/14/2009,Air Force,45,71,431,13,8,126,0,1,Nevada-Las Vegas,17,39,147,23,13,135,1,0,H,17,28,32,284,-10,-5,-9,-1,1,2009
1113,1113,11/14/2009,Alabama,31,40,252,18,13,192,0,0,Mississippi State,3,37,114,20,9,99,3,0,V,11,28,3,138,-2,4,93,-3,0,2009
1114,1114,11/14/2009,Arizona,16,28,73,41,25,201,1,1,California,24,40,176,22,13,181,2,0,V,-3,-8,-12,-103,19,12,20,-1,1,2009
1115,1115,11/14/2009,Arizona State,21,38,84,32,18,127,1,0,Oregon,44,42,268,20,10,120,1,1,V,-21,-23,-4,-184,12,8,7,0,-1,2009
1116,1116,11/14/2009,Arkansas,56,35,187,30,23,405,1,0,Troy,20,24,102,54,32,353,3,1,H,14,36,11,85,-24,-9,52,-2,-1,2009
1117,1117,11/14/2009,Arkansas State,18,36,176,27,20,168,0,0,Florida Atlantic,35,34,154,27,18,242,0,0,V,3,-17,2,22,0,2,-74,0,0,2009
1118,1118,11/14/2009,Army,22,47,186,14,11,174,0,4,Virginia Military,17,57,328,6,2,19,0,2,H, ,5,-10,-142,8,9,155,0,2,2009
1119,1119,11/14/2009,Auburn,24,38,115,28,20,238,2,0,Georgia,31,38,169,17,9,173,0,0,V,-4,-7,0,-54,11,11,65,2,0,2009
1120,1120,11/14/2009,Baylor,14,28,6,45,28,240,3,0,Texas,47,35,224,40,25,187,0,1,H,-23,-33,-7,-218,5,3,53,3,-1,2009
1121,1121,11/14/2009,Boise State,63,26,147,33,23,310,0,0,Idaho,25,46,209,27,17,305,5,2,H,32,38,-20,-62,6,6,5,-5,-2,2009
1122,1122,11/14/2009,Boston College,14,45,156,26,12,147,2,0,Virginia,10,28,77,41,21,221,1,0,V,4.5,4,17,79,-15,-9,-74,1,0,2009
1123,1123,11/14/2009,Brigham Young,24,23,41,33,21,314,1,1,New Mexico,19,36,88,45,28,272,0,0,V,27.5,5,-13,-47,-12,-7,42,1,1,2009
1124,1124,11/14/2009,California,24,40,176,22,13,181,2,0,Arizona,16,28,73,41,25,201,1,1,H,3,8,12,103,-19,-12,-20,1,-1,2009
1125,1125,11/14/2009,Clemson,43,36,254,19,13,200,0,0,No Carolina State,23,41,138,39,16,239,1,0,V,8,20,-5,116,-20,-3,-39,-1,0,2009
1126,1126,11/14/2009,Colorado,10,35,132,38,18,258,1,2,Iowa State,17,46,194,26,12,116,1,1,V,-4.5,-7,-11,-62,12,6,142,0,1,2009
1127,1127,11/14/2009,Duke,10,24,25,41,27,256,1,0,Georgia Tech,49,52,306,11,7,213,0,1,H,-14,-39,-28,-281,30,20,43,1,-1,2009
1128,1128,11/14/2009,Eastern Michigan,14,43,178,26,15,186,3,3,Western Michigan,35,36,164,33,21,275,1,1,H,-13.5,-21,7,14,-7,-6,-89,2,2,2009
1129,1129,11/14/2009,Florida,24,39,140,25,14,199,0,0,South Carolina,14,33,61,33,17,186,2,1,V,16.5,10,6,79,-8,-3,13,-2,-1,2009
1130,1130,11/14/2009,Florida Atlantic,35,34,154,27,18,242,0,0,Arkansas State,18,36,176,27,20,168,0,0,H,-3,17,-2,-22,0,-2,74,0,0,2009
1131,1131,11/14/2009,Florida Intl,35,33,173,18,12,85,0,0,North Texas,28,45,199,37,28,314,1,1,H,3.5,7,-12,-26,-19,-16,-229,-1,-1,2009
1132,1132,11/14/2009,Florida State,41,43,217,20,15,220,1,0,Wake Forest,28,29,227,40,25,227,2,0,V,-4.5,13,14,-10,-20,-10,-7,-1,0,2009
1133,1133,11/14/2009,Fresno State,14,35,112,35,24,362,1,4,Nevada-Reno,52,50,461,12,6,45,0,0,V,-7,-38,-15,-349,23,18,317,1,4,2009
1134,1134,11/14/2009,Georgia,31,38,169,17,9,173,0,0,Auburn,24,38,115,28,20,238,2,0,H,4,7,0,54,-11,-11,-65,-2,0,2009
1135,1135,11/14/2009,Georgia Tech,49,52,306,11,7,213,0,1,Duke,10,24,25,41,27,256,1,0,V,14,39,28,281,-30,-20,-43,-1,1,2009
1136,1136,11/14/2009,Hawaii,24,26,119,49,28,366,1,0,New Mexico State,6,23,133,21,12,111,2,0,H,19,18,3,-14,28,16,255,-1,0,2009
1137,1137,11/14/2009,Houston,32,15,46,57,33,379,1,2,U-C-F,37,50,152,25,21,241,1,1,V,4,-5,-35,-106,32,12,138,0,1,2009
1138,1138,11/14/2009,Idaho,25,46,209,27,17,305,5,2,Boise State,63,26,148,33,23,310,0,0,V,-32,-38,20,61,-6,-6,-5,5,2,2009
1139,1139,11/14/2009,Illinois,16,45,212,29,15,162,2,0,Northwestern,21,42,139,37,23,305,0,0,H,6.5,-5,3,73,-8,-8,-143,2,0,2009
1140,1140,11/14/2009,Indiana,20,24,48,52,32,298,1,0,Penn State,31,39,181,29,17,194,2,2,V,-24,-11,-15,-133,23,15,104,-1,-2,2009
1141,1141,11/14/2009,Iowa,24,24,67,33,20,233,3,0,Ohio State,27,51,229,17,14,93,0,0,V,-16.5,-3,-27,-162,16,6,140,3,0,2009
1142,1142,11/14/2009,Iowa State,17,46,194,26,12,116,1,1,Colorado,10,35,132,38,18,258,1,2,H,4.5,7,11,62,-12,-6,-142,0,-1,2009
1143,1143,11/14/2009,Kansas,17,29,99,41,19,236,0,1,Nebraska,31,42,214,21,13,196,0,0,H,-3.5,-14,-13,-115,20,6,40,0,1,2009
1144,1144,11/14/2009,Kansas State,12,43,112,31,21,239,1,2,Missouri,38,24,135,27,20,298,0,0,H,-1.5,-26,19,-23,4,1,-59,1,2,2009
1145,1145,11/14/2009,Kentucky,24,58,308,15,7,91,2,0,Vanderbilt,13,34,82,24,11,127,1,0,V,3.5,11,24,226,-9,-4,-36,1,0,2009
1146,1146,11/14/2009,Louisiana State,24,30,141,22,7,105,0,0,Louisiana Tech,16,51,178,33,17,144,0,0,H,22.5,8,-21,-37,-11,-10,-39,0,0,2009
1147,1147,11/14/2009,Louisiana Tech,16,51,178,33,17,144,0,0,Louisiana State,24,30,140,22,7,105,0,0,V,-22.5,-8,21,38,11,10,39,0,0,2009
1148,1148,11/14/2009,Louisville,10,35,34,18,9,117,1,0,Syracuse,9,47,156,21,14,110,1,1,H,7,1,-12,-122,-3,-5,7,0,-1,2009
1149,1149,11/14/2009,Marshall,20,26,26,52,29,337,2,1,Southern Miss,27,33,103,25,14,191,0,0,H,-3,-7,-7,-77,27,15,146,2,1,2009
1150,1150,11/14/2009,Maryland,9,31,132,33,12,104,0,0,Virginia Tech,36,49,216,23,13,268,0,1,H,-20,-27,-18,-84,10,-1,-164,0,-1,2009
1151,1151,11/14/2009,Memphis,21,32,104,42,27,332,0,2,U-A-B,31,42,111,26,19,376,0,1,H,-1.5,-10,-10,-7,16,8,-44,0,1,2009
1152,1152,11/14/2009,Miami-Florida,24,25,116,51,28,319,4,0,North Carolina,33,32,116,31,17,213,0,0,V,3,-9,-7,0,20,11,106,4,0,2009
1153,1153,11/14/2009,Michigan,24,32,71,31,21,194,1,0,Wisconsin,45,52,229,24,16,240,1,1,V,-8.5,-21,-20,-158,7,5,-46,0,-1,2009
1154,1154,11/14/2009,Michigan State,40,24,154,25,11,208,0,1,Purdue,37,37,151,55,39,373,0,1,V,3,3,-13,3,-30,-28,-165,0,0,2009
1155,1155,11/14/2009,Middle Tennessee,34,50,287,25,16,219,0,0,UL-Lafayette,17,32,73,43,25,220,1,1,H,14,17,18,214,-18,-9,-1,-1,-1,2009
1156,1156,11/14/2009,Minnesota,16,48,137,22,10,94,1,1,South Dakota State,13,27,46,39,15,183,2,2,H, ,3,21,91,-17,-5,-89,-1,-1,2009
1157,1157,11/14/2009,Mississippi,42,50,359,20,13,133,1,0,Tennessee,17,25,99,37,20,176,0,0,H,5.5,25,25,260,-17,-7,-43,1,0,2009
1158,1158,11/14/2009,Mississippi State,3,37,114,20,9,99,3,0,Alabama,31,40,252,18,13,192,0,0,H,-11,-28,-3,-138,2,-4,-93,3,0,2009
1159,1159,11/14/2009,Missouri,38,24,135,27,20,298,0,0,Kansas State,12,43,112,31,21,239,1,2,V,1.5,26,-19,23,-4,-1,59,-1,-2,2009
1160,1160,11/14/2009,Navy,35,51,242,6,4,78,0,1,Delaware,18,42,176,27,17,194,0,1,H, ,17,9,66,-21,-13,-116,0,0,2009
1161,1161,11/14/2009,Nebraska,31,42,214,21,13,196,0,0,Kansas,17,29,99,41,19,236,0,1,V,3.5,14,13,115,-20,-6,-40,0,-1,2009
1162,1162,11/14/2009,Nevada-Las Vegas,17,39,147,23,13,135,1,0,Air Force,45,71,431,13,8,126,0,1,V,-17,-28,-32,-284,10,5,9,1,-1,2009
1163,1163,11/14/2009,Nevada-Reno,52,50,461,12,6,45,0,0,Fresno State,14,35,112,35,24,362,1,4,H,7,38,15,349,-23,-18,-317,-1,-4,2009
1164,1164,11/14/2009,New Mexico,19,36,88,45,28,272,0,0,Brigham Young,24,23,41,33,21,314,1,1,H,-27.5,-5,13,47,12,7,-42,-1,-1,2009
1165,1165,11/14/2009,New Mexico State,6,23,133,21,12,111,2,0,Hawaii,24,26,119,49,28,366,1,0,V,-19,-18,-3,14,-28,-16,-255,1,0,2009
1166,1166,11/14/2009,No Carolina State,23,41,138,39,16,239,1,0,Clemson,43,36,254,19,13,200,0,0,H,-8,-20,5,-116,20,3,39,1,0,2009
1167,1167,11/14/2009,North Carolina,33,32,116,31,17,213,0,0,Miami-Florida,24,25,116,51,28,319,4,0,H,-3,9,7,0,-20,-11,-106,-4,0,2009
1168,1168,11/14/2009,North Texas,28,45,199,37,28,314,1,1,Florida Intl,35,33,173,18,12,85,0,0,V,-3.5,-7,12,26,19,16,229,1,1,2009
1169,1169,11/14/2009,Northwestern,21,42,139,37,23,305,0,0,Illinois,16,45,212,29,15,162,2,0,V,-6.5,5,-3,-73,8,8,143,-2,0,2009
1170,1170,11/14/2009,Notre Dame,22,25,66,42,27,283,1,1,Pittsburgh,27,32,193,27,15,236,0,0,V,-5.5,-5,-7,-127,15,12,47,1,1,2009
1171,1171,11/14/2009,Ohio State,27,51,229,17,14,93,0,0,Iowa,24,24,67,33,20,233,3,0,H,16.5,3,27,162,-16,-6,-140,-3,0,2009
1172,1172,11/14/2009,Oklahoma,65,45,248,39,24,392,1,0,Texas A+M,10,36,59,40,15,167,1,3,H,19.5,55,9,189,-1,9,225,0,-3,2009
1173,1173,11/14/2009,Oklahoma State,24,60,243,21,9,90,0,1,Texas Tech,17,14,50,58,35,307,3,0,H,4.5,7,46,193,-37,-26,-217,-3,1,2009
1174,1174,11/14/2009,Oregon,44,42,268,20,10,120,1,1,Arizona State,21,38,84,32,18,127,1,0,H,21,23,4,184,-12,-8,-7,0,1,2009
1175,1175,11/14/2009,Oregon State,48,37,178,31,22,194,0,1,Washington,21,30,121,23,14,153,1,1,H,13.5,27,7,57,8,8,41,-1,0,2009
1176,1176,11/14/2009,Penn State,31,39,181,29,17,194,2,2,Indiana,20,24,48,52,32,298,1,0,H,24,11,15,133,-23,-15,-104,1,2,2009
1177,1177,11/14/2009,Pittsburgh,27,32,193,27,15,236,0,0,Notre Dame,22,25,66,42,27,283,1,1,H,5.5,5,7,127,-15,-12,-47,-1,-1,2009
1178,1178,11/14/2009,Purdue,37,37,151,55,39,373,0,1,Michigan State,40,24,154,25,11,208,0,1,H,-3,-3,13,-3,30,28,165,0,0,2009
1179,1179,11/14/2009,Rice,28,32,117,24,15,214,0,0,Tulane,20,36,141,41,24,261,1,0,H,3,8,-4,-24,-17,-9,-47,-1,0,2009
1180,1180,11/14/2009,S-M-U,35,29,193,24,17,244,2,0,UTEP,31,42,231,41,23,396,1,0,H,6.5,4,-13,-38,-17,-6,-152,1,0,2009
1181,1181,11/14/2009,San Diego State,27,32,157,29,18,200,0,1,Wyoming,30,47,200,22,16,246,0,1,H,7,-3,-15,-43,7,2,-46,0,0,2009
1182,1182,11/14/2009,San Jose State,9,27,56,35,19,245,0,1,Utah State,24,52,381,19,7,50,0,1,V,-12.5,-15,-25,-325,16,12,195,0,0,2009
1183,1183,11/14/2009,South Carolina,14,33,61,33,17,186,2,1,Florida,24,39,140,25,14,199,0,0,H,-16.5,-10,-6,-79,8,3,-13,2,1,2009
1184,1184,11/14/2009,Southern Cal,21,27,138,31,21,196,3,1,Stanford,55,50,325,22,12,144,0,1,H,11.5,-34,-23,-187,9,9,52,3,0,2009
1185,1185,11/14/2009,Southern Miss,27,33,103,25,14,191,0,0,Marshall,20,26,26,52,29,337,2,1,V,3,7,7,77,-27,-15,-146,-2,-1,2009
1186,1186,11/14/2009,Stanford,55,50,325,22,12,144,0,1,Southern Cal,21,27,138,31,21,196,3,1,V,-11.5,34,23,187,-9,-9,-52,-3,0,2009
1187,1187,11/14/2009,Syracuse,9,47,156,21,14,110,1,1,Louisville,10,35,34,18,9,117,1,0,V,-7,-1,12,122,3,5,-7,0,1,2009
1188,1188,11/14/2009,Tennessee,17,25,99,37,20,176,0,0,Mississippi,42,49,360,21,14,132,1,0,V,-5.5,-25,-24,-261,16,6,44,-1,0,2009
1189,1189,11/14/2009,Texas,47,35,224,40,25,187,0,1,Baylor,14,28,6,45,28,240,3,0,V,23,33,7,218,-5,-3,-53,-3,1,2009
1190,1190,11/14/2009,Texas A+M,10,36,59,40,15,167,1,3,Oklahoma,65,45,248,39,24,392,1,0,V,-19.5,-55,-9,-189,1,-9,-225,0,3,2009
1191,1191,11/14/2009,Texas Christian,55,51,342,29,17,207,1,1,Utah,28,27,65,32,16,219,1,1,H,20,27,24,277,-3,1,-12,0,0,2009
1192,1192,11/14/2009,Texas Tech,17,14,50,58,35,307,3,0,Oklahoma State,24,60,243,21,9,90,0,1,V,-4.5,-7,-46,-193,37,26,217,3,-1,2009
1193,1193,11/14/2009,Troy,20,24,102,54,32,353,3,1,Arkansas,56,35,187,30,23,405,1,0,V,-14,-36,-11,-85,24,9,-52,2,1,2009
1194,1194,11/14/2009,Tulane,20,36,141,41,24,261,1,0,Rice,28,32,117,24,15,214,0,0,V,-3,-8,4,24,17,9,47,1,0,2009
1195,1195,11/14/2009,U-A-B,31,42,111,26,19,376,0,1,Memphis,21,33,103,41,26,333,0,2,V,1.5,10,9,8,-15,-7,43,0,-1,2009
1196,1196,11/14/2009,U-C-F,37,50,152,25,21,241,1,1,Houston,32,15,46,57,33,377,1,2,H,-4,5,35,106,-32,-12,-136,0,-1,2009
1197,1197,11/14/2009,U.C.L.A.,43,37,232,45,29,324,0,1,Washington State,7,27,73,20,9,108,3,1,V,17.5,36,10,159,25,20,216,-3,0,2009
1198,1198,11/14/2009,UL-Lafayette,17,32,73,43,25,220,1,1,Middle Tennessee,34,50,287,25,16,219,0,0,V,-14,-17,-18,-214,18,9,1,1,1,2009
1199,1199,11/14/2009,UL-Monroe,21,41,290,19,10,151,2,1,Western Kentucky,18,37,195,36,18,188,0,0,H,22,3,4,95,-17,-8,-37,2,1,2009
1200,1200,11/14/2009,UTEP,31,42,231,41,23,396,1,0,S-M-U,35,29,193,24,17,244,2,0,V,-6.5,-4,13,38,17,6,152,-1,0,2009
1201,1201,11/14/2009,Utah,28,27,65,32,16,219,1,1,Texas Christian,55,51,342,29,17,207,1,1,V,-20,-27,-24,-277,3,-1,12,0,0,2009
1202,1202,11/14/2009,Utah State,24,52,381,19,7,50,0,1,San Jose State,9,27,56,35,19,245,0,1,H,12.5,15,25,325,-16,-12,-195,0,0,2009
1203,1203,11/14/2009,Vanderbilt,13,34,82,24,11,127,1,0,Kentucky,24,58,308,15,7,91,2,0,H,-3.5,-11,-24,-226,9,4,36,-1,0,2009
1204,1204,11/14/2009,Virginia,10,28,77,41,21,221,1,0,Boston College,14,45,156,26,12,147,2,0,H,-4.5,-4,-17,-79,15,9,74,-1,0,2009
1205,1205,11/14/2009,Virginia Tech,36,49,216,23,13,268,0,1,Maryland,9,31,132,33,12,104,0,0,V,20,27,18,84,-10,1,164,0,1,2009
1206,1206,11/14/2009,Wake Forest,28,29,227,40,25,227,2,0,Florida State,41,43,217,20,15,220,1,0,H,4.5,-13,-14,10,20,10,7,1,0,2009
1207,1207,11/14/2009,Washington,21,30,121,23,14,153,1,1,Oregon State,48,37,178,31,22,194,0,1,V,-13.5,-27,-7,-57,-8,-8,-41,1,0,2009
1208,1208,11/14/2009,Washington State,7,27,73,20,9,108,3,1,U.C.L.A.,43,37,232,45,29,324,0,1,H,-17.5,-36,-10,-159,-25,-20,-216,3,0,2009
1209,1209,11/14/2009,Western Kentucky,18,37,195,36,18,188,0,0,UL-Monroe,21,41,290,19,10,151,2,1,V,-22,-3,-4,-95,17,8,37,-2,-1,2009
1210,1210,11/14/2009,Western Michigan,35,36,164,33,21,275,1,1,Eastern Michigan,14,43,178,26,15,186,3,3,V,13.5,21,-7,-14,7,6,89,-2,-2,2009
1211,1211,11/14/2009,Wisconsin,45,52,229,24,16,240,1,1,Michigan,24,32,71,31,21,194,1,0,H,8.5,21,20,158,-7,-5,46,0,1,2009
1212,1212,11/14/2009,Wyoming,30,47,200,22,16,246,0,1,San Diego State,27,32,157,29,18,200,0,1,V,-7,3,15,43,-7,-2,46,0,0,2009
1213,1213,11/15/2009,East Carolina,44,48,242,29,20,275,0,1,Tulsa,17,31,30,46,23,236,2,2,V,-4,27,17,212,-17,-3,39,-2,-1,2009
1214,1214,11/15/2009,Tulsa,17,31,30,46,23,236,2,2,East Carolina,44,48,242,29,20,277,0,1,H,4,-27,-17,-212,17,3,-41,2,1,2009
1215,1215,11/18/2009,Ball State,3,35,126,17,10,105,1,1,Central Michigan,35,44,168,28,25,344,0,2,H,-15,-32,-9,-42,-11,-15,-239,1,-1,2009
1216,1216,11/18/2009,Buffalo,42,31,240,20,14,166,0,0,Miami-Ohio,17,35,90,57,35,295,1,1,V,4.5,25,-4,150,-37,-21,-129,-1,-1,2009
1217,1217,11/18/2009,Central Michigan,35,44,168,28,25,344,0,2,Ball State,3,35,126,17,10,105,1,1,V,15,32,9,42,11,15,239,-1,1,2009
1218,1218,11/18/2009,Miami-Ohio,17,35,90,57,35,295,1,1,Buffalo,42,31,240,20,14,166,0,0,H,-4.5,-25,4,-150,37,21,129,1,1,2009
1219,1219,11/19/2009,Colorado,28,22,13,49,30,240,0,1,Oklahoma State,31,49,232,24,10,168,1,3,V,-17,-3,-27,-219,25,20,72,-1,-2,2009
1220,1220,11/19/2009,Oklahoma State,31,49,232,24,10,168,1,3,Colorado,28,22,13,49,30,240,0,1,H,17,3,27,219,-25,-20,-72,1,2,2009
1221,1221,11/20/2009,Akron,20,30,171,32,22,259,0,1,Bowling Green,36,33,136,32,23,338,0,0,V,-12,-16,-3,35,0,-1,-79,0,1,2009
1222,1222,11/20/2009,Boise State,52,43,323,30,16,249,0,0,Utah State,21,39,137,31,19,226,1,1,V,23,31,4,186,-1,-3,23,-1,-1,2009
1223,1223,11/20/2009,Bowling Green,36,33,136,32,23,338,0,0,Akron,20,30,171,32,22,259,0,1,H,12,16,3,-35,0,1,79,0,-1,2009
1224,1224,11/20/2009,Eastern Michigan,21,26,74,25,13,195,2,2,Toledo,47,51,330,18,11,122,1,0,V,-16,-26,-25,-256,7,2,73,1,2,2009
1225,1225,11/20/2009,Toledo,47,51,330,18,11,122,1,0,Eastern Michigan,21,26,74,25,13,195,2,2,H,16,26,25,256,-7,-2,-73,-1,-2,2009
1226,1226,11/20/2009,Utah State,21,39,137,31,19,226,1,1,Boise State,52,43,323,30,16,249,0,0,H,-23,-31,-4,-186,1,3,-23,1,1,2009
1227,1227,11/21/2009,Air Force,21,56,212,22,5,88,2,2,Brigham Young,38,25,121,45,33,377,2,1,V,-9.5,-17,31,91,-23,-28,-289,0,1,2009
1228,1228,11/21/2009,Alabama,45,56,313,16,10,109,0,0,Chattanooga,0,21,48,27,7,36,3,0,H, ,45,35,265,-11,3,73,-3,0,2009
1229,1229,11/21/2009,Arizona,41,35,126,47,30,315,1,1,Oregon,44,37,175,47,26,284,1,0,H,-5.5,-3,-2,-49,0,4,31,0,1,2009
1230,1230,11/21/2009,Arizona State,13,33,118,22,15,197,1,5,U.C.L.A.,23,36,131,32,16,161,0,0,V,-4.5,-10,-3,-13,-10,-1,36,1,5,2009
1231,1231,11/21/2009,Arkansas,42,27,83,34,18,313,2,0,Mississippi State,21,55,327,13,8,49,0,2,H,12,21,-28,-244,21,10,264,2,-2,2009
1232,1232,11/21/2009,Arkansas State,14,36,44,28,13,176,1,1,Middle Tennessee,38,44,164,28,15,263,1,1,V,-10,-24,-8,-120,0,-2,-87,0,0,2009
1233,1233,11/21/2009,Army,17,46,200,15,7,87,0,0,North Texas,13,30,222,41,31,225,3,2,V,-1,4,16,-22,-26,-24,-138,-3,-2,2009
1234,1234,11/21/2009,Baylor,3,26,82,38,24,215,3,0,Texas A+M,38,52,375,25,19,153,0,1,V,-5.5,-35,-26,-293,13,5,62,3,-1,2009
1235,1235,11/21/2009,Boston College,13,30,97,30,12,101,5,1,North Carolina,31,38,96,34,23,182,3,1,H,2.5,-18,-8,1,-4,-11,-81,2,0,2009
1236,1236,11/21/2009,Brigham Young,38,25,121,45,33,377,2,1,Air Force,21,56,212,22,5,88,2,2,H,9.5,17,-31,-91,23,28,289,0,-1,2009
1237,1237,11/21/2009,California,34,57,242,31,17,235,1,0,Stanford,28,28,187,30,10,158,1,0,V,-7,6,29,55,1,7,77,0,0,2009
1238,1238,11/21/2009,Clemson,34,38,132,26,19,234,0,0,Virginia,21,40,78,19,13,195,0,2,H,21,13,-2,54,7,6,39,0,-2,2009
1239,1239,11/21/2009,Colorado State,27,36,197,17,12,173,1,2,New Mexico,29,35,270,38,22,197,2,0,V,4,-2,1,-73,-21,-10,-24,-1,2,2009
1240,1240,11/21/2009,Connecticut,33,48,231,25,12,141,1,0,Notre Dame,30,35,123,45,30,329,0,2,V,-6.5,3,13,108,-20,-18,-188,1,-2,2009
1241,1241,11/21/2009,Duke,16,22,55,37,20,303,1,1,Miami-Florida,34,44,148,43,25,348,1,1,V,-19.5,-18,-22,-93,-6,-5,-45,0,0,2009
1242,1242,11/21/2009,East Carolina,37,24,75,26,20,250,0,0,U-A-B,21,49,273,27,19,247,1,1,H,14,16,-25,-198,-1,1,3,-1,-1,2009
1243,1243,11/21/2009,Florida,62,36,223,38,26,361,0,0,Florida Intl,3,30,53,26,10,136,1,0,H,47.5,59,6,170,12,16,225,-1,0,2009
1244,1244,11/21/2009,Florida Atlantic,21,34,142,36,23,206,0,1,Troy,47,31,168,40,28,483,1,2,V,-16.5,-26,3,-26,-4,-5,-277,-1,-1,2009
1245,1245,11/21/2009,Florida Intl,3,30,53,26,10,136,1,0,Florida,62,36,223,38,26,361,0,0,V,-47.5,-59,-6,-170,-12,-16,-225,1,0,2009
1246,1246,11/21/2009,Florida State,29,24,198,27,17,206,3,0,Maryland,26,46,196,27,20,214,0,1,H,17,3,-22,2,0,-3,-8,3,-1,2009
1247,1247,11/21/2009,Fresno State,30,44,176,42,17,182,0,0,Louisiana Tech,28,38,230,22,14,206,0,3,H,9,2,6,-54,20,3,-24,0,-3,2009
1248,1248,11/21/2009,Georgia,27,44,196,30,12,291,2,2,Kentucky,34,41,123,17,9,137,0,0,H,9.5,-7,3,73,13,3,154,2,2,2009
1249,1249,11/21/2009,Hawaii,17,30,106,47,28,299,0,2,San Jose State,10,31,132,25,15,145,3,1,V,2.5,7,-1,-26,22,13,154,-3,1,2009
1250,1250,11/21/2009,Houston,55,24,111,55,42,578,0,0,Memphis,14,45,243,28,15,101,1,0,H,22,41,-21,-132,27,27,477,-1,0,2009
1251,1251,11/21/2009,Indiana,21,36,196,39,23,266,2,2,Purdue,38,33,124,29,21,205,0,0,H,-2.5,-17,3,72,10,2,61,2,2,2009
1252,1252,11/21/2009,Iowa,12,36,54,24,11,117,1,1,Minnesota,0,36,48,42,14,153,1,2,H,12.5,12,0,6,-18,-3,-36,0,-1,2009
1253,1253,11/21/2009,Iowa State,24,28,77,41,29,259,2,0,Missouri,34,50,202,32,23,337,0,1,V,-15,-10,-22,-125,9,6,-78,2,-1,2009
1254,1254,11/21/2009,Kansas,20,26,47,39,25,256,1,0,Texas,51,40,136,42,32,396,0,1,V,-27.5,-31,-14,-89,-3,-7,-140,1,-1,2009
1255,1255,11/21/2009,Kansas State,3,34,140,33,12,153,1,1,Nebraska,17,45,101,19,13,166,1,0,V,-16.5,-14,-11,39,14,-1,-13,0,1,2009
1256,1256,11/21/2009,Kent State,13,30,64,41,21,256,2,1,Temple,47,38,275,17,6,124,1,0,V,-10.5,-34,-8,-211,24,15,132,1,1,2009
1257,1257,11/21/2009,Kentucky,34,41,123,17,9,137,0,0,Georgia,27,44,196,30,12,281,2,2,V,-9.5,7,-3,-73,-13,-3,-144,-2,-2,2009
1258,1258,11/21/2009,Louisiana State,23,27,40,37,19,250,1,0,Mississippi,25,45,193,22,15,233,0,0,V,-4.5,-2,-18,-153,15,4,17,1,0,2009
1259,1259,11/21/2009,Louisiana Tech,28,38,230,22,14,206,0,3,Fresno State,30,44,176,42,17,182,0,0,V,-9,-2,-6,54,-20,-3,24,0,3,2009
1260,1260,11/21/2009,Louisville,22,24,81,35,20,232,1,0,South Florida,34,45,234,35,20,304,0,1,V,-13,-12,-21,-153,0,0,-72,1,-1,2009
1261,1261,11/21/2009,Marshall,34,51,262,22,13,213,0,0,S-M-U,31,30,106,32,18,225,1,1,H,3.5,3,21,156,-10,-5,-12,-1,-1,2009
1262,1262,11/21/2009,Maryland,26,46,196,27,20,214,0,1,Florida State,29,24,198,27,17,206,3,0,V,-17,-3,22,-2,0,3,8,-3,1,2009
1263,1263,11/21/2009,Memphis,14,45,243,28,15,101,1,0,Houston,55,24,111,55,42,578,0,0,V,-22,-41,21,132,-27,-27,-477,1,0,2009
1264,1264,11/21/2009,Miami-Florida,34,44,148,43,25,348,1,1,Duke,16,22,55,37,20,303,1,1,H,19.5,18,22,93,6,5,45,0,0,2009
1265,1265,11/21/2009,Michigan,10,31,80,42,25,229,4,1,Ohio State,21,53,251,17,9,67,1,0,H,-10,-11,-22,-171,25,16,162,3,1,2009
1266,1266,11/21/2009,Michigan State,14,25,94,33,20,239,2,0,Penn State,42,38,188,28,20,324,0,0,H,-3,-28,-13,-94,5,0,-85,2,0,2009
1267,1267,11/21/2009,Middle Tennessee,38,44,164,28,15,263,1,1,Arkansas State,14,36,44,28,13,176,1,1,H,10,24,8,120,0,2,87,0,0,2009
1268,1268,11/21/2009,Minnesota,0,36,48,42,14,153,1,2,Iowa,12,36,54,24,11,117,1,1,V,-12.5,-12,0,-6,18,3,36,0,1,2009
1269,1269,11/21/2009,Mississippi,25,45,193,22,15,233,0,0,Louisiana State,23,27,40,37,19,250,1,0,H,4.5,2,18,153,-15,-4,-17,-1,0,2009
1270,1270,11/21/2009,Mississippi State,21,55,327,13,8,49,0,2,Arkansas,42,27,83,34,18,313,2,0,V,-12,-21,28,244,-21,-10,-264,-2,2,2009
1271,1271,11/21/2009,Missouri,34,50,202,32,23,337,0,1,Iowa State,24,28,77,41,29,259,2,0,H,15,10,22,125,-9,-6,78,-2,1,2009
1272,1272,11/21/2009,Nebraska,17,45,101,19,13,166,1,0,Kansas State,3,34,140,33,12,153,1,1,H,16.5,14,11,-39,-14,1,13,0,-1,2009
1273,1273,11/21/2009,Nevada-Reno,63,61,574,12,5,96,0,2,New Mexico State,20,33,155,19,8,77,2,0,V,30,43,28,419,-7,-3,19,-2,2,2009
1274,1274,11/21/2009,New Mexico,29,35,270,38,22,197,2,0,Colorado State,27,36,197,17,12,173,1,2,H,-4,2,-1,73,21,10,24,1,-2,2009
1275,1275,11/21/2009,New Mexico State,20,33,155,19,8,77,2,0,Nevada-Reno,63,61,574,12,5,96,0,2,H,-30,-43,-28,-419,7,3,-19,2,-2,2009
1276,1276,11/21/2009,No Carolina State,10,26,14,29,16,245,1,3,Virginia Tech,38,56,200,18,9,197,0,1,V,-21,-28,-30,-186,11,7,48,1,2,2009
1277,1277,11/21/2009,North Carolina,31,38,96,34,23,182,3,1,Boston College,13,30,97,30,12,101,5,1,V,-2.5,18,8,-1,4,11,81,-2,0,2009
1278,1278,11/21/2009,North Texas,13,30,222,41,31,225,3,2,Army,17,46,200,15,7,87,0,0,H,1,-4,-16,22,26,24,138,3,2,2009
1279,1279,11/21/2009,Northern Illinois,31,37,103,38,24,307,1,1,Ohio,38,28,84,29,17,144,0,1,V,-1.5,-7,9,19,9,7,163,1,0,2009
1280,1280,11/21/2009,Northwestern,33,25,73,41,27,364,0,1,Wisconsin,31,35,99,30,19,235,1,1,H,-7,2,-10,-26,11,8,129,-1,0,2009
1281,1281,11/21/2009,Notre Dame,30,35,123,45,30,329,0,2,Connecticut,33,48,231,25,12,141,1,0,H,6.5,-3,-13,-108,20,18,188,-1,2,2009
1282,1282,11/21/2009,Ohio,38,28,84,29,17,144,0,1,Northern Illinois,31,37,103,38,24,307,1,1,H,1.5,7,-9,-19,-9,-7,-163,-1,0,2009
1283,1283,11/21/2009,Ohio State,21,53,251,17,9,67,1,0,Michigan,10,31,80,42,25,229,4,1,V,10,11,22,171,-25,-16,-162,-3,-1,2009
1284,1284,11/21/2009,Oklahoma,13,26,48,36,18,262,2,0,Texas Tech,41,35,161,53,35,388,1,0,V,6,-28,-9,-113,-17,-17,-126,1,0,2009
1285,1285,11/21/2009,Oregon,44,37,175,47,26,284,1,0,Arizona,41,35,127,47,30,314,1,1,V,5.5,3,2,48,0,-4,-30,0,-1,2009
1286,1286,11/21/2009,Oregon State,42,39,283,37,26,284,1,0,Washington State,10,24,59,32,15,133,0,1,V,31,32,15,224,5,11,151,1,-1,2009
1287,1287,11/21/2009,Penn State,42,38,188,28,20,324,0,0,Michigan State,14,25,94,33,20,239,2,0,V,3,28,13,94,-5,0,85,-2,0,2009
1288,1288,11/21/2009,Purdue,38,33,124,29,21,205,0,0,Indiana,21,36,196,39,23,266,2,2,V,2.5,17,-3,-72,-10,-2,-61,-2,-2,2009
1289,1289,11/21/2009,Rice,30,49,172,17,8,55,1,0,UTEP,29,43,151,26,17,244,1,5,H,-6.5,1,6,21,-9,-9,-189,0,-5,2009
1290,1290,11/21/2009,Rutgers,13,27,26,18,8,104,2,0,Syracuse,31,51,213,22,17,211,0,0,V,10,-18,-24,-187,-4,-9,-107,2,0,2009
1291,1291,11/21/2009,S-M-U,31,30,106,32,18,225,1,1,Marshall,34,51,262,22,13,213,0,0,V,-3.5,-3,-21,-156,10,5,12,1,1,2009
1292,1292,11/21/2009,San Diego State,7,29,55,37,17,207,2,0,Utah,38,42,189,29,15,202,0,0,V,-20,-31,-13,-134,8,2,5,2,0,2009
1293,1293,11/21/2009,San Jose State,10,31,132,25,15,145,3,1,Hawaii,17,30,106,47,28,299,0,2,H,-2.5,-7,1,26,-22,-13,-154,3,-1,2009
1294,1294,11/21/2009,South Florida,34,45,234,35,20,304,0,1,Louisville,22,24,81,35,20,232,1,0,H,13,12,21,153,0,0,72,-1,1,2009
1295,1295,11/21/2009,Southern Miss,44,38,163,21,12,276,0,0,Tulsa,34,46,193,46,32,396,1,2,H,8.5,10,-8,-30,-25,-20,-120,-1,-2,2009
1296,1296,11/21/2009,Stanford,28,28,188,30,10,157,1,0,California,34,57,242,31,17,235,1,0,H,7,-6,-29,-54,-1,-7,-78,0,0,2009
1297,1297,11/21/2009,Syracuse,31,51,213,22,17,211,0,0,Rutgers,13,27,26,18,8,104,2,0,H,-10,18,24,187,4,9,107,-2,0,2009
1298,1298,11/21/2009,Temple,47,38,275,17,6,124,1,0,Kent State,13,30,64,41,21,256,2,1,H,10.5,34,8,211,-24,-15,-132,-1,-1,2009
1299,1299,11/21/2009,Tennessee,31,40,201,34,20,221,1,0,Vanderbilt,16,33,123,35,19,174,1,0,H,17,15,7,78,-1,1,47,0,0,2009
1300,1300,11/21/2009,Texas,51,40,136,42,32,396,0,1,Kansas,20,26,47,39,25,256,1,0,H,27.5,31,14,89,3,7,140,-1,1,2009
1301,1301,11/21/2009,Texas A+M,38,52,375,25,19,153,0,1,Baylor,3,26,82,38,24,215,3,0,H,5.5,35,26,293,-13,-5,-62,-3,1,2009
1302,1302,11/21/2009,Texas Christian,45,54,355,19,10,168,1,3,Wyoming,10,36,84,19,6,94,1,1,V,30.5,35,18,271,0,4,74,0,2,2009
1303,1303,11/21/2009,Texas Tech,41,35,161,53,35,388,1,0,Oklahoma,13,26,48,36,18,262,2,0,H,-6,28,9,113,17,17,126,-1,0,2009
1304,1304,11/21/2009,Troy,47,31,168,40,28,483,1,2,Florida Atlantic,21,34,142,36,23,206,0,1,H,16.5,26,-3,26,4,5,277,1,1,2009
1305,1305,11/21/2009,Tulane,0,24,-30,27,13,80,2,3,U-C-F,49,50,264,29,20,240,1,0,V,-22,-49,-26,-294,-2,-7,-160,1,3,2009
1306,1306,11/21/2009,Tulsa,34,46,193,46,32,396,1,2,Southern Miss,44,38,163,21,12,276,0,0,V,-8.5,-10,8,30,25,20,120,1,2,2009
1307,1307,11/21/2009,U-A-B,21,49,273,27,19,247,1,1,East Carolina,37,24,75,26,20,250,0,0,V,-14,-16,25,198,1,-1,-3,1,1,2009
1308,1308,11/21/2009,U-C-F,49,50,264,29,20,240,1,0,Tulane,0,24,-30,27,13,80,2,3,H,22,49,26,294,2,7,160,-1,-3,2009
1309,1309,11/21/2009,U.C.L.A.,23,36,131,32,16,161,0,0,Arizona State,13,33,118,22,15,197,1,5,H,4.5,10,3,13,10,1,-36,-1,-5,2009
1310,1310,11/21/2009,UL-Lafayette,21,39,62,27,16,252,0,1,UL-Monroe,17,43,212,12,8,91,2,1,H,-3.5,4,-4,-150,15,8,161,-2,0,2009
1311,1311,11/21/2009,UL-Monroe,17,43,212,12,8,91,2,1,UL-Lafayette,21,39,62,27,16,252,0,1,V,3.5,-4,4,150,-15,-8,-161,2,0,2009
1312,1312,11/21/2009,UTEP,29,43,151,26,17,244,1,5,Rice,30,49,172,17,8,55,1,0,V,6.5,-1,-6,-21,9,9,189,0,5,2009
1313,1313,11/21/2009,Utah,38,42,189,29,15,202,0,0,San Diego State,7,29,55,37,17,207,2,0,H,20,31,13,134,-8,-2,-5,-2,0,2009
1314,1314,11/21/2009,Vanderbilt,16,33,123,35,19,164,1,0,Tennessee,31,40,201,34,20,221,1,0,V,-17,-15,-7,-78,1,-1,-57,0,0,2009
1315,1315,11/21/2009,Virginia,21,40,78,19,13,195,0,2,Clemson,34,38,132,26,19,234,0,0,V,-21,-13,2,-54,-7,-6,-39,0,2,2009
1316,1316,11/21/2009,Virginia Tech,38,56,200,18,9,197,0,1,No Carolina State,10,26,14,29,16,245,1,3,H,21,28,30,186,-11,-7,-48,-1,-2,2009
1317,1317,11/21/2009,Washington State,10,24,59,32,15,133,0,1,Oregon State,42,39,283,37,26,284,1,0,H,-31,-32,-15,-224,-5,-11,-151,-1,1,2009
1318,1318,11/21/2009,Wisconsin,31,35,99,30,19,235,1,1,Northwestern,33,25,73,41,27,364,0,1,V,7,-2,10,26,-11,-8,-129,1,0,2009
1319,1319,11/21/2009,Wyoming,10,36,84,19,6,94,1,1,Texas Christian,45,54,355,19,10,168,1,3,H,-30.5,-35,-18,-271,0,-4,-74,0,-2,2009
1320,1320,11/24/2009,Ball State,22,41,155,16,7,71,1,0,Western Michigan,17,27,109,62,33,354,4,1,V,-10,5,14,46,-46,-26,-283,-3,-1,2009
1321,1321,11/24/2009,Western Michigan,17,27,109,62,33,354,4,1,Ball State,22,41,155,16,7,71,1,0,H,10,-5,-14,-46,46,26,283,3,1,2009
1322,1322,11/26/2009,Texas,49,39,293,40,24,304,0,1,Texas A+M,39,40,190,33,26,342,1,1,V,20.5,10,-1,103,7,-2,-38,-1,0,2009
1323,1323,11/26/2009,Texas A+M,39,40,190,33,26,342,1,1,Texas,49,39,293,40,24,304,0,1,H,-20.5,-10,1,-103,-7,2,38,1,0,2009
1324,1324,11/27/2009,Akron,28,36,193,18,11,117,2,1,Eastern Michigan,21,43,172,31,16,148,2,0,H,15.5,7,-7,21,-13,-5,-31,0,1,2009
1325,1325,11/27/2009,Alabama,26,35,73,32,21,218,0,0,Auburn,21,33,149,27,15,181,1,1,V,10,5,2,-76,5,6,37,-1,-1,2009
1326,1326,11/27/2009,Auburn,21,32,151,27,15,181,1,1,Alabama,26,35,73,32,21,218,0,0,H,-10,-5,-3,78,-5,-6,-37,1,1,2009
1327,1327,11/27/2009,Boise State,44,33,165,34,17,262,0,1,Nevada-Reno,33,44,242,22,12,141,0,1,H,13.5,11,-11,-77,12,5,121,0,0,2009
1328,1328,11/27/2009,Bowling Green,38,28,152,31,19,137,0,1,Toledo,24,40,159,39,23,326,2,3,H,7.5,14,-12,-7,-8,-4,-189,-2,-2,2009
1329,1329,11/27/2009,Buffalo,9,46,139,32,13,181,2,2,Kent State,6,33,128,14,5,31,0,1,V,3,3,13,11,18,8,150,2,1,2009
1330,1330,11/27/2009,Central Michigan,45,41,257,42,27,255,1,1,Northern Illinois,31,29,126,28,17,206,2,1,H,13.5,14,12,131,14,10,49,-1,0,2009
1331,1331,11/27/2009,Cincinnati,49,15,21,46,32,399,0,1,Illinois,36,45,169,35,22,307,0,0,H,18.5,13,-30,-148,11,10,92,0,1,2009
1332,1332,11/27/2009,Colorado,20,28,134,44,21,269,3,0,Nebraska,28,40,144,14,9,73,0,1,H,-10,-8,-12,-10,30,12,196,3,-1,2009
1333,1333,11/27/2009,Colorado State,16,35,167,30,22,189,1,1,Wyoming,17,33,96,21,13,137,0,0,H,3,-1,2,71,9,9,52,1,1,2009
1334,1334,11/27/2009,Eastern Michigan,21,43,172,31,16,148,2,0,Akron,28,36,193,18,11,117,2,1,V,-15.5,-7,7,-21,13,5,31,0,-1,2009
1335,1335,11/27/2009,Illinois,36,45,169,35,22,307,0,0,Cincinnati,49,15,21,46,32,399,0,1,V,-18.5,-13,30,148,-11,-10,-92,0,-1,2009
1336,1336,11/27/2009,Kent State,6,33,128,14,5,31,0,1,Buffalo,9,46,139,32,13,181,2,2,H,-3,-3,-13,-11,-18,-8,-150,-2,-1,2009
1337,1337,11/27/2009,Louisville,14,27,48,35,20,254,0,1,Rutgers,34,48,239,18,10,163,0,0,H,-3.5,-20,-21,-191,17,10,91,0,1,2009
1338,1338,11/27/2009,Memphis,30,37,268,19,10,94,1,0,Tulsa,33,46,148,42,27,268,1,1,V,-16.5,-3,-9,120,-23,-17,-174,0,-1,2009
1339,1339,11/27/2009,Nebraska,28,40,144,14,9,73,0,1,Colorado,20,28,134,44,21,269,3,0,V,10,8,12,10,-30,-12,-196,-3,1,2009
1340,1340,11/27/2009,Nevada-Reno,33,44,242,22,12,141,0,1,Boise State,44,33,165,34,17,262,0,1,V,-13.5,-11,11,77,-12,-5,-121,0,0,2009
1341,1341,11/27/2009,Northern Illinois,31,29,126,28,17,206,2,1,Central Michigan,45,41,257,42,27,255,1,1,V,-13.5,-14,-12,-131,-14,-10,-49,1,0,2009
1342,1342,11/27/2009,Ohio,35,38,170,21,17,324,0,0,Temple,17,47,255,34,11,123,3,0,H,-2,18,-9,-85,-13,6,201,-3,0,2009
1343,1343,11/27/2009,Pittsburgh,16,29,146,30,16,179,2,0,West Virginia,19,43,205,32,19,164,0,0,V,1,-3,-14,-59,-2,-3,15,2,0,2009
1344,1344,11/27/2009,Rutgers,34,48,239,18,10,163,0,0,Louisville,14,27,48,35,20,254,0,1,V,3.5,20,21,191,-17,-10,-91,0,-1,2009
1345,1345,11/27/2009,Temple,17,47,255,34,11,123,3,0,Ohio,35,38,170,21,17,324,0,0,V,2,-18,9,85,13,-6,-201,3,0,2009
1346,1346,11/27/2009,Toledo,24,40,159,39,23,326,2,3,Bowling Green,38,28,152,31,19,137,0,1,V,-7.5,-14,12,7,8,4,189,2,2,2009
1347,1347,11/27/2009,Tulsa,33,46,148,42,27,268,1,1,Memphis,30,36,268,19,10,94,1,0,H,16.5,3,10,-120,23,17,174,0,1,2009
1348,1348,11/27/2009,West Virginia,19,43,205,32,19,164,0,0,Pittsburgh,16,29,146,30,16,179,2,0,H,-1,3,14,59,2,3,-15,-2,0,2009
1349,1349,11/27/2009,Wyoming,17,33,96,21,13,137,0,0,Colorado State,16,35,167,30,22,185,1,0,V,-3,1,-2,-71,-9,-9,-48,-1,0,2009
1350,1350,11/28/2009,Arizona,20,23,117,43,24,148,0,0,Arizona State,17,30,86,33,17,217,0,1,V,3.5,3,-7,31,10,7,-69,0,-1,2009
1351,1351,11/28/2009,Arizona State,17,30,86,33,17,217,0,1,Arizona,20,23,117,43,24,148,0,0,H,-3.5,-3,7,-31,-10,-7,69,0,1,2009
1352,1352,11/28/2009,Arkansas,30,35,148,39,17,227,1,0,Louisiana State,33,38,147,25,17,179,1,1,V,-3.5,-3,-3,1,14,0,48,0,-1,2009
1353,1353,11/28/2009,Arkansas State,30,46,244,28,18,240,3,0,North Texas,26,26,140,28,15,128,1,0,H,7.5,4,20,104,0,3,112,2,0,2009
1354,1354,11/28/2009,Baylor,13,39,104,35,22,238,1,1,Texas Tech,20,28,100,49,31,269,1,1,N,-20.5,-7,11,4,-14,-9,-31,0,0,2009
1355,1355,11/28/2009,Boston College,19,47,126,23,14,227,0,0,Maryland,17,28,61,32,20,216,0,0,V,5,2,19,65,-9,-6,11,0,0,2009
1356,1356,11/28/2009,Brigham Young,26,36,131,32,12,134,0,0,Utah,23,30,97,45,22,201,1,0,H,7.5,3,6,34,-13,-10,-67,-1,0,2009
1357,1357,11/28/2009,Clemson,17,19,48,42,22,212,1,2,South Carolina,34,58,223,22,11,165,1,1,V,3,-17,-39,-175,20,11,47,0,1,2009
1358,1358,11/28/2009,Connecticut,56,41,204,21,13,173,1,0,Syracuse,31,36,129,41,31,360,0,2,H,13.5,25,5,75,-20,-18,-187,1,-2,2009
1359,1359,11/28/2009,Duke,34,19,68,48,28,387,1,0,Wake Forest,45,34,127,38,28,372,0,0,H,-3.5,-11,-15,-59,10,0,15,1,0,2009
1360,1360,11/28/2009,East Carolina,25,34,172,41,25,269,0,1,Southern Miss,20,29,164,45,21,265,0,1,H,6.5,5,5,8,-4,4,4,0,0,2009
1361,1361,11/28/2009,Florida,37,39,311,23,19,234,0,2,Florida State,10,24,83,32,19,186,2,0,H,25,27,15,228,-9,0,48,-2,2,2009
1362,1362,11/28/2009,Florida Atlantic,29,41,161,30,16,266,0,1,Western Kentucky,23,29,201,30,20,167,1,2,H,12,6,12,-40,0,-4,99,-1,-1,2009
1363,1363,11/28/2009,Florida State,10,24,83,32,19,186,2,0,Florida,37,39,311,23,19,234,0,2,V,-25,-27,-15,-228,9,0,-48,2,-2,2009
1364,1364,11/28/2009,Georgia,30,44,339,14,8,76,0,1,Georgia Tech,24,51,205,13,6,135,1,1,V,-9,6,-7,134,1,2,-59,-1,0,2009
1365,1365,11/28/2009,Georgia Tech,24,51,205,13,6,135,1,1,Georgia,30,44,339,14,8,76,0,1,H,9,-6,7,-134,-1,-2,59,1,0,2009
1366,1366,11/28/2009,Hawaii,24,17,62,46,32,366,0,1,Navy,17,48,248,9,5,88,0,0,H,-9.5,7,-31,-186,37,27,278,0,1,2009
1367,1367,11/28/2009,Houston,73,31,221,47,36,463,0,0,Rice,14,45,243,33,17,134,3,0,H,30,59,-14,-22,14,19,329,-3,0,2009
1368,1368,11/28/2009,Idaho,49,36,135,40,23,395,1,1,Utah State,52,39,163,31,19,376,0,1,H,3,-3,-3,-28,9,4,19,1,0,2009
1369,1369,11/28/2009,Kansas,39,19,49,55,37,498,1,2,Missouri,41,35,250,41,23,303,0,1,N,-3,-2,-16,-201,14,14,195,1,1,2009
1370,1370,11/28/2009,Kentucky,24,38,161,25,11,100,0,2,Tennessee,30,47,226,23,13,220,1,1,H,-3,-6,-9,-65,2,-2,-120,-1,1,2009
1371,1371,11/28/2009,Louisiana State,33,38,147,25,17,179,1,1,Arkansas,30,35,148,39,17,227,1,0,H,3.5,3,3,-1,-14,0,-48,0,1,2009
1372,1372,11/28/2009,Marshall,21,33,146,47,25,347,3,0,UTEP,52,21,72,42,28,517,0,0,V,-2,-31,12,74,5,-3,-170,3,0,2009
1373,1373,11/28/2009,Maryland,17,28,61,32,20,216,0,0,Boston College,19,47,126,23,14,227,0,0,H,-5,-2,-19,-65,9,6,-11,0,0,2009
1374,1374,11/28/2009,Miami-Florida,31,47,240,22,11,161,0,0,South Florida,10,39,143,16,6,77,1,1,V,3.5,21,8,97,6,5,84,-1,-1,2009
1375,1375,11/28/2009,Middle Tennessee,38,36,190,20,10,116,2,0,UL-Monroe,19,38,139,39,21,231,3,0,V,3.5,19,-2,51,-19,-11,-115,-1,0,2009
1376,1376,11/28/2009,Mississippi,27,23,90,30,18,295,3,1,Mississippi State,41,59,317,14,8,95,1,1,V,7.5,-14,-36,-227,16,10,200,2,0,2009
1377,1377,11/28/2009,Mississippi State,41,59,317,14,8,95,1,1,Mississippi,27,23,90,30,18,295,3,1,H,-7.5,14,36,227,-16,-10,-200,-2,0,2009
1378,1378,11/28/2009,Missouri,41,35,250,41,23,303,0,1,Kansas,39,19,49,55,37,498,1,2,N,3,2,16,201,-14,-14,-195,-1,-1,2009
1379,1379,11/28/2009,Navy,17,48,248,9,5,88,0,0,Hawaii,24,17,62,46,32,366,0,1,V,9.5,-7,31,186,-37,-27,-278,0,-1,2009
1380,1380,11/28/2009,Nevada-Las Vegas,28,31,123,35,21,274,2,0,San Diego State,24,31,104,45,25,341,2,0,H,6,4,0,19,-10,-4,-67,0,0,2009
1381,1381,11/28/2009,New Mexico,10,29,10,45,20,162,4,1,Texas Christian,51,45,202,24,15,232,0,3,V,-44.5,-41,-16,-192,21,5,-70,4,-2,2009
1382,1382,11/28/2009,New Mexico State,10,38,167,14,6,51,1,0,San Jose State,13,42,117,27,17,176,1,1,V,-11,-3,-4,50,-13,-11,-125,0,-1,2009
1383,1383,11/28/2009,No Carolina State,28,41,76,27,20,259,0,0,North Carolina,27,34,159,20,14,322,1,1,H,-6,1,7,-83,7,6,-63,-1,-1,2009
1384,1384,11/28/2009,North Carolina,27,34,159,20,14,322,1,1,No Carolina State,28,41,76,27,20,259,0,0,V,6,-1,-7,83,-7,-6,63,1,1,2009
1385,1385,11/28/2009,North Texas,26,26,140,28,15,128,1,0,Arkansas State,30,46,244,28,18,240,3,0,V,-7.5,-4,-20,-104,0,-3,-112,-2,0,2009
1386,1386,11/28/2009,Notre Dame,38,25,107,30,23,340,0,1,Stanford,45,48,280,21,15,216,0,1,V,-10,-7,-23,-173,9,8,124,0,0,2009
1387,1387,11/28/2009,Oklahoma,27,47,143,37,20,224,0,2,Oklahoma State,0,29,62,23,10,47,1,1,H,7.5,27,18,81,14,10,177,-1,1,2009
1388,1388,11/28/2009,Oklahoma State,0,29,62,23,10,47,1,1,Oklahoma,27,47,143,37,20,224,0,2,V,-7.5,-27,-18,-81,-14,-10,-177,1,-1,2009
1389,1389,11/28/2009,Rice,14,45,243,33,17,134,3,0,Houston,73,31,221,47,36,463,0,0,V,-30,-59,14,22,-14,-19,-329,3,0,2009
1390,1390,11/28/2009,S-M-U,26,37,181,34,20,264,0,0,Tulane,21,32,129,26,18,216,0,1,H,20,5,5,52,8,2,48,0,-1,2009
1391,1391,11/28/2009,San Diego State,24,31,104,45,25,341,2,0,Nevada-Las Vegas,28,31,123,35,21,274,2,0,V,-6,-4,0,-19,10,4,67,0,0,2009
1392,1392,11/28/2009,San Jose State,13,42,117,27,17,176,1,1,New Mexico State,10,38,167,14,6,51,1,0,H,11,3,4,-50,13,11,125,0,1,2009
1393,1393,11/28/2009,South Carolina,34,58,223,22,11,165,1,1,Clemson,17,19,48,42,22,212,1,2,H,-3,17,39,175,-20,-11,-47,0,-1,2009
1394,1394,11/28/2009,South Florida,10,39,143,16,6,77,1,1,Miami-Florida,31,47,240,22,11,161,0,0,H,-3.5,-21,-8,-97,-6,-5,-84,1,1,2009
1395,1395,11/28/2009,Southern Cal,28,34,130,26,18,206,1,0,U.C.L.A.,7,35,134,39,18,188,3,1,H,13,21,-1,-4,-13,0,18,-2,-1,2009
1396,1396,11/28/2009,Southern Miss,20,28,164,45,21,265,0,1,East Carolina,25,34,172,41,25,269,0,1,V,-6.5,-5,-6,-8,4,-4,-4,0,0,2009
1397,1397,11/28/2009,Stanford,45,48,280,21,15,216,0,1,Notre Dame,38,25,107,30,23,340,0,1,H,10,7,23,173,-9,-8,-124,0,0,2009
1398,1398,11/28/2009,Syracuse,31,36,129,41,31,360,0,2,Connecticut,56,41,204,21,13,173,1,0,V,-13.5,-25,-5,-75,20,18,187,-1,2,2009
1399,1399,11/28/2009,Tennessee,30,48,224,23,13,220,1,1,Kentucky,24,38,161,25,11,100,0,2,V,3,6,10,63,-2,2,120,1,-1,2009
1400,1400,11/28/2009,Texas Christian,51,45,202,24,15,228,0,2,New Mexico,10,29,10,45,20,162,4,1,H,44.5,41,16,192,-21,-5,66,-4,1,2009
1401,1401,11/28/2009,Texas Tech,20,28,100,49,31,269,1,1,Baylor,13,39,104,35,22,238,1,1,N,20.5,7,-11,-4,14,9,31,0,0,2009
1402,1402,11/28/2009,Troy,48,35,220,31,20,293,1,1,UL-Lafayette,31,37,148,50,30,415,1,1,V,11,17,-2,72,-19,-10,-122,0,0,2009
1403,1403,11/28/2009,Tulane,21,32,129,26,18,216,0,1,S-M-U,26,37,181,34,20,264,0,0,V,-20,-5,-5,-52,-8,-2,-48,0,1,2009
1404,1404,11/28/2009,U-A-B,27,32,205,35,20,322,1,0,U-C-F,34,35,205,38,24,230,2,0,H,-3,-7,-3,0,-3,-4,92,-1,0,2009
1405,1405,11/28/2009,U-C-F,34,35,205,38,24,230,2,0,U-A-B,27,32,205,35,20,322,1,0,V,3,7,3,0,3,4,-92,1,0,2009
1406,1406,11/28/2009,U.C.L.A.,7,35,134,39,18,188,3,1,Southern Cal,28,34,130,26,18,206,1,0,V,-13,-21,1,4,13,0,-18,2,1,2009
1407,1407,11/28/2009,UL-Lafayette,31,37,148,50,30,415,1,1,Troy,48,35,220,31,20,293,1,1,H,-11,-17,2,-72,19,10,122,0,0,2009
1408,1408,11/28/2009,UL-Monroe,19,38,139,39,21,231,3,0,Middle Tennessee,38,36,190,20,10,116,2,0,H,-3.5,-19,2,-51,19,11,115,1,0,2009
1409,1409,11/28/2009,UTEP,52,21,72,42,28,517,0,0,Marshall,21,33,146,47,25,347,3,0,H,2,31,-12,-74,-5,3,170,-3,0,2009
1410,1410,11/28/2009,Utah,23,30,97,45,22,201,1,0,Brigham Young,26,36,131,32,12,134,0,0,V,-7.5,-3,-6,-34,13,10,67,1,0,2009
1411,1411,11/28/2009,Utah State,52,39,163,31,19,376,0,1,Idaho,49,36,135,40,23,395,1,1,V,-3,3,3,28,-9,-4,-19,-1,0,2009
1412,1412,11/28/2009,Virginia,13,37,175,22,12,120,0,2,Virginia Tech,42,45,298,15,8,185,1,0,H,-14,-29,-8,-123,7,4,-65,-1,2,2009
1413,1413,11/28/2009,Virginia Tech,42,45,298,15,8,185,1,0,Virginia,13,37,175,22,12,120,0,2,V,14,29,8,123,-7,-4,65,1,-2,2009
1414,1414,11/28/2009,Wake Forest,45,34,127,38,28,372,0,0,Duke,34,19,68,48,28,387,1,0,V,3.5,11,15,59,-10,0,-15,-1,0,2009
1415,1415,11/28/2009,Washington,30,40,265,28,16,196,1,1,Washington State,0,28,47,32,14,116,1,1,H,24.5,30,12,218,-4,2,80,0,0,2009
1416,1416,11/28/2009,Washington State,0,28,47,32,14,116,1,1,Washington,30,40,265,28,16,196,1,1,V,-24.5,-30,-12,-218,4,-2,-80,0,0,2009
1417,1417,11/28/2009,Western Kentucky,23,29,201,30,20,167,1,2,Florida Atlantic,29,41,161,30,16,266,0,1,V,-12,-6,-12,40,0,4,-99,1,1,2009
1418,1418,12/03/2009,Arkansas State,24,34,101,20,16,146,0,2,Western Kentucky,20,46,103,19,12,121,1,2,V,6.5,4,-12,-2,1,4,25,-1,0,2009
1419,1419,12/03/2009,Oregon,37,49,288,21,14,201,1,1,Oregon State,33,25,83,36,24,306,0,0,H,9.5,4,24,205,-15,-10,-105,1,1,2009
1420,1420,12/03/2009,Oregon State,33,25,83,36,24,306,0,0,Oregon,37,49,288,21,14,201,1,1,V,-9.5,-4,-24,-205,15,10,105,-1,-1,2009
1421,1421,12/03/2009,Western Kentucky,20,46,103,19,12,121,1,2,Arkansas State,24,34,101,20,16,146,0,2,H,-6.5,-4,12,2,-1,-4,-25,1,0,2009
1422,1422,12/04/2009,Central Michigan,20,41,126,39,28,255,1,0,Ohio,10,29,108,27,11,167,0,1,N,13.5,10,12,18,12,17,88,1,-1,2009
1423,1423,12/04/2009,Ohio,10,29,108,27,11,167,0,1,Central Michigan,20,41,126,39,28,255,1,0,N,-13.5,-10,-12,-18,-12,-17,-88,-1,1,2009
1424,1424,12/05/2009,Alabama,32,53,251,18,12,239,0,0,Florida,13,14,88,35,20,247,1,0,N,-4.5,19,39,163,-17,-8,-8,-1,0,2009
1425,1425,12/05/2009,Arizona,21,29,82,40,22,239,1,0,Southern Cal,17,31,138,37,20,144,1,0,V,-7,4,-2,-56,3,2,95,0,0,2009
1426,1426,12/05/2009,Boise State,42,39,256,35,23,288,0,2,New Mexico State,7,43,142,13,4,49,1,1,H,46,35,-4,114,22,19,239,-1,1,2009
1427,1427,12/05/2009,California,10,29,81,32,14,215,0,2,Washington,42,39,177,24,20,286,0,0,V,6.5,-32,-10,-96,8,-6,-71,0,2,2009
1428,1428,12/05/2009,Cincinnati,45,18,69,44,22,302,3,0,Pittsburgh,44,55,193,21,13,176,2,0,V,-1.5,1,-37,-124,23,9,126,1,0,2009
1429,1429,12/05/2009,Clemson,34,34,323,17,10,91,2,0,Georgia Tech,39,65,333,18,9,136,0,0,N,-1,-5,-31,-10,-1,1,-45,2,0,2009
1430,1430,12/05/2009,Connecticut,29,30,127,30,20,225,0,0,South Florida,27,44,193,19,11,160,0,1,H,7,2,-14,-66,11,9,65,0,-1,2009
1431,1431,12/05/2009,East Carolina,38,38,151,34,21,262,0,0,Houston,32,19,30,75,56,527,3,1,H,-1,6,19,121,-41,-35,-265,-3,-1,2009
1432,1432,12/05/2009,Florida,13,14,88,35,20,247,1,0,Alabama,32,54,242,18,12,251,0,0,N,4.5,-19,-40,-154,17,8,-4,1,0,2009
1433,1433,12/05/2009,Florida Atlantic,28,40,186,27,15,220,0,0,Florida Intl,21,38,199,35,22,246,0,0,V,-2.5,7,2,-13,-8,-7,-26,0,0,2009
1434,1434,12/05/2009,Florida Intl,21,39,190,35,22,246,0,0,Florida Atlantic,28,40,186,27,15,220,0,0,H,2.5,-7,-1,4,8,7,26,0,0,2009
1435,1435,12/05/2009,Fresno State,53,44,233,21,13,183,1,0,Illinois,52,49,331,19,9,217,2,1,V,-2,1,-5,-98,2,4,-34,-1,-1,2009
1436,1436,12/05/2009,Georgia Tech,39,65,333,18,9,136,0,0,Clemson,34,34,323,17,10,91,2,0,N,1,5,31,10,1,-1,45,-2,0,2009
1437,1437,12/05/2009,Hawaii,10,17,17,34,15,197,2,0,Wisconsin,51,52,301,20,16,253,0,0,H,-12,-41,-35,-284,14,-1,-56,2,0,2009
1438,1438,12/05/2009,Houston,32,19,30,75,56,527,3,1,East Carolina,38,38,151,34,21,262,0,0,V,1,-6,-19,-121,41,35,265,3,1,2009
1439,1439,12/05/2009,Illinois,52,49,331,19,9,217,2,1,Fresno State,53,44,233,21,13,183,1,0,H,2,-1,5,98,-2,-4,34,1,1,2009
1440,1440,12/05/2009,Louisiana Tech,55,43,240,13,10,184,0,1,San Jose State,20,36,27,41,24,300,3,1,H,24,35,7,213,-28,-14,-116,-3,0,2009
1441,1441,12/05/2009,Nebraska,12,35,67,20,6,39,3,0,Texas,13,38,18,36,20,184,3,0,N,-14,-1,-3,49,-16,-14,-145,0,0,2009
1442,1442,12/05/2009,New Mexico State,7,43,142,13,4,49,1,1,Boise State,42,39,256,35,23,288,0,2,V,-46,-35,4,-114,-22,-19,-239,1,-1,2009
1443,1443,12/05/2009,Pittsburgh,44,55,193,21,13,176,2,0,Cincinnati,45,18,69,44,22,302,3,0,H,1.5,-1,37,124,-23,-9,-126,-1,0,2009
1444,1444,12/05/2009,Rutgers,21,35,65,28,9,153,2,0,West Virginia,24,45,162,20,10,116,0,2,H,1.5,-3,-10,-97,8,-1,37,2,-2,2009
1445,1445,12/05/2009,San Jose State,20,36,27,41,24,300,3,1,Louisiana Tech,55,43,240,13,10,184,0,1,V,-24,-35,-7,-213,28,14,116,3,0,2009
1446,1446,12/05/2009,South Florida,27,44,193,19,11,160,0,1,Connecticut,29,30,127,30,20,225,0,0,V,-7,-2,14,66,-11,-9,-65,0,1,2009
1447,1447,12/05/2009,Southern Cal,17,31,138,37,20,144,1,0,Arizona,21,29,82,40,22,239,1,0,H,7,-4,2,56,-3,-2,-95,0,0,2009
1448,1448,12/05/2009,Texas,13,38,18,36,20,184,3,0,Nebraska,12,35,67,20,6,39,3,0,N,14,1,3,-49,16,14,145,0,0,2009
1449,1449,12/05/2009,Washington,42,39,177,24,20,286,0,0,California,10,29,81,32,14,215,0,2,H,-6.5,32,10,96,-8,6,71,0,-2,2009
1450,1450,12/05/2009,West Virginia,24,45,162,20,10,116,0,2,Rutgers,21,35,65,28,9,153,2,0,V,-1.5,3,10,97,-8,1,-37,-2,2,2009
1451,1451,12/05/2009,Wisconsin,51,52,301,20,16,253,0,0,Hawaii,10,17,17,34,15,197,2,0,V,12,41,35,284,-14,1,56,-2,0,2009
1452,1452,12/12/2009,Army,3,40,110,21,7,77,1,1,Navy,17,52,186,7,3,61,1,1,N,-15,-14,-12,-76,14,4,16,0,0,2009
1453,1453,12/12/2009,Navy,17,52,186,7,3,61,1,1,Army,3,40,110,21,7,77,1,1,N,15,14,12,76,-14,-4,-16,0,0,2009
