,Week,Team,ScoreOff,RushAttOff,RushYdsOff,PassAttOff,PassCompOff,PassYdsOff,PassIntOff,FumblesOff,Opponent,ScoreDef,RushAttDef,RushYdsDef,PassAttDef,PassCompDef,PassYdsDef,PassIntDef,FumblesDef,ScoreDiff,RushAttDiff,RushYdsDiff,PassAttDiff,PassCompDiff,PassYdsDiff,PassIntDiff,FumblesDiff
0,08/26/2000,Brigham Young,3.0,24,-2,46,18,227,3,0,Florida State,29.0,36,57,51,32,318,0,1,-26.0,-12,-59,-5,-14,-91,3,-1
1,08/26/2000,Florida State,29.0,36,57,51,32,318,0,1,Brigham Young,3.0,24,-2,46,18,227,3,0,26.0,12,59,5,14,91,-3,1
2,08/26/2000,Iowa,7.0,30,80,26,10,76,1,0,Kansas State,27.0,47,178,28,14,250,2,1,-20.0,-17,-98,-2,-4,-174,-1,-1
3,08/26/2000,Kansas State,27.0,47,178,28,14,250,2,1,Iowa,7.0,30,80,26,10,76,1,0,20.0,17,98,2,4,174,1,1
4,08/26/2000,Louisiana Tech,63.0,37,190,34,29,362,1,2,Miss Valley State,10.0,36,97,33,14,186,2,0,53.0,1,93,1,15,176,-1,2
5,08/26/2000,New Mexico,3.0,52,115,18,6,52,1,2,Texas Tech,24.0,24,69,47,21,186,1,0,-21.0,28,46,-29,-15,-134,0,2
6,08/26/2000,Penn State,5.0,22,6,30,10,136,1,0,Southern Cal,29.0,50,164,20,10,87,1,0,-24.0,-28,-158,10,0,49,0,0
7,08/26/2000,Southern Cal,29.0,50,164,20,10,87,1,0,Penn State,5.0,22,6,30,10,136,1,0,24.0,28,158,-10,0,-49,0,0
8,08/26/2000,Texas Tech,24.0,24,69,47,21,186,1,0,New Mexico,3.0,52,115,18,6,52,1,2,21.0,-28,-46,29,15,134,0,-2
9,09/02/2000,Air Force,55.0,74,583,20,11,115,1,0,Northridge State,6.0,32,125,29,15,102,1,2,49.0,42,458,-9,-4,13,0,-2
10,09/02/2000,Akron,23.0,44,162,30,14,248,1,1,Virginia Tech,52.0,48,335,16,9,214,1,3,-29.0,-4,-173,14,5,34,0,-2
11,09/02/2000,Arkansas State,31.0,45,179,25,13,152,0,2,No Carolina State,38.0,35,142,57,29,397,0,3,-7.0,10,37,-32,-16,-245,0,-1
12,09/02/2000,Alabama,24.0,30,146,30,11,119,1,2,U.C.L.A.,35.0,57,171,27,15,225,1,0,-11.0,-27,-25,3,-4,-106,0,2
13,09/02/2000,Arizona,17.0,39,135,15,3,11,0,0,Utah,3.0,39,60,51,21,310,2,3,14.0,0,75,-36,-18,-299,-2,-3
14,09/02/2000,Arkansas,38.0,49,183,29,20,249,0,0,S W Missouri St,0.0,22,47,20,8,51,1,1,38.0,27,136,9,12,198,-1,-1
15,09/02/2000,Army,17.0,34,120,29,14,123,1,1,Cincinnati,23.0,51,198,29,18,239,2,0,-6.0,-17,-78,0,-4,-116,-1,1
16,09/02/2000,Auburn,35.0,45,177,21,12,266,0,2,Wyoming,21.0,27,29,36,20,213,1,0,14.0,18,148,-15,-8,53,-1,2
17,09/02/2000,Arizona State,10.0,40,110,42,18,160,1,0,San Diego State,7.0,28,100,57,24,219,1,0,3.0,12,10,-15,-6,-59,0,0
18,09/02/2000,Ball State,19.0,34,85,26,14,174,1,2,Florida,40.0,32,130,46,21,327,0,1,-21.0,2,-45,-20,-7,-153,1,1
19,09/02/2000,Baylor,20.0,36,107,30,18,218,0,0,North Texas,7.0,34,95,17,10,144,2,2,13.0,2,12,13,8,74,-2,-2
20,09/02/2000,Boise State,31.0,35,139,34,17,168,0,0,New Mexico,14.0,44,156,26,12,122,2,0,17.0,-9,-17,8,5,46,-2,0
21,09/02/2000,Boston College,14.0,33,79,33,15,127,3,2,West Virginia,34.0,53,189,19,7,166,0,0,-20.0,-20,-110,14,8,-39,3,2
22,09/02/2000,Bowling Green,7.0,28,58,42,18,213,1,0,Michigan,42.0,53,289,19,15,265,0,2,-35.0,-25,-231,23,3,-52,1,-2
23,09/02/2000,Buffalo,7.0,33,102,36,16,168,2,3,Syracuse,63.0,50,304,9,6,82,1,0,-56.0,-17,-202,27,10,86,1,3
24,09/02/2000,Brigham Young,38.0,34,93,42,34,447,2,1,Virginia,35.0,42,270,23,13,217,1,0,3.0,-8,-177,19,21,230,1,1
25,09/02/2000,Central Florida,17.0,26,8,31,16,247,1,1,Georgia Tech,21.0,44,110,41,23,226,0,2,-4.0,-18,-102,-10,-7,21,1,-1
26,09/02/2000,Cincinnati,23.0,51,198,29,18,239,2,0,Army,17.0,34,120,29,14,123,1,1,6.0,17,78,0,4,116,1,-1
27,09/02/2000,Clemson,38.0,48,236,33,21,222,0,0,The Citadel,0.0,42,57,16,6,48,1,1,38.0,6,179,17,15,174,-1,-1
28,09/02/2000,Central Michigan,0.0,38,65,28,16,150,0,3,Purdue,48.0,40,145,45,26,336,0,0,-48.0,-2,-80,-17,-10,-186,0,3
29,09/02/2000,Colorado,24.0,45,223,39,25,309,0,0,Colorado State,28.0,28,65,30,19,327,2,0,-4.0,17,158,9,6,-18,-2,0
30,09/02/2000,Colorado State,28.0,28,65,30,19,327,2,0,Colorado,24.0,45,223,39,25,309,0,0,4.0,-17,-158,-9,-6,18,2,0
31,09/02/2000,Duke,0.0,31,44,25,10,96,3,0,East Carolina,38.0,43,164,31,22,264,0,1,-38.0,-12,-120,-6,-12,-168,3,-1
32,09/02/2000,East Carolina,38.0,43,164,31,22,264,0,1,Duke,0.0,31,44,25,10,96,3,0,38.0,12,120,6,12,168,-3,1
33,09/02/2000,Eastern Michigan,32.0,45,150,35,21,205,0,2,Connecticut,25.0,25,62,49,23,340,1,1,7.0,20,88,-14,-2,-135,-1,1
34,09/02/2000,Florida,40.0,32,130,46,21,327,0,1,Ball State,19.0,34,85,26,14,174,1,2,21.0,-2,45,20,7,153,-1,-1
35,09/02/2000,Fresno State,10.0,27,87,51,31,285,4,2,Ohio State,43.0,50,223,20,11,166,0,1,-33.0,-23,-136,31,20,119,4,1
36,09/02/2000,Georgia,29.0,39,171,27,16,203,1,2,Georgia Southern,7.0,54,190,19,10,45,0,2,22.0,-15,-19,8,6,158,1,0
37,09/02/2000,Georgia Tech,21.0,44,110,41,23,226,0,2,Central Florida,17.0,26,8,31,16,247,1,1,4.0,18,102,10,7,-21,-1,1
38,09/02/2000,Houston,27.0,29,45,47,32,339,1,2,Rice,30.0,61,198,16,5,85,0,2,-3.0,-32,-153,31,27,254,1,0
39,09/02/2000,Iowa State,25.0,40,204,30,16,196,1,0,Ohio,15.0,41,179,25,9,130,2,2,10.0,-1,25,5,7,66,-1,-2
40,09/02/2000,Idaho,20.0,33,145,30,23,256,1,4,Washington,44.0,44,239,31,17,235,1,0,-24.0,-11,-94,-1,6,21,0,4
41,09/02/2000,Illinois,35.0,49,285,27,19,190,1,0,Mid Tennessee St,6.0,35,207,40,25,262,2,0,29.0,14,78,-13,-6,-72,-1,0
42,09/02/2000,Kansas,17.0,32,81,42,16,210,0,3,Southern Methodist,31.0,44,151,25,14,164,1,0,-14.0,-12,-70,17,2,46,-1,3
43,09/02/2000,Kent State,7.0,35,83,32,18,205,2,0,Pittsburgh,30.0,32,119,26,13,293,0,0,-23.0,3,-36,6,5,-88,2,0
44,09/02/2000,Kansas State,54.0,41,267,23,13,233,0,2,Louisiana Tech,10.0,29,72,54,33,319,4,1,44.0,12,195,-31,-20,-86,-4,1
45,09/02/2000,Kentucky,34.0,21,95,34,22,322,3,2,Louisville,40.0,48,186,30,16,256,0,4,-6.0,-27,-91,4,6,66,3,-2
46,09/02/2000,Louisville,40.0,48,186,30,16,256,0,4,Kentucky,34.0,21,95,34,22,322,3,2,6.0,27,91,-4,-6,-66,-3,2
47,09/02/2000,Louisiana State,58.0,43,195,28,23,485,0,0,Western Carolina,0.0,32,96,22,11,71,1,1,58.0,11,99,6,12,414,-1,-1
48,09/02/2000,Louisiana Tech,10.0,29,72,54,33,319,4,1,Kansas State,54.0,41,267,23,13,233,0,2,-44.0,-12,-195,31,20,86,4,-1
49,09/02/2000,Marshall,63.0,50,315,26,18,263,0,1,S E Missouri St,7.0,37,133,28,13,126,2,1,56.0,13,182,-2,5,137,-2,0
50,09/02/2000,Memphis,3.0,41,87,34,10,81,2,3,Mississippi State,17.0,35,45,20,10,82,1,1,-14.0,6,42,14,0,-1,1,2
51,09/02/2000,"Miami, Florida",61.0,30,287,37,22,341,0,1,McNeese State,14.0,44,197,33,19,212,3,1,47.0,-14,90,4,3,129,-3,0
52,09/02/2000,"Miami, Ohio",33.0,28,71,42,24,358,1,1,Vanderbilt,30.0,32,56,25,18,307,0,0,3.0,-4,15,17,6,51,1,1
53,09/02/2000,Michigan,42.0,53,289,19,15,265,0,2,Bowling Green,7.0,28,58,42,18,213,1,0,35.0,25,231,-23,-3,52,-1,2
54,09/02/2000,Minnesota,47.0,46,172,28,18,258,0,0,UL-Monroe,10.0,33,59,32,17,173,0,2,37.0,13,113,-4,1,85,0,-2
55,09/02/2000,Mississippi,49.0,35,118,31,19,306,0,0,Tulane,20.0,35,120,38,17,204,1,0,29.0,0,-2,-7,2,102,-1,0
56,09/02/2000,Missouri,50.0,43,137,26,11,166,1,1,Western Illinois,20.0,39,-2,35,16,253,1,3,30.0,4,139,-9,-5,-87,0,-2
57,09/02/2000,Mississippi State,17.0,35,45,20,10,82,1,1,Memphis,3.0,41,87,34,10,81,2,3,14.0,-6,-42,-14,0,1,-1,-2
58,09/02/2000,Mid Tennessee St,6.0,35,207,40,25,262,2,0,Illinois,35.0,49,285,27,19,190,1,0,-29.0,-14,-78,13,6,72,1,0
59,09/02/2000,Navy,6.0,30,73,13,6,75,0,0,Temple,17.0,58,231,27,17,188,0,2,-11.0,-28,-158,-14,-11,-113,0,-2
60,09/02/2000,North Carolina,30.0,44,173,30,16,242,0,2,Tulsa,9.0,27,19,38,17,214,0,1,21.0,17,154,-8,-1,28,0,1
61,09/02/2000,No Carolina State,38.0,35,142,57,29,397,0,3,Arkansas State,31.0,45,179,25,13,152,0,2,7.0,-10,-37,32,16,245,0,1
62,09/02/2000,Notre Dame,24.0,49,194,16,10,133,0,0,Texas A & M,10.0,37,90,28,16,165,1,0,14.0,12,104,-12,-6,-32,-1,0
63,09/02/2000,Nebraska,49.0,60,505,13,5,91,3,0,San Jose State,13.0,29,193,37,14,153,1,0,36.0,31,312,-24,-9,-62,2,0
64,09/02/2000,UL-Monroe,10.0,33,59,32,17,173,0,2,Minnesota,47.0,46,172,28,18,258,0,0,-37.0,-13,-113,4,-1,-85,0,2
65,09/02/2000,Nevada,7.0,34,-3,30,8,106,3,0,Oregon,36.0,42,225,27,12,231,1,1,-29.0,-8,-228,3,-4,-125,2,-1
66,09/02/2000,Northern Illinois,17.0,34,112,40,20,254,2,1,Northwestern,35.0,57,236,27,16,176,0,1,-18.0,-23,-124,13,4,78,2,0
67,09/02/2000,New Mexico,14.0,44,156,26,12,122,2,0,Boise State,31.0,35,139,34,17,168,0,0,-17.0,9,17,-8,-5,-46,2,0
68,09/02/2000,New Mexico State,0.0,46,121,19,8,76,2,1,South Carolina,31.0,39,204,26,14,149,1,2,-31.0,7,-83,-7,-6,-73,1,-1
69,09/02/2000,North Texas,7.0,34,95,17,10,144,2,2,Baylor,20.0,36,107,30,18,218,0,0,-13.0,-2,-12,-13,-8,-74,2,2
70,09/02/2000,Northwestern,35.0,57,236,27,16,176,0,1,Northern Illinois,17.0,34,112,40,20,254,2,1,18.0,23,124,-13,-4,-78,-2,0
71,09/02/2000,Ohio,15.0,41,179,25,9,130,2,2,Iowa State,25.0,40,204,30,16,196,1,0,-10.0,1,-25,-5,-7,-66,1,2
72,09/02/2000,Ohio State,43.0,50,223,20,11,166,0,1,Fresno State,10.0,27,87,51,31,285,4,2,33.0,23,136,-31,-20,-119,-4,-1
73,09/02/2000,Oklahoma,55.0,33,122,39,19,287,1,2,Texas-El Paso,14.0,38,125,42,21,217,2,5,41.0,-5,-3,-3,-2,70,-1,-3
74,09/02/2000,Oregon,36.0,42,225,27,12,231,1,1,Nevada,7.0,34,-3,30,8,106,3,0,29.0,8,228,-3,4,125,-2,1
75,09/02/2000,Oregon State,21.0,49,194,29,13,132,2,2,Eastern Washington,19.0,33,58,30,13,139,1,2,2.0,16,136,-1,0,-7,1,0
76,09/02/2000,Penn State,6.0,27,30,24,10,136,0,1,Toledo,24.0,54,245,28,18,140,0,0,-18.0,-27,-215,-4,-8,-4,0,1
77,09/02/2000,Pittsburgh,30.0,32,119,26,13,293,0,0,Kent State,7.0,35,83,32,18,205,2,0,23.0,-3,36,-6,-5,88,-2,0
78,09/02/2000,Purdue,48.0,40,145,45,26,336,0,0,Central Michigan,0.0,38,65,28,16,150,0,3,48.0,2,80,17,10,186,0,-3
79,09/02/2000,Rice,30.0,61,198,16,5,85,0,2,Houston,27.0,29,45,47,32,339,1,2,3.0,32,153,-31,-27,-254,-1,0
80,09/02/2000,Rutgers,34.0,32,46,44,27,323,1,0,Villanova,21.0,23,57,49,29,285,2,1,13.0,9,-11,-5,-2,38,-1,-1
81,09/02/2000,South Carolina,31.0,39,204,26,14,149,1,2,New Mexico State,0.0,46,121,19,8,76,2,1,31.0,-7,83,7,6,73,-1,1
82,09/02/2000,San Diego State,7.0,28,100,57,24,219,1,0,Arizona State,10.0,40,110,42,18,160,1,0,-3.0,-12,-10,15,6,59,0,0
83,09/02/2000,San Jose State,13.0,29,193,37,14,153,1,0,Nebraska,49.0,60,505,13,5,91,3,0,-36.0,-31,-312,24,9,62,-2,0
84,09/02/2000,Southern Miss,16.0,31,71,30,22,232,0,2,Tennessee,19.0,40,145,25,13,125,1,0,-3.0,-9,-74,5,9,107,-1,2
85,09/02/2000,Southern Methodist,31.0,44,151,25,14,164,1,0,Kansas,17.0,32,81,42,16,210,0,3,14.0,12,70,-17,-2,-46,1,-3
86,09/02/2000,Stanford,24.0,38,118,28,17,256,0,1,Washington State,10.0,36,91,36,20,161,2,0,14.0,2,27,-8,-3,95,-2,1
87,09/02/2000,UL-Lafayette,14.0,44,150,24,9,90,0,1,Sam Houston State,21.0,35,98,30,17,151,1,1,-7.0,9,52,-6,-8,-61,-1,0
88,09/02/2000,Syracuse,63.0,50,304,9,6,82,1,0,Buffalo,7.0,33,102,36,16,168,2,3,56.0,17,202,-27,-10,-86,-1,-3
89,09/02/2000,Temple,17.0,58,231,27,17,188,0,2,Navy,6.0,30,73,13,6,75,0,0,11.0,28,158,14,11,113,0,2
90,09/02/2000,Tennessee,19.0,40,145,25,13,125,1,0,Southern Miss,16.0,31,71,30,22,232,0,2,3.0,9,74,-5,-9,-107,1,-2
91,09/02/2000,Toledo,24.0,54,245,28,18,140,0,0,Penn State,6.0,27,30,24,10,136,0,1,18.0,27,215,4,8,4,0,-1
92,09/02/2000,Texas Tech,38.0,28,77,57,37,505,1,0,Utah State,16.0,28,147,35,16,153,1,2,22.0,0,-70,22,21,352,0,-2
93,09/02/2000,Tulane,20.0,35,120,38,17,204,1,0,Mississippi,49.0,35,118,31,19,306,0,0,-29.0,0,2,7,-2,-102,1,0
94,09/02/2000,Tulsa,9.0,27,19,38,17,214,0,1,North Carolina,30.0,44,173,30,16,242,0,2,-21.0,-17,-154,8,1,-28,0,-1
95,09/02/2000,Texas A & M,10.0,37,90,28,16,165,1,0,Notre Dame,24.0,49,194,16,10,133,0,0,-14.0,-12,-104,12,6,32,1,0
96,09/02/2000,U.C.L.A.,35.0,57,171,27,15,225,1,0,Alabama,24.0,30,146,30,11,119,1,2,11.0,27,25,-3,4,106,0,-2
97,09/02/2000,Utah,3.0,39,60,51,21,310,2,3,Arizona,17.0,39,135,15,3,11,0,0,-14.0,0,-75,36,18,299,2,3
98,09/02/2000,Texas-El Paso,14.0,38,125,42,21,217,2,5,Oklahoma,55.0,33,122,39,19,287,1,2,-41.0,5,3,3,2,-70,1,3
99,09/02/2000,Utah State,16.0,28,147,35,16,153,1,2,Texas Tech,38.0,28,77,57,37,505,1,0,-22.0,0,70,-22,-21,-352,0,2
100,09/02/2000,Vanderbilt,30.0,32,56,25,18,307,0,0,"Miami, Ohio",33.0,28,71,42,24,358,1,1,-3.0,4,-15,-17,-6,-51,-1,-1
101,09/02/2000,Virginia,35.0,42,270,23,13,217,1,0,Brigham Young,38.0,34,93,42,34,447,2,1,-3.0,8,177,-19,-21,-230,-1,-1
102,09/02/2000,Virginia Tech,52.0,48,335,16,9,214,1,3,Akron,23.0,44,162,30,14,248,1,1,29.0,4,173,-14,-5,-34,0,2
103,09/02/2000,Washington,44.0,44,239,31,17,235,1,0,Idaho,20.0,33,145,30,23,256,1,4,24.0,11,94,1,-6,-21,0,-4
104,09/02/2000,Washington State,10.0,36,91,36,20,161,2,0,Stanford,24.0,38,118,28,17,256,0,1,-14.0,-2,-27,8,3,-95,2,-1
105,09/02/2000,Wake Forest,16.0,33,55,21,10,126,2,2,Appalachian State,20.0,50,147,34,19,235,2,2,-4.0,-17,-92,-13,-9,-109,0,0
106,09/02/2000,Wisconsin,19.0,57,156,11,6,96,0,0,Western Michigan,7.0,20,-1,39,20,243,1,1,12.0,37,157,-28,-14,-147,-1,-1
107,09/02/2000,Western Michigan,7.0,20,-1,39,20,243,1,1,Wisconsin,19.0,57,156,11,6,96,0,0,-12.0,-37,-157,28,14,147,1,1
108,09/02/2000,West Virginia,34.0,53,189,19,7,166,0,0,Boston College,14.0,33,79,33,15,127,3,2,20.0,20,110,-14,-8,39,-3,-2
109,09/02/2000,Wyoming,21.0,27,29,36,20,213,1,0,Auburn,35.0,45,177,21,12,266,0,2,-14.0,-18,-148,15,8,-53,1,-2
110,09/09/2000,Air Force,31.0,53,186,16,11,203,0,0,Brigham Young,23.0,26,125,40,18,235,1,2,8.0,27,61,-24,-7,-32,-1,-2
111,09/09/2000,Akron,7.0,39,184,24,8,68,2,0,Central Michigan,17.0,50,171,19,9,173,0,0,-10.0,-11,13,5,-1,-105,2,0
112,09/09/2000,Arkansas State,7.0,21,84,33,21,191,1,0,Oklahoma,45.0,35,208,34,26,325,1,0,-38.0,-14,-124,-1,-5,-134,0,0
113,09/09/2000,Alabama,28.0,42,292,15,6,57,0,0,Vanderbilt,10.0,31,85,26,12,172,0,0,18.0,11,207,-11,-6,-115,0,0
114,09/09/2000,Arizona,17.0,39,57,23,11,137,0,1,Ohio State,27.0,40,101,20,12,240,1,2,-10.0,-1,-44,3,-1,-103,-1,-1
115,09/09/2000,Army,17.0,39,161,38,20,193,3,0,Boston College,55.0,48,252,30,20,335,0,0,-38.0,-9,-91,8,0,-142,3,0
116,09/09/2000,Auburn,35.0,51,261,26,13,160,0,1,Mississippi,27.0,32,152,26,11,105,3,0,8.0,19,109,0,2,55,-3,1
117,09/09/2000,Ball State,14.0,36,165,33,16,156,4,1,Western Illinois,24.0,50,196,18,6,66,1,1,-10.0,-14,-31,15,10,90,3,0
118,09/09/2000,Boise State,42.0,37,238,26,17,351,2,0,Northern Iowa,17.0,43,134,36,18,243,0,1,25.0,-6,104,-10,-1,108,2,-1
119,09/09/2000,Boston College,55.0,48,252,30,20,335,0,0,Army,17.0,39,161,38,20,193,3,0,38.0,9,91,-8,0,142,-3,0
120,09/09/2000,Bowling Green,16.0,39,35,39,19,197,1,1,Pittsburgh,34.0,35,36,32,22,321,0,3,-18.0,4,-1,7,-3,-124,1,-2
121,09/09/2000,Buffalo,0.0,37,-7,45,24,223,1,3,Rutgers,59.0,39,187,29,19,266,0,1,-59.0,-2,-194,16,5,-43,1,2
122,09/09/2000,Brigham Young,23.0,26,125,40,18,235,1,2,Air Force,31.0,53,186,16,11,203,0,0,-8.0,-27,-61,24,7,32,1,2
123,09/09/2000,California,24.0,45,120,28,18,209,1,2,Utah,21.0,38,139,31,16,158,1,3,3.0,7,-19,-3,2,51,0,-1
124,09/09/2000,Central Florida,19.0,33,132,34,21,253,1,0,Northwestern St(LA),7.0,42,189,31,9,128,1,1,12.0,-9,-57,3,12,125,0,-1
125,09/09/2000,Cincinnati,12.0,35,155,35,16,188,0,2,Syracuse,10.0,37,105,30,21,221,2,1,2.0,-2,50,5,-5,-33,-2,1
126,09/09/2000,Clemson,62.0,50,206,24,15,275,0,1,Missouri,9.0,36,72,28,14,144,3,3,53.0,14,134,-4,1,131,-3,-2
127,09/09/2000,Central Michigan,17.0,50,171,19,9,173,0,0,Akron,7.0,39,184,24,8,68,2,0,10.0,11,-13,-5,1,105,-2,0
128,09/09/2000,Colorado,14.0,38,137,27,17,231,0,1,Southern Cal,17.0,38,158,31,25,275,1,0,-3.0,0,-21,-4,-8,-44,-1,1
129,09/09/2000,Colorado State,41.0,43,297,34,22,219,1,1,East Tennessee St,7.0,36,127,25,13,154,1,3,34.0,7,170,9,9,65,0,-2
130,09/09/2000,Duke,5.0,32,44,32,11,130,4,0,Northwestern,38.0,52,259,30,18,213,0,0,-33.0,-20,-215,2,-7,-83,4,0
131,09/09/2000,East Carolina,28.0,39,87,47,23,331,3,0,Virginia Tech,45.0,36,205,16,9,106,0,1,-17.0,3,-118,31,14,225,3,-1
132,09/09/2000,Eastern Michigan,17.0,32,135,43,23,228,1,0,"Miami, Ohio",34.0,42,179,29,13,232,1,1,-17.0,-10,-44,14,10,-4,0,-1
133,09/09/2000,Florida,55.0,30,158,41,26,299,1,2,Mid Tennessee St,0.0,35,90,32,17,139,1,4,55.0,-5,68,9,9,160,0,-2
134,09/09/2000,Fresno State,21.0,23,26,33,20,249,0,1,U.C.L.A.,24.0,48,135,33,17,135,0,0,-3.0,-25,-109,0,3,114,0,1
135,09/09/2000,Florida State,26.0,34,73,40,26,463,1,1,Georgia Tech,21.0,34,79,37,22,219,0,0,5.0,0,-6,3,4,244,1,1
136,09/09/2000,Georgia,10.0,28,94,24,10,108,5,0,South Carolina,21.0,43,133,28,18,154,1,0,-11.0,-15,-39,-4,-8,-46,4,0
137,09/09/2000,Georgia Tech,21.0,34,79,37,22,219,0,0,Florida State,26.0,34,73,40,26,463,1,1,-5.0,0,6,-3,-4,-244,-1,-1
138,09/09/2000,Houston,13.0,27,84,54,29,354,2,2,Louisiana State,28.0,39,120,26,12,177,2,1,-15.0,-12,-36,28,17,177,0,1
139,09/09/2000,Iowa State,37.0,42,150,31,16,286,1,0,Nevada-Las Vegas,22.0,47,197,25,9,190,1,1,15.0,-5,-47,6,7,96,0,-1
140,09/09/2000,Idaho,38.0,39,131,47,31,303,3,0,Montana,45.0,19,48,52,33,505,0,2,-7.0,20,83,-5,-2,-202,3,-2
141,09/09/2000,Illinois,49.0,44,259,26,19,158,0,2,San Diego State,13.0,34,99,36,19,151,2,0,36.0,10,160,-10,0,7,-2,2
142,09/09/2000,Indiana,38.0,44,236,27,14,240,0,1,No Carolina State,41.0,23,73,52,31,401,1,0,-3.0,21,163,-25,-17,-161,-1,1
143,09/09/2000,Iowa,21.0,31,49,34,23,314,0,2,Western Michigan,27.0,36,59,31,21,294,1,1,-6.0,-5,-10,3,2,20,-1,1
144,09/09/2000,Kent State,10.0,33,129,30,20,190,0,1,Purdue,45.0,37,168,54,36,437,1,2,-35.0,-4,-39,-24,-16,-247,-1,-1
145,09/09/2000,Kentucky,27.0,30,145,58,30,382,1,0,South Florida,9.0,36,134,24,19,81,1,1,18.0,-6,11,34,11,301,0,-1
146,09/09/2000,Louisville,52.0,39,226,26,22,202,1,2,Grambling,0.0,37,-56,33,13,116,1,2,52.0,2,282,-7,9,86,0,0
147,09/09/2000,Louisiana State,28.0,39,120,26,12,177,2,1,Houston,13.0,27,84,54,29,354,2,2,15.0,12,36,-28,-17,-177,0,-1
148,09/09/2000,Louisiana Tech,7.0,19,45,33,16,122,5,2,Penn State,67.0,63,299,22,16,194,0,2,-60.0,-44,-254,11,0,-72,5,0
149,09/09/2000,Marshall,24.0,19,51,44,27,227,3,1,Michigan State,34.0,43,221,31,21,212,2,1,-10.0,-24,-170,13,6,15,1,0
150,09/09/2000,Michigan State,34.0,43,221,31,21,212,2,1,Marshall,24.0,19,51,44,27,227,3,1,10.0,24,170,-13,-6,-15,-1,0
151,09/09/2000,Maryland,17.0,36,100,23,11,154,0,3,Temple,10.0,36,104,37,25,339,1,1,7.0,0,-4,-14,-14,-185,-1,2
152,09/09/2000,Memphis,28.0,46,180,24,13,98,0,2,UL-Monroe,0.0,19,44,43,17,132,2,1,28.0,27,136,-19,-4,-34,-2,1
153,09/09/2000,"Miami, Florida",29.0,33,158,34,15,215,0,3,Washington,34.0,46,128,31,18,223,2,1,-5.0,-13,30,3,-3,-8,-2,2
154,09/09/2000,"Miami, Ohio",34.0,42,179,29,13,232,1,1,Eastern Michigan,17.0,32,135,43,23,228,1,0,17.0,10,44,-14,-10,4,0,1
155,09/09/2000,Michigan,38.0,49,230,19,13,166,0,0,Rice,7.0,46,164,11,5,107,0,2,31.0,3,66,8,8,59,0,-2
156,09/09/2000,Minnesota,17.0,26,147,28,10,223,1,1,Ohio,23.0,73,363,9,3,90,0,0,-6.0,-47,-216,19,7,133,1,1
157,09/09/2000,Mississippi,27.0,32,152,26,11,105,3,0,Auburn,35.0,51,261,27,13,160,0,1,-8.0,-19,-109,-1,-2,-55,3,-1
158,09/09/2000,Missouri,9.0,36,72,28,14,144,3,3,Clemson,62.0,50,206,24,15,275,0,1,-53.0,-14,-134,4,-1,-131,3,2
159,09/09/2000,Mid Tennessee St,0.0,35,90,32,17,139,1,4,Florida,55.0,30,158,41,26,299,1,2,-55.0,5,-68,-9,-9,-160,0,2
160,09/09/2000,North Carolina,35.0,49,129,13,7,194,0,1,Wake Forest,14.0,40,-2,34,14,164,0,1,21.0,9,131,-21,-7,30,0,0
161,09/09/2000,No Carolina State,41.0,23,73,52,31,401,1,0,Indiana,38.0,44,236,27,14,240,0,1,3.0,-21,-163,25,17,161,1,-1
162,09/09/2000,Notre Dame,24.0,40,184,15,3,40,1,0,Nebraska,27.0,59,274,15,7,103,1,0,-3.0,-19,-90,0,-4,-63,0,0
163,09/09/2000,Nebraska,27.0,59,274,15,7,103,1,0,Notre Dame,24.0,40,184,15,3,40,1,0,3.0,19,90,0,4,63,0,0
164,09/09/2000,UL-Monroe,0.0,19,44,43,17,132,2,1,Memphis,28.0,46,180,24,13,98,0,2,-28.0,-27,-136,19,4,34,2,-1
165,09/09/2000,Nevada,10.0,36,11,47,23,259,0,1,Texas Christian,41.0,55,317,10,3,53,2,2,-31.0,-19,-306,37,20,206,-2,-1
166,09/09/2000,Northern Illinois,52.0,65,305,18,9,117,1,0,Illinois State,0.0,28,73,28,12,134,4,0,52.0,37,232,-10,-3,-17,-3,0
167,09/09/2000,New Mexico,20.0,31,42,21,12,130,2,1,Oregon State,28.0,49,222,28,12,78,0,1,-8.0,-18,-180,-7,0,52,2,0
168,09/09/2000,North Texas,7.0,33,49,13,6,107,0,2,Texas Tech,13.0,29,80,55,42,238,3,0,-6.0,4,-31,-42,-36,-131,-3,2
169,09/09/2000,Northwestern,38.0,52,259,30,18,213,0,0,Duke,5.0,32,44,32,11,130,4,0,33.0,20,215,-2,7,83,-4,0
170,09/09/2000,Ohio,23.0,73,363,9,3,90,0,0,Minnesota,17.0,26,147,28,10,223,1,1,6.0,47,216,-19,-7,-133,-1,-1
171,09/09/2000,Ohio State,27.0,40,101,20,12,240,1,2,Arizona,17.0,39,57,23,11,137,0,1,10.0,1,44,-3,1,103,1,1
172,09/09/2000,Oklahoma,45.0,35,208,34,26,325,1,0,Arkansas State,7.0,21,84,33,21,191,1,0,38.0,14,124,1,5,134,0,0
173,09/09/2000,Oklahoma State,36.0,38,247,20,11,166,0,1,Tulsa,26.0,30,62,49,28,373,1,2,10.0,8,185,-29,-17,-207,-1,-1
174,09/09/2000,Oregon,23.0,25,92,49,22,362,3,0,Wisconsin,27.0,43,302,13,5,65,1,0,-4.0,-18,-210,36,17,297,2,0
175,09/09/2000,Oregon State,28.0,49,222,28,12,78,0,1,New Mexico,20.0,31,42,21,12,130,2,1,8.0,18,180,7,0,-52,-2,0
176,09/09/2000,Penn State,67.0,63,299,22,16,194,0,2,Louisiana Tech,7.0,19,45,33,16,122,5,2,60.0,44,254,-11,0,72,-5,0
177,09/09/2000,Pittsburgh,34.0,35,36,32,22,321,0,3,Bowling Green,16.0,39,35,39,19,197,1,1,18.0,-4,1,-7,3,124,-1,2
178,09/09/2000,Purdue,45.0,37,168,54,36,437,1,2,Kent State,10.0,33,129,30,20,190,0,1,35.0,4,39,24,16,247,1,1
179,09/09/2000,Rice,7.0,46,164,11,5,107,0,2,Michigan,38.0,49,230,19,13,166,0,0,-31.0,-3,-66,-8,-8,-59,0,2
180,09/09/2000,Rutgers,59.0,39,187,29,19,266,0,1,Buffalo,0.0,37,-7,45,24,223,1,3,59.0,2,194,-16,-5,43,-1,-2
181,09/09/2000,Southern Cal,17.0,38,158,31,25,275,1,0,Colorado,14.0,38,137,27,17,231,0,1,3.0,0,21,4,8,44,1,-1
182,09/09/2000,South Carolina,21.0,43,133,28,18,154,1,0,Georgia,10.0,28,94,24,10,108,5,0,11.0,15,39,4,8,46,-4,0
183,09/09/2000,San Diego State,13.0,34,99,36,19,151,2,0,Illinois,49.0,44,259,26,19,158,0,2,-36.0,-10,-160,10,0,-7,2,-2
184,09/09/2000,San Jose State,40.0,34,284,30,18,199,0,1,Stanford,27.0,44,241,42,18,373,1,2,13.0,-10,43,-12,0,-174,-1,-1
185,09/09/2000,Southern Methodist,20.0,24,75,46,22,420,2,0,Texas-El Paso,37.0,47,204,19,13,206,0,0,-17.0,-23,-129,27,9,214,2,0
186,09/09/2000,Stanford,27.0,44,241,42,18,373,1,2,San Jose State,40.0,34,284,30,18,199,0,1,-13.0,10,-43,12,0,174,1,1
187,09/09/2000,UL-Lafayette,10.0,42,68,34,17,183,2,0,Texas,52.0,23,87,40,25,403,1,1,-42.0,19,-19,-6,-8,-220,1,-1
188,09/09/2000,Syracuse,10.0,37,105,30,21,221,2,1,Cincinnati,12.0,35,155,35,16,188,0,2,-2.0,2,-50,-5,5,33,2,-1
189,09/09/2000,Texas Christian,41.0,55,317,10,3,53,2,2,Nevada,10.0,36,11,47,23,259,0,1,31.0,19,306,-37,-20,-206,2,1
190,09/09/2000,Temple,10.0,36,104,37,25,339,1,1,Maryland,17.0,36,100,23,11,154,0,3,-7.0,0,4,14,14,185,1,-2
191,09/09/2000,Texas,52.0,23,87,40,25,403,1,1,UL-Lafayette,10.0,42,68,34,17,183,2,0,42.0,-19,19,6,8,220,-1,1
192,09/09/2000,Toledo,51.0,45,205,27,18,201,0,1,Weber State,0.0,35,22,35,17,198,2,3,51.0,10,183,-8,1,3,-2,-2
193,09/09/2000,Texas Tech,13.0,29,80,55,42,238,3,0,North Texas,7.0,33,49,13,6,107,0,2,6.0,-4,31,42,36,131,3,-2
194,09/09/2000,Tulsa,26.0,30,62,49,28,373,1,2,Oklahoma State,36.0,38,247,20,11,166,0,1,-10.0,-8,-185,29,17,207,1,1
195,09/09/2000,Texas A & M,51.0,37,191,25,16,299,0,2,Wyoming,3.0,42,83,32,17,130,1,2,48.0,-5,108,-7,-1,169,-1,0
196,09/09/2000,Alabama-Birmingham,20.0,38,177,28,13,223,2,3,Chattanooga,15.0,29,25,43,24,272,2,1,5.0,9,152,-15,-11,-49,0,2
197,09/09/2000,U.C.L.A.,24.0,48,135,33,17,135,0,0,Fresno State,21.0,23,26,33,20,249,0,1,3.0,25,109,0,-3,-114,0,-1
198,09/09/2000,Nevada-Las Vegas,22.0,47,197,25,9,190,1,1,Iowa State,37.0,42,150,31,16,286,1,0,-15.0,5,47,-6,-7,-96,0,1
199,09/09/2000,Utah,21.0,38,139,31,16,158,1,3,California,24.0,45,120,28,18,209,1,2,-3.0,-7,19,3,-2,-51,0,1
200,09/09/2000,Texas-El Paso,37.0,47,204,19,13,206,0,0,Southern Methodist,20.0,24,75,46,22,420,2,0,17.0,23,129,-27,-9,-214,-2,0
201,09/09/2000,Utah State,30.0,26,29,28,15,225,0,1,Southern Utah,14.0,56,297,24,5,71,3,1,16.0,-30,-268,4,10,154,-3,0
202,09/09/2000,Vanderbilt,10.0,31,85,26,12,172,0,0,Alabama,28.0,42,292,15,6,57,0,0,-18.0,-11,-207,11,6,115,0,0
203,09/09/2000,Virginia,34.0,32,107,28,19,299,0,0,Richmond,6.0,53,228,9,2,13,0,1,28.0,-21,-121,19,17,286,0,-1
204,09/09/2000,Virginia Tech,45.0,36,205,16,9,106,0,1,East Carolina,28.0,39,87,47,23,331,3,0,17.0,-3,118,-31,-14,-225,-3,1
205,09/09/2000,Washington,34.0,46,128,31,18,223,2,1,"Miami, Florida",29.0,33,158,34,15,215,0,3,5.0,13,-30,-3,3,8,2,-2
206,09/09/2000,Wake Forest,14.0,40,-2,34,14,164,0,1,North Carolina,35.0,49,129,13,7,194,0,1,-21.0,-9,-131,21,7,-30,0,0
207,09/09/2000,Wisconsin,27.0,43,302,13,5,65,1,0,Oregon,23.0,25,92,49,22,362,3,0,4.0,18,210,-36,-17,-297,-2,0
208,09/09/2000,Western Michigan,27.0,36,59,31,21,294,1,1,Iowa,21.0,31,49,34,23,314,0,2,6.0,5,10,-3,-2,-20,1,-1
209,09/09/2000,Wyoming,3.0,42,83,32,17,130,1,2,Texas A & M,51.0,37,191,25,16,299,0,2,-48.0,5,-108,7,1,-169,1,0
210,09/16/2000,Akron,35.0,50,279,25,15,228,1,1,Central Florida,24.0,32,126,43,25,306,4,0,11.0,18,153,-18,-10,-78,-3,1
211,09/16/2000,Arkansas State,17.0,28,102,30,17,222,1,0,Memphis,19.0,44,147,23,14,122,0,0,-2.0,-16,-45,7,3,100,1,0
212,09/16/2000,Alabama,0.0,33,95,35,19,122,2,2,Southern Miss,21.0,37,51,23,14,159,1,0,-21.0,-4,44,12,5,-37,1,2
213,09/16/2000,Arizona,17.0,36,185,31,19,200,1,3,San Diego State,3.0,37,72,29,15,124,1,0,14.0,-1,113,2,4,76,0,3
214,09/16/2000,Arkansas,38.0,46,217,28,12,249,1,1,Boise State,31.0,26,74,48,23,304,2,0,7.0,20,143,-20,-11,-55,-1,1
215,09/16/2000,Army,30.0,26,52,41,21,305,0,0,Houston,31.0,46,188,46,29,336,2,2,-1.0,-20,-136,-5,-8,-31,-2,-2
216,09/16/2000,Auburn,34.0,48,196,30,21,225,0,1,Louisiana State,17.0,26,83,30,13,214,1,0,17.0,22,113,0,8,11,-1,1
217,09/16/2000,Arizona State,13.0,48,184,24,11,77,0,0,Colorado State,10.0,34,64,31,14,225,1,1,3.0,14,120,-7,-3,-148,-1,-1
218,09/16/2000,Ball State,0.0,45,46,8,1,5,2,1,Kansas State,76.0,57,322,12,8,192,0,0,-76.0,-12,-276,-4,-7,-187,2,1
219,09/16/2000,Baylor,9.0,26,56,40,15,123,1,1,Minnesota,34.0,58,300,23,15,187,1,1,-25.0,-32,-244,17,0,-64,0,0
220,09/16/2000,Boise State,31.0,26,74,48,23,304,2,0,Arkansas,38.0,46,217,28,12,249,1,1,-7.0,-20,-143,20,11,55,1,-1
221,09/16/2000,Bowling Green,14.0,29,26,28,14,164,0,0,Temple,31.0,38,127,34,24,272,2,0,-17.0,-9,-101,-6,-10,-108,-2,0
222,09/16/2000,Buffalo,21.0,36,101,40,26,259,1,1,Connecticut,24.0,38,139,37,20,199,0,1,-3.0,-2,-38,3,6,60,1,0
223,09/16/2000,Brigham Young,28.0,32,65,50,27,268,2,2,Mississippi State,44.0,33,208,20,13,167,0,2,-16.0,-1,-143,30,14,101,2,0
224,09/16/2000,California,15.0,33,114,32,15,162,0,1,Illinois,17.0,57,222,24,7,112,0,1,-2.0,-24,-108,8,8,50,0,0
225,09/16/2000,Central Florida,24.0,32,126,43,25,306,4,0,Akron,35.0,50,279,25,15,228,1,1,-11.0,-18,-153,18,10,78,3,-1
226,09/16/2000,Cincinnati,25.0,37,113,37,19,238,1,0,Wisconsin,28.0,47,198,21,11,107,0,0,-3.0,-10,-85,16,8,131,1,0
227,09/16/2000,Clemson,55.0,66,436,21,10,187,0,0,Wake Forest,7.0,35,102,17,7,57,0,2,48.0,31,334,4,3,130,0,-2
228,09/16/2000,Central Michigan,10.0,31,43,36,18,240,0,2,Wyoming,31.0,55,321,17,5,47,1,0,-21.0,-24,-278,19,13,193,-1,2
229,09/16/2000,Colorado,14.0,35,70,27,15,173,0,2,Washington,17.0,49,205,29,15,200,2,2,-3.0,-14,-135,-2,0,-27,-2,0
230,09/16/2000,Colorado State,10.0,34,64,31,14,225,1,1,Arizona State,13.0,48,185,24,11,76,0,0,-3.0,-14,-121,7,3,149,1,1
231,09/16/2000,Duke,10.0,34,133,36,18,198,1,0,Virginia,26.0,45,119,30,20,333,0,0,-16.0,-11,14,6,-2,-135,1,0
232,09/16/2000,East Carolina,37.0,44,247,33,13,258,0,0,Tulane,17.0,53,188,35,20,299,0,2,20.0,-9,59,-2,-7,-41,0,-2
233,09/16/2000,Eastern Michigan,6.0,27,43,33,20,149,0,1,South Carolina,41.0,44,336,33,19,240,0,2,-35.0,-17,-293,0,1,-91,0,-1
234,09/16/2000,Florida,27.0,21,39,43,20,290,1,0,Tennessee,23.0,49,203,29,17,140,1,1,4.0,-28,-164,14,3,150,0,-1
235,09/16/2000,Florida State,63.0,41,194,27,15,346,0,0,North Carolina,14.0,44,79,33,16,244,1,3,49.0,-3,115,-6,-1,102,-1,-3
236,09/16/2000,Georgia Tech,40.0,40,139,19,10,166,0,1,Navy,13.0,52,165,40,24,199,0,4,27.0,-12,-26,-21,-14,-33,0,-3
238,09/16/2000,Houston,31.0,46,188,46,29,336,2,2,Army,30.0,26,52,40,20,303,0,0,1.0,20,136,6,9,33,2,2
239,09/16/2000,Iowa State,24.0,46,246,27,18,239,1,0,Iowa,14.0,28,93,41,22,235,1,0,10.0,18,153,-14,-4,4,0,0
240,09/16/2000,Idaho,13.0,25,119,35,15,186,0,2,Oregon,42.0,46,217,30,18,233,0,0,-29.0,-21,-98,5,-3,-47,0,2
241,09/16/2000,Illinois,17.0,57,222,24,7,112,0,1,California,15.0,33,114,32,15,162,0,1,2.0,24,108,-8,-8,-50,0,0
242,09/16/2000,Indiana,34.0,43,232,26,11,143,0,2,Kentucky,41.0,26,79,48,33,339,0,0,-7.0,17,153,-22,-22,-196,0,2
243,09/16/2000,Iowa,14.0,28,93,41,22,235,1,0,Iowa State,24.0,46,246,27,18,239,1,0,-10.0,-18,-153,14,4,-4,0,0
244,09/16/2000,Kansas,23.0,44,209,23,10,152,2,2,Alabama-Birmingham,20.0,51,193,24,10,45,1,0,3.0,-7,16,-1,0,107,1,2
245,09/16/2000,Kent State,20.0,36,97,34,20,178,1,0,Youngstown State,26.0,50,81,15,10,127,0,1,-6.0,-14,16,19,10,51,1,-1
246,09/16/2000,Kansas State,76.0,57,322,12,8,192,0,0,Ball State,0.0,45,46,8,1,5,2,1,76.0,12,276,4,7,187,-2,-1
247,09/16/2000,Kentucky,41.0,26,79,48,33,339,0,0,Indiana,34.0,43,232,26,11,143,0,2,7.0,-17,-153,22,22,196,0,-2
248,09/16/2000,Louisiana State,17.0,26,83,29,12,212,1,0,Auburn,34.0,48,196,30,21,225,0,1,-17.0,-22,-113,-1,-9,-13,1,-1
249,09/16/2000,Louisiana Tech,31.0,38,187,38,26,282,1,1,Stephen F Austin,34.0,47,221,25,14,169,1,0,-3.0,-9,-34,13,12,113,0,1
250,09/16/2000,Michigan State,13.0,46,140,24,10,157,1,1,Missouri,10.0,36,114,31,16,242,0,1,3.0,10,26,-7,-6,-85,1,0
251,09/16/2000,Maryland,17.0,30,71,30,19,215,1,0,West Virginia,30.0,45,276,22,14,165,0,3,-13.0,-15,-205,8,5,50,1,-3
252,09/16/2000,Memphis,19.0,44,147,23,14,122,0,0,Arkansas State,17.0,28,102,30,17,222,1,0,2.0,16,45,-7,-3,-100,-1,0
253,09/16/2000,"Miami, Ohio",16.0,22,132,48,21,236,3,0,Ohio State,27.0,56,273,30,13,194,0,0,-11.0,-34,-141,18,8,42,3,0
254,09/16/2000,Michigan,20.0,46,263,28,8,111,1,1,U.C.L.A.,23.0,39,126,41,22,268,0,3,-3.0,7,137,-13,-14,-157,1,-2
255,09/16/2000,Minnesota,34.0,55,289,20,14,172,1,1,Baylor,9.0,26,56,40,15,123,1,1,25.0,29,233,-20,-1,49,0,0
256,09/16/2000,Mississippi,12.0,37,201,23,14,133,1,0,Vanderbilt,7.0,32,90,45,20,278,2,2,5.0,5,111,-22,-6,-145,-1,-2
257,09/16/2000,Missouri,10.0,36,114,31,16,242,0,1,Michigan State,13.0,46,140,24,10,157,1,1,-3.0,-10,-26,7,6,85,-1,0
258,09/16/2000,Mississippi State,44.0,33,208,20,13,167,0,2,Brigham Young,28.0,32,65,50,27,268,2,2,16.0,1,143,-30,-14,-101,-2,0
259,09/16/2000,Mid Tennessee St,44.0,51,273,35,22,260,1,1,Murray State,28.0,27,62,36,20,225,0,0,16.0,24,211,-1,2,35,1,1
260,09/16/2000,Navy,13.0,52,165,40,24,199,0,4,Georgia Tech,40.0,40,139,19,10,166,0,1,-27.0,12,26,21,14,33,0,3
261,09/16/2000,North Carolina,14.0,44,79,33,16,244,1,3,Florida State,63.0,41,194,27,15,346,0,0,-49.0,3,-115,6,1,-102,1,3
262,09/16/2000,No Carolina State,41.0,25,99,29,18,331,2,1,Southern Methodist,0.0,51,101,31,15,75,4,1,41.0,-26,-2,-2,3,256,-2,0
263,09/16/2000,Notre Dame,23.0,34,78,25,14,158,1,0,Purdue,21.0,43,177,24,13,221,1,1,2.0,-9,-99,1,1,-63,0,-1
264,09/16/2000,UL-Monroe,27.0,38,69,37,25,369,2,1,Nicholls State,21.0,37,156,13,2,0,1,0,6.0,1,-87,24,23,369,1,1
265,09/16/2000,New Mexico,16.0,47,137,15,6,31,0,0,New Mexico State,13.0,42,185,27,10,185,1,2,3.0,5,-48,-12,-4,-154,-1,-2
266,09/16/2000,New Mexico State,13.0,42,185,27,10,185,1,2,New Mexico,16.0,47,137,15,6,31,0,0,-3.0,-5,48,12,4,154,1,2
267,09/16/2000,North Texas,0.0,45,119,37,18,178,0,3,Nevada-Las Vegas,38.0,44,314,15,7,133,0,1,-38.0,1,-195,22,11,45,0,2
268,09/16/2000,Northwestern,14.0,29,113,23,13,145,3,1,Texas Christian,41.0,69,387,12,8,101,1,0,-27.0,-40,-274,11,5,44,2,1
269,09/16/2000,Ohio,52.0,66,429,15,11,168,0,2,Tennessee Tech,14.0,27,95,35,18,180,2,0,38.0,39,334,-20,-7,-12,-2,2
270,09/16/2000,Ohio State,27.0,56,273,30,13,194,0,0,"Miami, Ohio",16.0,22,132,48,21,236,3,0,11.0,34,141,-18,-8,-42,-3,0
271,09/16/2000,Oklahoma State,23.0,41,169,21,10,222,0,1,S W Texas State,0.0,29,36,27,14,105,1,0,23.0,12,133,-6,-4,117,-1,1
272,09/16/2000,Oregon,42.0,46,217,30,18,233,0,0,Idaho,13.0,25,119,35,15,186,0,2,29.0,21,98,-5,3,47,0,-2
273,09/16/2000,Penn State,0.0,33,64,36,18,161,1,1,Pittsburgh,12.0,44,107,19,11,272,1,1,-12.0,-11,-43,17,7,-111,0,0
274,09/16/2000,Pittsburgh,12.0,44,107,19,11,272,1,1,Penn State,0.0,33,64,36,18,161,1,1,12.0,11,43,-17,-7,111,0,0
275,09/16/2000,Purdue,21.0,43,177,24,13,221,1,1,Notre Dame,23.0,34,78,25,14,158,1,0,-2.0,9,99,-1,-1,63,0,1
276,09/16/2000,Rice,16.0,62,335,21,6,82,1,3,Tulsa,23.0,36,73,27,10,194,1,1,-7.0,26,262,-6,-4,-112,0,2
277,09/16/2000,Rutgers,0.0,24,57,49,17,184,4,0,Virginia Tech,49.0,58,348,28,15,179,0,3,-49.0,-34,-291,21,2,5,4,-3
278,09/16/2000,South Carolina,41.0,44,336,33,19,240,0,2,Eastern Michigan,6.0,27,43,33,20,149,0,1,35.0,17,293,0,-1,91,0,1
279,09/16/2000,San Diego State,3.0,37,72,29,15,124,1,0,Arizona,17.0,36,185,31,19,200,1,3,-14.0,1,-113,-2,-4,-76,0,-3
280,09/16/2000,San Jose State,47.0,38,199,21,15,295,2,0,Southern Utah,7.0,62,262,9,6,86,1,2,40.0,-24,-63,12,9,209,1,-2
281,09/16/2000,Southern Miss,21.0,37,51,23,14,159,1,0,Alabama,0.0,33,95,35,19,122,2,2,21.0,4,-44,-12,-5,37,-1,-2
282,09/16/2000,Southern Methodist,0.0,51,101,30,15,75,4,1,No Carolina State,41.0,25,99,29,18,331,2,1,-41.0,26,2,1,-3,-256,2,0
283,09/16/2000,Stanford,27.0,37,60,37,15,255,0,0,Texas,24.0,28,13,46,21,330,2,0,3.0,9,47,-9,-6,-75,-2,0
284,09/16/2000,UL-Lafayette,0.0,34,94,22,11,85,3,0,Texas Tech,26.0,31,101,37,24,240,2,0,-26.0,3,-7,-15,-13,-155,1,0
285,09/16/2000,Texas Christian,41.0,69,387,12,8,101,1,0,Northwestern,14.0,29,113,23,13,145,3,1,27.0,40,274,-11,-5,-44,-2,-1
286,09/16/2000,Temple,31.0,38,127,34,24,272,2,0,Bowling Green,14.0,29,26,28,14,164,0,0,17.0,9,101,6,10,108,2,0
287,09/16/2000,Tennessee,23.0,49,203,29,17,140,1,1,Florida,27.0,21,39,43,20,290,1,0,-4.0,28,164,-14,-3,-150,0,1
288,09/16/2000,Texas,24.0,28,13,46,21,330,2,0,Stanford,27.0,37,60,37,15,255,0,0,-3.0,-9,-47,9,6,75,2,0
289,09/16/2000,Toledo,31.0,45,258,28,11,103,1,0,Eastern Illinois,26.0,29,108,46,25,414,3,2,5.0,16,150,-18,-14,-311,-2,-2
290,09/16/2000,Texas Tech,26.0,31,101,37,24,240,2,0,UL-Lafayette,0.0,34,94,22,11,85,3,0,26.0,-3,7,15,13,155,-1,0
291,09/16/2000,Tulane,17.0,53,188,35,20,299,0,2,East Carolina,37.0,44,247,33,13,258,0,0,-20.0,9,-59,2,7,41,0,2
292,09/16/2000,Tulsa,23.0,36,73,27,10,194,1,1,Rice,16.0,62,335,21,6,82,1,3,7.0,-26,-262,6,4,112,0,-2
293,09/16/2000,Texas A & M,45.0,40,236,29,18,178,1,0,Texas-El Paso,17.0,37,82,31,19,218,1,0,28.0,3,154,-2,-1,-40,0,0
294,09/16/2000,Alabama-Birmingham,20.0,51,193,24,10,45,1,0,Kansas,23.0,44,209,23,10,152,2,2,-3.0,7,-16,1,0,-107,-1,-2
295,09/16/2000,U.C.L.A.,23.0,39,126,41,22,268,0,3,Michigan,20.0,46,263,28,8,111,1,1,3.0,-7,-137,13,14,157,-1,2
296,09/16/2000,Nevada-Las Vegas,38.0,44,314,15,7,133,0,1,North Texas,0.0,42,108,34,17,163,0,3,38.0,2,206,-19,-10,-30,0,-2
297,09/16/2000,Utah,21.0,28,136,43,20,282,1,1,Washington State,38.0,51,213,18,11,211,0,1,-17.0,-23,-77,25,9,71,1,0
298,09/16/2000,Texas-El Paso,17.0,37,82,31,19,218,1,0,Texas A & M,45.0,40,236,28,18,178,1,0,-28.0,-3,-154,3,1,40,0,0
299,09/16/2000,Vanderbilt,7.0,32,90,45,20,278,2,2,Mississippi,12.0,37,201,23,14,133,1,0,-5.0,-5,-111,22,6,145,1,2
300,09/16/2000,Virginia,26.0,45,119,30,20,333,0,0,Duke,10.0,34,133,36,18,198,1,0,16.0,11,-14,-6,2,135,-1,0
301,09/16/2000,Virginia Tech,49.0,58,348,28,15,179,0,3,Rutgers,0.0,24,57,49,17,184,4,0,49.0,34,291,-21,-2,-5,-4,3
302,09/16/2000,Washington,17.0,49,205,29,15,200,2,2,Colorado,14.0,35,69,27,15,174,0,2,3.0,14,136,2,0,26,2,0
303,09/16/2000,Washington State,38.0,51,213,18,11,211,0,1,Utah,21.0,28,136,43,20,282,1,1,17.0,23,77,-25,-9,-71,-1,0
304,09/16/2000,Wake Forest,7.0,35,102,17,7,57,0,2,Clemson,55.0,66,436,21,10,187,0,0,-48.0,-31,-334,-4,-3,-130,0,2
305,09/16/2000,Wisconsin,28.0,47,198,21,11,107,0,0,Cincinnati,25.0,37,113,37,19,238,1,0,3.0,10,85,-16,-8,-131,-1,0
306,09/16/2000,Western Michigan,56.0,52,295,27,14,194,0,0,Indiana State,0.0,41,77,13,6,64,0,2,56.0,11,218,14,8,130,0,-2
307,09/16/2000,West Virginia,30.0,45,276,22,14,165,0,3,Maryland,17.0,30,71,30,19,215,1,0,13.0,15,205,-8,-5,-50,-1,3
308,09/16/2000,Wyoming,31.0,55,321,17,5,47,1,0,Central Michigan,10.0,31,43,36,18,240,0,2,21.0,24,278,-19,-13,-193,1,-2
309,09/23/2000,Air Force,23.0,54,242,11,5,149,0,1,Utah,14.0,41,136,28,16,195,0,0,9.0,13,106,-17,-11,-46,0,1
310,09/23/2000,Akron,23.0,48,133,33,20,258,0,0,Ohio,20.0,46,284,15,4,92,2,1,3.0,2,-151,18,16,166,-2,-1
311,09/23/2000,Arkansas State,3.0,43,86,18,8,65,2,2,Texas Christian,52.0,44,255,18,13,211,1,0,-49.0,-1,-169,0,-5,-146,1,2
312,09/23/2000,Alabama,21.0,57,226,20,8,117,0,1,Arkansas,28.0,29,151,33,20,173,1,1,-7.0,28,75,-13,-12,-56,-1,0
313,09/23/2000,Arkansas,28.0,29,151,33,20,173,1,1,Alabama,21.0,57,226,20,8,117,0,1,7.0,-28,-75,13,12,56,1,0
314,09/23/2000,Army,16.0,30,38,45,31,269,3,1,Memphis,26.0,38,130,34,23,208,1,1,-10.0,-8,-92,11,8,61,2,0
315,09/23/2000,Auburn,31.0,35,189,29,21,222,1,1,Northern Illinois,14.0,42,129,35,17,239,2,1,17.0,-7,60,-6,4,-17,-1,0
316,09/23/2000,Arizona State,44.0,48,131,21,12,374,0,2,Utah State,20.0,32,103,38,17,240,3,1,24.0,16,28,-17,-5,134,-3,1
317,09/23/2000,Baylor,28.0,39,147,29,20,223,0,1,South Florida,13.0,27,173,42,22,236,0,4,15.0,12,-26,-13,-2,-13,0,-3
318,09/23/2000,Boise State,47.0,45,270,31,18,245,0,0,Central Michigan,10.0,31,80,33,19,188,1,1,37.0,14,190,-2,-1,57,-1,-1
319,09/23/2000,Boston College,48.0,47,211,33,24,414,1,0,Navy,7.0,44,112,24,11,111,0,2,41.0,3,99,9,13,303,1,-2
320,09/23/2000,Bowling Green,17.0,50,112,20,5,63,0,0,Buffalo,20.0,31,64,38,24,183,2,1,-3.0,19,48,-18,-19,-120,-2,-1
321,09/23/2000,Buffalo,20.0,31,50,38,24,197,2,1,Bowling Green,17.0,50,112,20,5,63,0,0,3.0,-19,-62,18,19,134,2,1
322,09/23/2000,Brigham Young,10.0,47,196,29,15,157,1,0,Nevada-Las Vegas,7.0,33,41,17,11,202,1,1,3.0,14,155,12,4,-45,0,-1
323,09/23/2000,California,3.0,35,108,36,16,197,2,0,Fresno State,17.0,30,64,41,24,325,1,1,-14.0,5,44,-5,-8,-128,1,-1
324,09/23/2000,Central Florida,52.0,37,112,35,19,278,1,1,William & Mary,7.0,38,66,19,7,71,1,2,45.0,-1,46,16,12,207,0,-1
325,09/23/2000,Cincinnati,6.0,35,114,45,22,239,0,1,Indiana,42.0,46,295,21,10,221,1,1,-36.0,-11,-181,24,12,18,-1,0
326,09/23/2000,Clemson,31.0,43,327,25,15,154,1,3,Virginia,10.0,36,111,39,17,170,1,0,21.0,7,216,-14,-2,-16,0,3
327,09/23/2000,Central Michigan,10.0,31,80,33,19,188,1,1,Boise State,47.0,45,270,31,18,245,0,0,-37.0,-14,-190,2,1,-57,1,1
328,09/23/2000,Duke,7.0,27,66,36,18,163,2,1,Vanderbilt,26.0,34,174,40,23,266,1,1,-19.0,-7,-108,-4,-5,-103,1,0
329,09/23/2000,East Carolina,34.0,39,177,17,8,201,0,0,Syracuse,17.0,48,247,22,12,179,2,0,17.0,-9,-70,-5,-4,22,-2,0
330,09/23/2000,Eastern Michigan,40.0,36,132,50,34,364,1,1,Temple,49.0,39,298,16,10,163,0,1,-9.0,-3,-166,34,24,201,1,0
331,09/23/2000,Florida,59.0,35,190,27,15,262,0,0,Kentucky,31.0,29,141,60,35,363,2,2,28.0,6,49,-33,-20,-101,-2,-2
332,09/23/2000,Fresno State,17.0,30,64,41,24,325,1,1,California,3.0,35,108,36,16,197,2,0,14.0,-5,-44,5,8,128,-1,1
333,09/23/2000,Florida State,31.0,48,235,34,23,274,3,2,Louisville,0.0,21,3,45,24,207,1,1,31.0,27,232,-11,-1,67,2,1
334,09/23/2000,Georgia,37.0,42,237,25,13,191,1,0,New Mexico State,0.0,41,102,21,9,82,0,0,37.0,1,135,4,4,109,1,0
335,09/23/2000,Georgia Tech,23.0,42,141,43,24,226,1,2,No Carolina State,30.0,31,66,36,21,262,2,0,-7.0,11,75,7,3,-36,-1,2
336,09/23/2000,Hawaii,7.0,25,53,50,15,211,2,1,Texas-El Paso,39.0,47,140,34,18,265,1,3,-32.0,-22,-87,16,-3,-54,1,-2
337,09/23/2000,Houston,0.0,30,13,40,19,185,2,3,Texas,48.0,32,96,37,22,253,3,1,-48.0,-2,-83,3,-3,-68,-1,2
338,09/23/2000,Idaho,38.0,44,216,36,22,246,3,1,Washington State,34.0,36,183,32,16,292,0,2,4.0,8,33,4,6,-46,3,-1
339,09/23/2000,Illinois,31.0,32,95,38,27,352,0,2,Michigan,35.0,55,341,28,12,172,0,0,-4.0,-23,-246,10,15,180,0,2
340,09/23/2000,Indiana,42.0,46,295,21,10,221,1,1,Cincinnati,6.0,35,114,45,22,239,0,1,36.0,11,181,-24,-12,-18,1,0
341,09/23/2000,Iowa,13.0,31,47,40,19,252,2,0,Nebraska,42.0,51,331,13,10,159,0,1,-29.0,-20,-284,27,9,93,2,-1
342,09/23/2000,Kansas,42.0,47,206,20,9,124,0,2,Southern Illinois,0.0,45,122,11,6,43,1,4,42.0,2,84,9,3,81,-1,-2
343,09/23/2000,Kent State,14.0,37,193,28,14,110,1,2,"Miami, Ohio",45.0,37,210,36,23,286,1,1,-31.0,0,-17,-8,-9,-176,0,1
344,09/23/2000,Kansas State,55.0,58,260,22,15,217,1,2,North Texas,10.0,28,103,17,7,35,0,2,45.0,30,157,5,8,182,1,0
345,09/23/2000,Kentucky,31.0,29,141,60,35,363,2,2,Florida,59.0,35,190,27,15,262,0,0,-28.0,-6,-49,33,20,101,2,2
346,09/23/2000,Louisville,0.0,21,3,45,24,207,1,1,Florida State,31.0,48,235,34,23,274,3,2,-31.0,-27,-232,11,1,-67,-2,-1
347,09/23/2000,Louisiana State,10.0,36,107,38,15,156,4,2,Alabama-Birmingham,13.0,38,113,22,8,65,1,2,-3.0,-2,-6,16,7,91,3,0
348,09/23/2000,Louisiana Tech,10.0,42,196,24,14,141,2,2,Tulsa,22.0,45,177,28,14,141,0,1,-12.0,-3,19,-4,0,0,2,1
349,09/23/2000,Marshall,15.0,23,90,35,19,215,0,0,North Carolina,20.0,37,142,39,24,292,2,0,-5.0,-14,-52,-4,-5,-77,-2,0
350,09/23/2000,Michigan State,27.0,50,167,24,12,181,1,1,Notre Dame,21.0,37,149,16,5,63,1,0,6.0,13,18,8,7,118,0,1
351,09/23/2000,Maryland,45.0,38,171,31,21,357,1,1,Mid Tennessee St,27.0,31,129,52,30,342,1,0,18.0,7,42,-21,-9,15,0,1
352,09/23/2000,Memphis,26.0,40,130,32,21,208,1,1,Army,16.0,30,38,45,31,269,3,1,10.0,10,92,-13,-10,-61,-2,0
353,09/23/2000,"Miami, Florida",47.0,36,96,33,22,291,0,2,West Virginia,10.0,40,155,36,15,162,2,2,37.0,-4,-59,-3,7,129,-2,0
354,09/23/2000,"Miami, Ohio",45.0,37,210,36,23,286,1,1,Kent State,14.0,37,193,28,14,110,1,2,31.0,0,17,8,9,176,0,-1
355,09/23/2000,Michigan,35.0,55,341,28,12,172,0,0,Illinois,31.0,32,95,38,27,352,0,2,4.0,23,246,-10,-15,-180,0,-2
356,09/23/2000,Minnesota,24.0,28,55,39,22,214,1,0,Purdue,38.0,39,122,50,33,409,0,2,-14.0,-11,-67,-11,-11,-195,1,-2
357,09/23/2000,Mississippi State,19.0,37,94,36,17,224,1,2,South Carolina,23.0,32,30,41,20,330,0,2,-4.0,5,64,-5,-3,-106,1,0
358,09/23/2000,Mid Tennessee St,27.0,31,129,52,30,342,1,0,Maryland,45.0,38,171,31,21,357,1,1,-18.0,-7,-42,21,9,-15,0,-1
359,09/23/2000,Navy,7.0,44,112,24,11,111,0,2,Boston College,48.0,47,211,33,24,414,1,0,-41.0,-3,-99,-9,-13,-303,-1,2
360,09/23/2000,North Carolina,20.0,37,142,39,24,292,2,0,Marshall,15.0,23,90,35,19,215,0,0,5.0,14,52,4,5,77,2,0
361,09/23/2000,No Carolina State,30.0,31,66,36,21,262,2,0,Georgia Tech,23.0,42,141,43,24,226,1,2,7.0,-11,-75,-7,-3,36,1,-2
362,09/23/2000,Notre Dame,21.0,37,149,16,5,63,1,0,Michigan State,27.0,50,167,24,12,181,1,1,-6.0,-13,-18,-8,-7,-118,0,-1
363,09/23/2000,Nebraska,42.0,51,331,13,10,159,0,1,Iowa,13.0,31,47,40,19,252,2,0,29.0,20,284,-27,-9,-93,-2,1
364,09/23/2000,UL-Monroe,3.0,26,33,37,21,146,1,1,Tennessee,70.0,42,234,31,20,274,1,1,-67.0,-16,-201,6,1,-128,0,0
365,09/23/2000,Nevada,35.0,34,169,28,16,195,0,0,Wyoming,28.0,34,176,45,26,259,2,1,7.0,0,-7,-17,-10,-64,-2,-1
366,09/23/2000,Northern Illinois,14.0,42,129,35,17,239,2,1,Auburn,31.0,35,189,29,21,222,1,1,-17.0,7,-60,6,-4,17,1,0
367,09/23/2000,New Mexico,35.0,55,186,15,12,162,1,1,Northern Arizona,28.0,27,113,39,19,268,3,0,7.0,28,73,-24,-7,-106,-2,1
368,09/23/2000,New Mexico State,0.0,41,102,21,9,82,0,0,Georgia,37.0,42,237,25,13,191,1,0,-37.0,-1,-135,-4,-4,-109,-1,0
369,09/23/2000,North Texas,10.0,28,103,17,7,35,0,2,Kansas State,55.0,58,260,22,15,217,1,2,-45.0,-30,-157,-5,-8,-182,-1,0
370,09/23/2000,Northwestern,47.0,38,266,41,21,278,0,0,Wisconsin,44.0,60,352,24,12,153,0,2,3.0,-22,-86,17,9,125,0,-2
371,09/23/2000,Ohio,20.0,46,284,15,4,92,2,1,Akron,23.0,48,133,33,20,258,0,0,-3.0,-2,151,-18,-16,-166,2,1
372,09/23/2000,Ohio State,45.0,47,158,22,13,239,1,0,Penn State,6.0,38,93,23,11,120,1,2,39.0,9,65,-1,2,119,0,-2
373,09/23/2000,Oklahoma,42.0,33,189,36,28,343,2,1,Rice,14.0,51,145,12,6,117,1,1,28.0,-18,44,24,22,226,1,0
374,09/23/2000,Oklahoma State,6.0,38,157,35,16,146,3,1,Southern Miss,28.0,32,-7,37,20,257,0,2,-22.0,6,164,-2,-4,-111,3,-1
375,09/23/2000,Oregon,29.0,52,208,34,15,153,0,0,U.C.L.A.,10.0,26,-9,34,14,206,1,2,19.0,26,217,0,1,-53,-1,-2
376,09/23/2000,Oregon State,35.0,46,153,30,15,183,0,0,San Diego State,3.0,38,71,30,15,156,4,3,32.0,8,82,0,0,27,-4,-3
377,09/23/2000,Penn State,6.0,38,93,23,11,120,1,2,Ohio State,45.0,47,158,22,13,239,1,0,-39.0,-9,-65,1,-2,-119,0,2
378,09/23/2000,Pittsburgh,29.0,55,212,27,19,218,2,5,Rutgers,17.0,21,-13,37,20,225,1,1,12.0,34,225,-10,-1,-7,1,4
379,09/23/2000,Purdue,38.0,39,122,50,33,409,0,2,Minnesota,24.0,28,55,39,22,214,1,0,14.0,11,67,11,11,195,-1,2
380,09/23/2000,Rice,14.0,51,145,12,6,117,1,1,Oklahoma,42.0,33,189,36,28,343,2,1,-28.0,18,-44,-24,-22,-226,-1,0
381,09/23/2000,Rutgers,17.0,21,-13,37,20,225,1,1,Pittsburgh,29.0,55,212,27,19,218,2,5,-12.0,-34,-225,10,1,7,-1,-4
382,09/23/2000,Southern Cal,34.0,46,234,38,22,338,0,4,San Jose State,24.0,29,110,41,20,256,1,0,10.0,17,124,-3,2,82,-1,4
383,09/23/2000,South Carolina,23.0,32,30,41,20,330,0,2,Mississippi State,19.0,37,94,36,17,224,1,2,4.0,-5,-64,5,3,106,-1,0
384,09/23/2000,San Diego State,3.0,38,71,30,15,156,4,3,Oregon State,35.0,46,153,30,15,183,0,0,-32.0,-8,-82,0,0,-27,4,3
385,09/23/2000,San Jose State,24.0,29,110,41,20,256,1,0,Southern Cal,34.0,46,233,38,22,338,0,4,-10.0,-17,-123,3,-2,-82,1,-4
386,09/23/2000,Southern Miss,28.0,32,-7,37,20,257,0,2,Oklahoma State,6.0,38,157,35,16,146,3,1,22.0,-6,-164,2,4,111,-3,1
387,09/23/2000,Southern Methodist,17.0,28,116,49,27,264,0,1,Tulane,29.0,26,64,53,35,392,0,0,-12.0,2,52,-4,-8,-128,0,1
388,09/23/2000,UL-Lafayette,21.0,41,204,21,10,123,0,0,Northwestern St(LA),23.0,41,188,33,13,117,0,0,-2.0,0,16,-12,-3,6,0,0
389,09/23/2000,Syracuse,17.0,48,247,22,12,179,2,0,East Carolina,34.0,39,163,17,8,215,0,0,-17.0,9,84,5,4,-36,2,0
390,09/23/2000,Texas Christian,52.0,44,255,18,13,211,1,0,Arkansas State,3.0,43,86,18,8,65,2,2,49.0,1,169,0,5,146,-1,-2
391,09/23/2000,Temple,49.0,39,298,16,10,163,0,1,Eastern Michigan,40.0,36,132,50,34,364,1,1,9.0,3,166,-34,-24,-201,-1,0
392,09/23/2000,Tennessee,70.0,42,234,31,20,274,1,1,UL-Monroe,3.0,26,33,37,21,146,1,1,67.0,16,201,-6,-1,128,0,0
393,09/23/2000,Texas,48.0,32,96,37,22,253,3,1,Houston,0.0,32,13,38,17,185,2,3,48.0,0,83,-1,5,68,1,-2
394,09/23/2000,Toledo,14.0,29,124,50,23,188,1,0,Western Michigan,21.0,40,132,37,18,231,0,2,-7.0,-11,-8,13,5,-43,1,-2
395,09/23/2000,Tulane,29.0,26,64,53,35,392,0,0,Southern Methodist,17.0,28,116,49,27,264,0,1,12.0,-2,-52,4,8,128,0,-1
396,09/23/2000,Tulsa,22.0,45,177,28,14,141,0,1,Louisiana Tech,10.0,42,196,24,14,141,2,2,12.0,3,-19,4,0,0,-2,-1
397,09/23/2000,Alabama-Birmingham,13.0,38,113,22,8,65,1,2,Louisiana State,10.0,36,107,38,15,156,4,2,3.0,2,6,-16,-7,-91,-3,0
398,09/23/2000,U.C.L.A.,10.0,26,-9,34,14,206,1,2,Oregon,29.0,52,208,34,15,153,0,0,-19.0,-26,-217,0,-1,53,1,2
399,09/23/2000,Nevada-Las Vegas,7.0,33,41,17,11,202,1,1,Brigham Young,10.0,47,196,29,15,157,1,0,-3.0,-14,-155,-12,-4,45,0,1
400,09/23/2000,Utah,14.0,41,136,28,16,195,0,0,Air Force,23.0,54,242,11,5,149,0,1,-9.0,-13,-106,17,11,46,0,-1
401,09/23/2000,Texas-El Paso,39.0,47,140,34,18,265,1,3,Hawaii,7.0,25,53,50,15,211,2,1,32.0,22,87,-16,3,54,-1,2
402,09/23/2000,Utah State,20.0,32,103,38,17,240,3,1,Arizona State,44.0,48,131,21,12,374,0,2,-24.0,-16,-28,17,5,-134,3,-1
403,09/23/2000,Vanderbilt,26.0,34,174,40,23,266,1,1,Duke,7.0,27,66,36,18,163,2,1,19.0,7,108,4,5,103,-1,0
404,09/23/2000,Virginia,10.0,36,111,39,17,170,1,0,Clemson,31.0,43,327,25,15,154,1,3,-21.0,-7,-216,14,2,16,0,-3
405,09/23/2000,Washington State,34.0,36,183,32,16,292,0,2,Idaho,38.0,44,216,36,22,246,3,1,-4.0,-8,-33,-4,-6,46,-3,1
406,09/23/2000,Wisconsin,44.0,60,352,24,12,153,0,2,Northwestern,47.0,38,266,41,21,278,0,0,-3.0,22,86,-17,-9,-125,0,2
407,09/23/2000,Western Michigan,21.0,40,132,37,18,231,0,2,Toledo,14.0,29,124,50,23,188,1,0,7.0,11,8,-13,-5,43,-1,2
408,09/23/2000,West Virginia,10.0,40,155,36,15,162,2,2,"Miami, Florida",47.0,36,96,33,22,291,0,2,-37.0,4,59,3,-7,-129,2,0
409,09/23/2000,Wyoming,28.0,34,176,45,26,259,2,1,Nevada,35.0,34,169,28,16,195,0,0,-7.0,0,7,17,10,64,2,1
410,09/30/2000,Air Force,13.0,51,219,21,9,133,1,0,Nevada-Las Vegas,34.0,46,224,22,16,259,0,1,-21.0,5,-5,-1,-7,-126,1,-1
411,09/30/2000,Akron,37.0,43,243,19,9,214,1,1,"Miami, Ohio",20.0,43,256,49,20,174,2,1,17.0,0,-13,-30,-11,40,-1,0
412,09/30/2000,Arkansas State,27.0,35,141,21,12,242,0,1,Richmond,30.0,66,402,14,3,35,0,0,-3.0,-31,-261,7,9,207,0,1
413,09/30/2000,Alabama,27.0,33,146,32,19,204,2,0,South Carolina,17.0,32,85,44,20,264,3,1,10.0,1,61,-12,-1,-60,-1,-1
414,09/30/2000,Arizona,27.0,46,192,23,12,198,1,2,Stanford,3.0,30,68,32,14,177,2,4,24.0,16,124,-9,-2,21,-1,-2
415,09/30/2000,Arkansas,7.0,26,52,38,19,162,2,1,Georgia,38.0,46,175,25,13,168,0,0,-31.0,-20,-123,13,6,-6,2,1
416,09/30/2000,Auburn,33.0,33,154,33,16,227,1,0,Vanderbilt,0.0,29,65,34,15,87,0,0,33.0,4,89,-1,1,140,1,0
417,09/30/2000,Arizona State,31.0,24,98,49,24,365,2,2,U.C.L.A.,38.0,48,233,31,17,267,1,3,-7.0,-24,-135,18,7,98,1,-1
418,09/30/2000,Ball State,14.0,42,66,24,17,170,0,3,Northern Illinois,43.0,50,192,16,9,236,0,1,-29.0,-8,-126,8,8,-66,0,2
419,09/30/2000,Baylor,17.0,37,108,27,8,161,1,2,Iowa State,31.0,53,308,23,12,167,0,2,-14.0,-16,-200,4,-4,-6,1,0
420,09/30/2000,Boston College,34.0,40,213,24,11,74,1,0,Virginia Tech,48.0,57,420,17,5,61,1,2,-14.0,-17,-207,7,6,13,0,-2
421,09/30/2000,Bowling Green,18.0,43,124,21,13,111,1,2,Kent State,11.0,32,38,53,27,285,3,0,7.0,11,86,-32,-14,-174,-2,2
422,09/30/2000,Buffalo,14.0,25,6,28,15,186,1,1,Marshall,47.0,46,148,41,28,483,2,0,-33.0,-21,-142,-13,-13,-297,-1,1
423,09/30/2000,Brigham Young,14.0,21,21,44,24,272,0,1,Syracuse,42.0,50,224,12,10,228,0,0,-28.0,-29,-203,32,14,44,0,1
424,09/30/2000,California,17.0,46,149,31,11,89,1,1,Washington State,21.0,36,41,24,15,238,0,2,-4.0,10,108,7,-4,-149,1,-1
425,09/30/2000,Central Florida,31.0,35,136,38,27,365,1,2,Eastern Michigan,10.0,32,30,36,25,250,1,1,21.0,3,106,2,2,115,0,1
426,09/30/2000,Cincinnati,19.0,52,155,32,18,195,2,1,Tulane,24.0,30,119,35,22,299,2,0,-5.0,22,36,-3,-4,-104,0,1
427,09/30/2000,Clemson,52.0,57,315,23,12,212,0,1,Duke,22.0,31,67,35,16,168,1,0,30.0,26,248,-12,-4,44,-1,1
428,09/30/2000,Central Michigan,0.0,24,43,24,14,125,0,2,Toledo,41.0,56,311,26,15,146,1,0,-41.0,-32,-268,-2,-1,-21,-1,2
429,09/30/2000,Colorado,21.0,35,137,34,20,267,2,0,Kansas State,44.0,36,153,26,15,293,0,2,-23.0,-1,-16,8,5,-26,2,-2
430,09/30/2000,Colorado State,45.0,55,318,29,16,185,3,0,Nevada,14.0,28,58,31,15,253,0,1,31.0,27,260,-2,1,-68,3,-1
431,09/30/2000,Duke,22.0,31,67,35,16,168,1,0,Clemson,52.0,57,315,23,12,212,0,1,-30.0,-26,-248,12,4,-44,1,-1
432,09/30/2000,Eastern Michigan,10.0,32,30,36,25,250,1,1,Central Florida,31.0,35,136,38,27,365,1,2,-21.0,-3,-106,-2,-2,-115,0,-1
433,09/30/2000,Florida,35.0,22,-78,57,34,494,1,2,Mississippi State,47.0,57,351,27,14,166,2,1,-12.0,-35,-429,30,20,328,-1,1
434,09/30/2000,Florida State,59.0,63,260,27,18,353,1,0,Maryland,7.0,26,124,27,10,100,1,1,52.0,37,136,0,8,253,0,-1
435,09/30/2000,Georgia,38.0,46,175,25,13,168,0,0,Arkansas,7.0,26,52,38,19,162,2,1,31.0,20,123,-13,-6,6,-2,-1
436,09/30/2000,Georgia Tech,42.0,40,134,30,21,238,2,0,North Carolina,28.0,37,89,31,17,388,2,0,14.0,3,45,-1,4,-150,0,0
437,09/30/2000,Hawaii,14.0,18,31,48,31,313,2,2,Tulsa,24.0,39,98,25,16,145,1,0,-10.0,-21,-67,23,15,168,1,2
438,09/30/2000,Houston,17.0,33,67,47,28,348,0,0,Southern Methodist,15.0,18,52,58,28,326,4,0,2.0,15,15,-11,0,22,-4,0
439,09/30/2000,Iowa State,31.0,53,308,23,12,167,0,2,Baylor,17.0,37,108,27,8,161,1,2,14.0,16,200,-4,4,6,-1,0
440,09/30/2000,Idaho,56.0,35,183,34,20,437,1,0,Montana State,7.0,33,22,34,17,160,2,1,49.0,2,161,0,3,277,-1,-1
441,09/30/2000,Illinois,10.0,30,82,43,18,178,2,2,Minnesota,44.0,64,364,17,10,182,0,2,-34.0,-34,-282,26,8,-4,2,0
442,09/30/2000,Indiana,45.0,53,433,22,9,111,0,1,Iowa,33.0,34,152,47,30,380,0,1,12.0,19,281,-25,-21,-269,0,0
443,09/30/2000,Iowa,33.0,34,152,47,30,380,0,1,Indiana,45.0,53,433,22,9,111,0,1,-12.0,-19,-281,25,21,269,0,0
444,09/30/2000,Kansas,16.0,45,119,29,12,258,5,2,Oklahoma,34.0,28,98,43,29,346,0,2,-18.0,17,21,-14,-17,-88,5,0
445,09/30/2000,Kent State,11.0,32,38,53,27,285,3,0,Bowling Green,18.0,42,109,22,14,126,1,2,-7.0,-10,-71,31,13,159,2,-2
446,09/30/2000,Kansas State,44.0,36,153,26,15,293,0,2,Colorado,21.0,35,137,34,20,267,2,0,23.0,1,16,-8,-5,26,-2,2
447,09/30/2000,Kentucky,17.0,24,39,42,17,192,3,0,Mississippi,35.0,46,179,25,15,238,0,1,-18.0,-22,-140,17,2,-46,3,-1
448,09/30/2000,Louisville,41.0,35,156,32,19,253,1,0,Connecticut,22.0,27,28,54,27,306,0,1,19.0,8,128,-22,-8,-53,1,-1
449,09/30/2000,Louisiana State,38.0,29,142,35,23,318,0,1,Tennessee,31.0,27,86,62,37,319,1,0,7.0,2,56,-27,-14,-1,-1,1
450,09/30/2000,Marshall,47.0,46,148,41,28,483,2,0,Buffalo,14.0,25,6,28,15,186,1,1,33.0,21,142,13,13,297,1,-1
451,09/30/2000,Michigan State,17.0,35,134,35,17,233,1,2,Northwestern,37.0,55,346,23,12,160,1,0,-20.0,-20,-212,12,5,73,0,2
452,09/30/2000,Maryland,7.0,26,124,27,10,100,1,1,Florida State,59.0,63,260,27,18,353,1,0,-52.0,-37,-136,0,-8,-253,0,1
453,09/30/2000,Memphis,3.0,36,67,38,23,161,3,0,Southern Miss,24.0,32,99,31,15,163,0,2,-21.0,4,-32,7,8,-2,3,-2
454,09/30/2000,"Miami, Florida",64.0,54,261,23,17,296,0,1,Rutgers,6.0,27,4,42,19,153,3,2,58.0,27,257,-19,-2,143,-3,-1
455,09/30/2000,"Miami, Ohio",20.0,42,241,50,21,189,2,1,Akron,37.0,43,243,19,9,214,1,1,-17.0,-1,-2,31,12,-25,1,0
456,09/30/2000,Michigan,13.0,44,118,27,15,257,0,2,Wisconsin,10.0,42,180,18,8,98,3,1,3.0,2,-62,9,7,159,-3,1
457,09/30/2000,Minnesota,44.0,64,364,17,10,182,0,2,Illinois,10.0,30,82,43,18,178,2,2,34.0,34,282,-26,-8,4,-2,0
458,09/30/2000,Mississippi,35.0,46,179,25,15,238,0,1,Kentucky,17.0,24,39,42,17,192,3,0,18.0,22,140,-17,-2,46,-3,1
459,09/30/2000,Missouri,24.0,31,209,39,19,283,1,1,Nebraska,42.0,53,311,23,11,173,0,0,-18.0,-22,-102,16,8,110,1,1
460,09/30/2000,Mississippi State,47.0,57,351,27,14,166,2,1,Florida,35.0,22,-78,57,34,494,1,2,12.0,35,429,-30,-20,-328,1,-1
461,09/30/2000,Navy,0.0,41,112,6,2,8,0,0,Texas Christian,24.0,51,197,18,15,192,0,0,-24.0,-10,-85,-12,-13,-184,0,0
462,09/30/2000,North Carolina,28.0,37,89,31,17,388,2,0,Georgia Tech,42.0,40,134,30,21,238,2,0,-14.0,-3,-45,1,-4,150,0,0
463,09/30/2000,Nebraska,42.0,53,311,23,11,173,0,0,Missouri,24.0,31,209,39,19,283,1,1,18.0,22,102,-16,-8,-110,-1,-1
464,09/30/2000,UL-Monroe,7.0,20,51,59,28,278,2,2,S W Texas State,27.0,44,176,26,14,144,0,0,-20.0,-24,-125,33,14,134,2,2
465,09/30/2000,Nevada,14.0,28,58,31,15,253,0,1,Colorado State,45.0,55,318,29,16,185,3,0,-31.0,-27,-260,2,-1,68,-3,1
466,09/30/2000,Northern Illinois,43.0,50,192,16,9,236,0,1,Ball State,14.0,42,66,24,17,170,0,3,29.0,8,126,-8,-8,66,0,-2
467,09/30/2000,New Mexico,45.0,64,308,16,11,121,1,0,Wyoming,10.0,27,47,26,17,209,1,2,35.0,37,261,-10,-6,-88,0,-2
468,09/30/2000,New Mexico State,31.0,44,355,29,13,153,1,2,Texas-El Paso,41.0,45,228,28,16,237,0,1,-10.0,-1,127,1,-3,-84,1,1
469,09/30/2000,Northwestern,37.0,55,346,23,12,160,1,0,Michigan State,17.0,35,134,35,17,233,1,2,20.0,20,212,-12,-5,-73,0,-2
470,09/30/2000,Ohio,10.0,49,177,8,4,116,1,2,Western Michigan,23.0,37,138,33,23,332,2,3,-13.0,12,39,-25,-19,-216,-1,-1
471,09/30/2000,Oklahoma,34.0,28,98,43,29,346,0,2,Kansas,16.0,45,119,29,12,258,5,2,18.0,-17,-21,14,17,88,-5,0
472,09/30/2000,Oklahoma State,7.0,36,168,23,8,101,0,2,Texas,42.0,44,205,33,18,299,0,0,-35.0,-8,-37,-10,-10,-198,0,2
473,09/30/2000,Oregon,23.0,52,229,22,9,119,0,0,Washington,16.0,28,111,37,14,229,2,1,7.0,24,118,-15,-5,-110,-2,-1
474,09/30/2000,Oregon State,31.0,53,218,29,10,157,0,2,Southern Cal,21.0,30,63,38,19,282,3,1,10.0,23,155,-9,-9,-125,-3,1
475,09/30/2000,Penn State,22.0,44,221,25,11,109,1,0,Purdue,20.0,41,118,51,24,286,0,0,2.0,3,103,-26,-13,-177,1,0
476,09/30/2000,Purdue,20.0,41,118,51,24,286,0,0,Penn State,22.0,44,221,25,11,109,1,0,-2.0,-3,-103,26,13,177,-1,0
477,09/30/2000,Rice,16.0,63,191,16,8,107,0,0,San Jose State,29.0,31,121,42,26,383,2,1,-13.0,32,70,-26,-18,-276,-2,-1
478,09/30/2000,Rutgers,6.0,27,4,42,19,153,3,2,"Miami, Florida",64.0,54,261,23,17,296,0,1,-58.0,-27,-257,19,2,-143,3,1
479,09/30/2000,Southern Cal,21.0,30,63,38,19,282,3,1,Oregon State,31.0,53,218,29,10,157,0,2,-10.0,-23,-155,9,9,125,3,-1
480,09/30/2000,South Carolina,17.0,32,85,44,20,264,3,1,Alabama,27.0,33,146,32,19,204,2,0,-10.0,-1,-61,12,1,60,1,1
481,09/30/2000,San Jose State,29.0,31,121,42,26,373,2,1,Rice,16.0,63,191,16,8,107,0,0,13.0,-32,-70,26,18,266,2,1
482,09/30/2000,Southern Miss,24.0,32,99,31,15,163,0,2,Memphis,3.0,36,67,38,23,161,3,0,21.0,-4,32,-7,-8,2,-3,2
483,09/30/2000,Southern Methodist,15.0,19,54,58,28,326,4,0,Houston,17.0,32,69,47,28,338,0,0,-2.0,-13,-15,11,0,-12,4,0
484,09/30/2000,Stanford,3.0,30,68,32,14,177,2,4,Arizona,27.0,46,192,23,12,198,1,2,-24.0,-16,-124,9,2,-21,1,2
485,09/30/2000,UL-Lafayette,2.0,28,-27,38,15,118,0,2,Alabama-Birmingham,47.0,53,290,16,8,129,2,0,-45.0,-25,-317,22,7,-11,-2,2
486,09/30/2000,Syracuse,42.0,50,224,12,10,228,0,0,Brigham Young,14.0,21,21,44,24,272,0,1,28.0,29,203,-32,-14,-44,0,-1
487,09/30/2000,Texas Christian,24.0,51,197,18,15,192,0,0,Navy,0.0,41,112,6,2,8,0,0,24.0,10,85,12,13,184,0,0
488,09/30/2000,Temple,24.0,25,143,32,18,154,1,0,West Virginia,29.0,40,152,32,18,242,1,2,-5.0,-15,-9,0,0,-88,0,-2
489,09/30/2000,Tennessee,31.0,27,86,62,37,319,1,0,Louisiana State,38.0,29,142,35,23,318,0,1,-7.0,-2,-56,27,14,1,1,-1
490,09/30/2000,Texas,42.0,44,205,33,18,299,0,0,Oklahoma State,7.0,36,168,23,8,101,0,2,35.0,8,37,10,10,198,0,-2
491,09/30/2000,Toledo,41.0,56,311,26,15,146,1,0,Central Michigan,0.0,24,43,24,14,125,0,2,41.0,32,268,2,1,21,1,-2
492,09/30/2000,Texas Tech,15.0,28,23,52,29,322,3,0,Texas A & M,33.0,36,159,23,16,186,0,1,-18.0,-8,-136,29,13,136,3,-1
493,09/30/2000,Tulane,24.0,30,119,35,22,299,2,0,Cincinnati,19.0,52,155,32,18,195,2,1,5.0,-22,-36,3,4,104,0,-1
494,09/30/2000,Tulsa,24.0,39,98,25,16,145,1,0,Hawaii,14.0,18,31,48,31,313,2,2,10.0,21,67,-23,-15,-168,-1,-2
495,09/30/2000,Texas A & M,33.0,36,159,23,16,186,0,1,Texas Tech,15.0,28,23,52,29,322,3,0,18.0,8,136,-29,-13,-136,-3,1
496,09/30/2000,Alabama-Birmingham,47.0,53,290,16,8,129,2,0,UL-Lafayette,2.0,28,-27,38,15,118,0,2,45.0,25,317,-22,-7,11,2,-2
497,09/30/2000,U.C.L.A.,38.0,48,233,31,17,267,1,3,Arizona State,31.0,24,98,49,24,365,2,2,7.0,24,135,-18,-7,-98,-1,1
498,09/30/2000,Nevada-Las Vegas,34.0,46,224,22,16,259,0,1,Air Force,13.0,51,219,21,9,133,1,0,21.0,-5,5,1,7,126,-1,1
499,09/30/2000,Utah,35.0,59,278,15,9,186,1,1,Utah State,14.0,19,52,43,19,230,3,0,21.0,40,226,-28,-10,-44,-2,1
500,09/30/2000,Texas-El Paso,41.0,44,230,28,16,237,0,1,New Mexico State,31.0,45,357,29,13,153,1,2,10.0,-1,-127,-1,3,84,-1,-1
501,09/30/2000,Utah State,14.0,19,52,43,19,230,3,0,Utah,35.0,59,278,15,9,186,1,1,-21.0,-40,-226,28,10,44,2,-1
502,09/30/2000,Vanderbilt,0.0,29,65,34,15,87,0,0,Auburn,33.0,33,154,33,16,227,1,0,-33.0,-4,-89,1,-1,-140,-1,0
503,09/30/2000,Virginia,27.0,47,237,27,16,179,0,0,Wake Forest,10.0,34,154,30,14,153,1,0,17.0,13,83,-3,2,26,-1,0
504,09/30/2000,Virginia Tech,48.0,57,420,17,5,61,1,2,Boston College,34.0,40,213,24,11,74,1,0,14.0,17,207,-7,-6,-13,0,2
505,09/30/2000,Washington,16.0,28,111,37,14,229,2,1,Oregon,23.0,52,229,22,9,119,0,0,-7.0,-24,-118,15,5,110,2,1
506,09/30/2000,Washington State,21.0,36,41,24,15,238,0,2,California,17.0,46,149,31,11,89,1,1,4.0,-10,-108,-7,4,149,-1,1
507,09/30/2000,Wake Forest,10.0,34,154,30,14,153,1,0,Virginia,27.0,47,237,27,16,179,0,0,-17.0,-13,-83,3,-2,-26,1,0
508,09/30/2000,Wisconsin,10.0,42,180,18,8,98,3,1,Michigan,13.0,44,118,27,15,257,0,2,-3.0,-2,62,-9,-7,-159,3,-1
509,09/30/2000,Western Michigan,23.0,37,138,33,23,332,2,3,Ohio,10.0,49,177,8,4,116,1,2,13.0,-12,-39,25,19,216,1,1
510,09/30/2000,West Virginia,29.0,40,152,32,18,242,1,2,Temple,24.0,25,143,32,18,154,1,0,5.0,15,9,0,0,88,0,2
511,09/30/2000,Wyoming,10.0,27,47,26,17,209,1,2,New Mexico,45.0,64,308,16,11,121,1,0,-35.0,-37,-261,10,6,88,0,2
512,10/07/2000,Air Force,27.0,47,135,13,6,101,1,0,Navy,13.0,57,108,23,11,140,0,2,14.0,-10,27,-10,-5,-39,1,-2
513,10/07/2000,Akron,27.0,34,85,27,17,259,0,0,Bowling Green,21.0,50,159,24,15,185,1,0,6.0,-16,-74,3,2,74,-1,0
514,10/07/2000,Arkansas State,10.0,24,113,26,11,79,2,0,Mississippi,35.0,41,153,33,24,251,2,1,-25.0,-17,-40,-7,-13,-172,0,-1
515,10/07/2000,Arizona,31.0,44,117,13,7,136,1,1,Southern Cal,15.0,27,10,50,26,321,3,2,16.0,17,107,-37,-19,-185,-2,-1
516,10/07/2000,Arkansas,52.0,40,166,33,17,237,0,2,UL-Monroe,6.0,32,85,30,13,109,2,1,46.0,8,81,3,4,128,-2,1
517,10/07/2000,Army,23.0,47,235,28,12,144,4,0,New Mexico State,42.0,52,202,16,10,101,0,0,-19.0,-5,33,12,2,43,4,0
518,10/07/2000,Auburn,10.0,19,18,32,17,146,0,0,Mississippi State,17.0,42,135,31,18,208,1,2,-7.0,-23,-117,1,-1,-62,-1,-2
519,10/07/2000,Arizona State,30.0,44,146,32,12,420,1,1,California,10.0,40,255,32,14,135,0,3,20.0,4,-109,0,-2,285,1,-2
520,10/07/2000,Ball State,15.0,56,218,29,17,186,3,1,"Miami, Ohio",10.0,24,65,38,15,170,2,2,5.0,32,153,-9,2,16,1,-1
521,10/07/2000,Baylor,0.0,30,100,40,13,148,2,1,Texas Tech,28.0,27,129,50,33,322,0,1,-28.0,3,-29,-10,-20,-174,2,0
522,10/07/2000,Boise State,35.0,29,139,41,24,335,1,3,Washington State,42.0,47,131,31,21,290,0,1,-7.0,-18,8,10,3,45,1,2
523,10/07/2000,Boston College,55.0,51,361,22,15,274,0,0,Connecticut,3.0,26,49,40,20,215,2,1,52.0,25,312,-18,-5,59,-2,-1
524,10/07/2000,Bowling Green,21.0,50,159,24,15,185,1,0,Akron,27.0,34,85,27,17,259,0,0,-6.0,16,74,-3,-2,-74,1,0
525,10/07/2000,Buffalo,20.0,46,145,31,17,262,1,3,Ohio,42.0,62,361,8,4,109,1,0,-22.0,-16,-216,23,13,153,0,3
526,10/07/2000,Brigham Young,38.0,38,198,39,25,335,0,0,Utah State,14.0,25,11,38,23,204,0,1,24.0,13,187,1,2,131,0,-1
527,10/07/2000,California,10.0,40,255,32,14,135,0,3,Arizona State,30.0,44,146,32,12,420,1,1,-20.0,-4,109,0,2,-285,-1,2
528,10/07/2000,Central Florida,20.0,23,30,40,30,301,1,6,Northern Illinois,40.0,56,221,18,10,153,1,1,-20.0,-33,-191,22,20,148,0,5
529,10/07/2000,Cincinnati,48.0,52,262,25,15,268,2,2,Houston,31.0,29,77,44,31,326,1,1,17.0,23,185,-19,-16,-58,1,1
530,10/07/2000,Clemson,34.0,65,274,30,18,220,2,1,No Carolina State,27.0,23,32,50,21,370,0,0,7.0,42,242,-20,-3,-150,2,1
531,10/07/2000,Central Michigan,21.0,40,109,34,20,271,2,2,Kent State,24.0,56,188,21,10,132,0,1,-3.0,-16,-79,13,10,139,2,1
532,10/07/2000,Colorado,26.0,42,112,25,15,239,0,2,Texas A & M,19.0,36,71,45,28,291,0,0,7.0,6,41,-20,-13,-52,0,2
533,10/07/2000,Colorado State,17.0,34,39,36,21,252,2,0,New Mexico,14.0,37,73,22,16,203,0,1,3.0,-3,-34,14,5,49,2,-1
534,10/07/2000,East Carolina,10.0,21,64,43,18,246,2,2,Memphis,17.0,56,129,25,18,175,0,1,-7.0,-35,-65,18,0,71,2,1
535,10/07/2000,Eastern Michigan,14.0,26,66,22,14,106,2,1,Toledo,42.0,58,281,26,16,123,0,0,-28.0,-32,-215,-4,-2,-17,2,1
536,10/07/2000,Florida,41.0,34,175,32,21,298,0,0,Louisiana State,9.0,29,92,38,19,249,4,0,32.0,5,83,-6,2,49,-4,0
537,10/07/2000,Fresno State,27.0,34,179,31,20,220,2,2,Rice,24.0,58,306,13,4,61,0,2,3.0,-24,-127,18,16,159,2,0
538,10/07/2000,Florida State,24.0,27,69,58,29,496,2,1,"Miami, Florida",27.0,35,120,42,27,328,0,3,-3.0,-8,-51,16,2,168,2,-2
539,10/07/2000,Georgia,21.0,52,141,17,8,134,0,3,Tennessee,10.0,32,112,32,18,136,2,1,11.0,20,29,-15,-10,-2,-2,2
540,10/07/2000,Hawaii,21.0,16,118,44,18,266,0,2,Texas Christian,41.0,71,393,17,7,91,1,1,-20.0,-55,-275,27,11,175,-1,1
541,10/07/2000,Houston,31.0,29,77,44,31,326,1,1,Cincinnati,48.0,52,262,25,15,268,2,2,-17.0,-23,-185,19,16,58,-1,-1
542,10/07/2000,Iowa State,27.0,25,37,43,22,346,2,0,Nebraska,49.0,60,336,17,7,164,1,0,-22.0,-35,-299,26,15,182,1,0
543,10/07/2000,Idaho,16.0,48,89,50,35,365,4,0,West Virginia,28.0,34,116,30,12,131,1,1,-12.0,14,-27,20,23,234,3,-1
544,10/07/2000,Indiana,33.0,38,174,47,23,268,1,3,Northwestern,52.0,61,417,17,9,119,1,1,-19.0,-23,-243,30,14,149,0,2
545,10/07/2000,Iowa,21.0,37,85,25,17,146,0,2,Michigan State,16.0,41,286,36,14,180,2,0,5.0,-4,-201,-11,3,-34,-2,2
546,10/07/2000,Kansas,13.0,46,103,23,10,128,1,2,Kansas State,52.0,49,210,22,14,258,1,0,-39.0,-3,-107,1,-4,-130,0,2
547,10/07/2000,Kent State,24.0,56,188,21,10,132,0,1,Central Michigan,21.0,40,109,34,20,271,2,2,3.0,16,79,-13,-10,-139,-2,-1
548,10/07/2000,Kansas State,52.0,49,210,22,14,258,1,0,Kansas,13.0,46,103,23,10,128,1,2,39.0,3,107,-1,4,130,0,-2
549,10/07/2000,Kentucky,17.0,28,93,52,34,304,2,0,South Carolina,20.0,30,159,31,17,228,0,2,-3.0,-2,-66,21,17,76,2,-2
550,10/07/2000,Louisville,38.0,39,107,30,21,227,1,0,Alabama-Birmingham,17.0,35,38,30,12,187,3,1,21.0,4,69,0,9,40,-2,-1
551,10/07/2000,Louisiana State,9.0,29,92,38,19,249,4,0,Florida,41.0,34,175,32,21,298,0,0,-32.0,-5,-83,6,-2,-49,4,0
552,10/07/2000,Louisiana Tech,21.0,31,127,41,26,217,2,1,Mid Tennessee St,49.0,44,335,22,16,201,0,2,-28.0,-13,-208,19,10,16,2,-1
553,10/07/2000,Marshall,10.0,35,90,54,26,324,1,0,Western Michigan,30.0,47,286,22,12,121,1,1,-20.0,-12,-196,32,14,203,0,-1
554,10/07/2000,Michigan State,16.0,41,286,36,14,180,2,0,Iowa,21.0,37,85,25,17,146,0,2,-5.0,4,201,11,-3,34,2,-2
555,10/07/2000,Maryland,24.0,31,109,34,14,207,2,0,Virginia,31.0,59,263,20,12,222,2,2,-7.0,-28,-154,14,2,-15,0,-2
556,10/07/2000,Memphis,17.0,56,129,25,18,175,0,1,East Carolina,10.0,21,64,43,18,246,2,2,7.0,35,65,-18,0,-71,-2,-1
557,10/07/2000,"Miami, Florida",27.0,35,120,42,27,328,0,3,Florida State,24.0,27,69,58,29,496,2,1,3.0,8,51,-16,-2,-168,-2,2
558,10/07/2000,"Miami, Ohio",10.0,24,65,38,15,170,2,2,Ball State,15.0,56,218,29,17,186,3,1,-5.0,-32,-153,9,-2,-16,-1,1
559,10/07/2000,Michigan,31.0,29,174,35,26,256,0,1,Purdue,32.0,43,244,45,32,286,1,0,-1.0,-14,-70,-10,-6,-30,-1,1
560,10/07/2000,Minnesota,25.0,49,182,20,12,166,0,1,Penn State,16.0,33,98,36,19,189,0,2,9.0,16,84,-16,-7,-23,0,-1
561,10/07/2000,Mississippi,35.0,41,163,33,24,251,2,1,Arkansas State,10.0,24,113,26,11,79,2,0,25.0,17,50,7,13,172,0,1
562,10/07/2000,Missouri,24.0,39,182,28,14,191,1,0,Oklahoma State,10.0,39,102,44,26,257,3,0,14.0,0,80,-16,-12,-66,-2,0
563,10/07/2000,Mississippi State,17.0,42,135,31,18,208,1,2,Auburn,10.0,19,18,32,17,146,0,0,7.0,23,117,-1,1,62,1,2
564,10/07/2000,Mid Tennessee St,49.0,44,335,22,16,201,0,2,Louisiana Tech,21.0,31,127,41,26,217,2,1,28.0,13,208,-19,-10,-16,-2,1
565,10/07/2000,Navy,13.0,57,108,23,11,140,0,2,Air Force,27.0,47,135,13,6,101,1,0,-14.0,10,-27,10,5,39,-1,2
566,10/07/2000,No Carolina State,27.0,23,-4,50,21,370,0,0,Clemson,34.0,65,274,30,18,220,2,1,-7.0,-42,-278,20,3,150,-2,-1
567,10/07/2000,Notre Dame,20.0,50,166,18,10,100,0,0,Stanford,14.0,29,142,43,19,242,1,1,6.0,21,24,-25,-9,-142,-1,-1
568,10/07/2000,Nebraska,49.0,60,336,17,7,164,1,0,Iowa State,27.0,25,37,43,22,346,2,0,22.0,35,299,-26,-15,-182,-1,0
569,10/07/2000,UL-Monroe,6.0,32,85,30,13,109,2,1,Arkansas,52.0,40,166,33,17,237,0,2,-46.0,-8,-81,-3,-4,-128,2,-1
570,10/07/2000,Nevada,7.0,31,109,33,11,136,1,0,Nevada-Las Vegas,38.0,53,321,14,8,152,0,0,-31.0,-22,-212,19,3,-16,1,0
571,10/07/2000,Northern Illinois,40.0,56,221,18,10,153,1,1,Central Florida,20.0,23,30,40,30,301,1,6,20.0,33,191,-22,-20,-148,0,-5
572,10/07/2000,New Mexico,14.0,37,73,22,16,203,0,1,Colorado State,17.0,34,39,36,21,252,2,0,-3.0,3,34,-14,-5,-49,-2,1
573,10/07/2000,New Mexico State,42.0,52,202,16,10,101,0,0,Army,23.0,47,235,28,12,144,4,0,19.0,5,-33,-12,-2,-43,-4,0
574,10/07/2000,North Texas,41.0,50,262,10,5,72,0,0,Samford,6.0,52,166,16,9,92,1,3,35.0,-2,96,-6,-4,-20,-1,-3
575,10/07/2000,Northwestern,52.0,61,417,17,9,119,1,1,Indiana,33.0,38,174,47,23,268,1,3,19.0,23,243,-30,-14,-149,0,-2
576,10/07/2000,Ohio,42.0,62,367,8,4,109,1,0,Buffalo,20.0,46,145,31,17,262,1,3,22.0,16,222,-23,-13,-153,0,-3
577,10/07/2000,Ohio State,23.0,44,249,13,8,143,1,1,Wisconsin,7.0,43,109,35,19,209,1,1,16.0,1,140,-22,-11,-66,0,0
578,10/07/2000,Oklahoma,63.0,56,245,28,18,289,0,2,Texas,14.0,17,-7,41,20,161,2,1,49.0,39,252,-13,-2,128,-2,1
579,10/07/2000,Oklahoma State,10.0,39,102,44,26,257,3,0,Missouri,24.0,39,182,28,14,191,1,0,-14.0,0,-80,16,12,66,2,0
580,10/07/2000,Oregon State,30.0,40,160,25,13,314,0,0,Washington,33.0,47,281,32,20,223,0,0,-3.0,-7,-121,-7,-7,91,0,0
581,10/07/2000,Penn State,16.0,33,98,36,19,189,0,2,Minnesota,25.0,49,182,20,12,166,0,1,-9.0,-16,-84,16,7,23,0,1
582,10/07/2000,Pittsburgh,17.0,32,91,46,21,237,0,0,Syracuse,24.0,53,160,29,20,279,0,0,-7.0,-21,-69,17,1,-42,0,0
583,10/07/2000,Purdue,32.0,43,244,45,32,286,1,0,Michigan,31.0,29,174,35,26,256,0,1,1.0,14,70,10,6,30,1,-1
584,10/07/2000,Rice,24.0,58,306,13,4,61,0,2,Fresno State,27.0,34,179,31,20,220,2,2,-3.0,24,127,-18,-16,-159,-2,0
585,10/07/2000,Southern Cal,15.0,27,10,50,26,321,3,2,Arizona,31.0,44,117,13,7,136,1,1,-16.0,-17,-107,37,19,185,2,1
586,10/07/2000,South Carolina,20.0,30,159,31,17,228,0,2,Kentucky,17.0,28,93,52,34,304,2,0,3.0,2,66,-21,-17,-76,-2,2
587,10/07/2000,San Diego State,34.0,42,117,27,19,317,1,1,Wyoming,0.0,30,26,30,20,158,1,2,34.0,12,91,-3,-1,159,0,-1
588,10/07/2000,San Jose State,35.0,38,200,25,10,167,0,2,Southern Methodist,10.0,38,136,54,25,324,4,1,25.0,0,64,-29,-15,-157,-4,1
589,10/07/2000,Southern Miss,41.0,50,169,35,19,180,0,0,South Florida,7.0,25,18,27,13,133,1,0,34.0,25,151,8,6,47,-1,0
590,10/07/2000,Southern Methodist,10.0,38,136,54,25,324,4,1,San Jose State,35.0,38,204,25,10,167,0,2,-25.0,0,-68,29,15,157,4,-1
591,10/07/2000,Stanford,14.0,29,142,43,19,242,1,1,Notre Dame,20.0,50,166,18,10,100,0,0,-6.0,-21,-24,25,9,142,1,1
592,10/07/2000,UL-Lafayette,37.0,40,166,35,17,291,1,0,Tulane,38.0,31,138,49,32,410,3,1,-1.0,9,28,-14,-15,-119,-2,-1
593,10/07/2000,Syracuse,24.0,53,154,29,20,279,0,0,Pittsburgh,17.0,32,91,46,21,237,0,0,7.0,21,63,-17,-1,42,0,0
594,10/07/2000,Texas Christian,41.0,71,383,17,7,91,1,1,Hawaii,21.0,16,118,44,18,266,0,2,20.0,55,265,-27,-11,-175,1,-1
595,10/07/2000,Temple,13.0,28,-15,28,13,131,3,0,Virginia Tech,35.0,56,214,29,14,162,2,1,-22.0,-28,-229,-1,-1,-31,1,-1
596,10/07/2000,Tennessee,10.0,32,112,32,18,136,2,1,Georgia,21.0,52,141,17,8,134,0,3,-11.0,-20,-29,15,10,2,2,-2
597,10/07/2000,Texas,14.0,17,-7,41,20,161,2,1,Oklahoma,63.0,56,245,28,18,289,0,2,-49.0,-39,-252,13,2,-128,2,-1
598,10/07/2000,Toledo,42.0,58,281,26,16,123,0,0,Eastern Michigan,14.0,26,66,22,14,106,2,1,28.0,32,215,4,2,17,-2,-1
599,10/07/2000,Texas Tech,28.0,27,129,50,33,322,0,1,Baylor,0.0,30,100,40,13,148,2,1,28.0,-3,29,10,20,174,-2,0
600,10/07/2000,Tulane,38.0,31,178,49,32,410,3,1,UL-Lafayette,37.0,40,166,35,17,291,1,0,1.0,-9,12,14,15,119,2,1
601,10/07/2000,Tulsa,7.0,26,6,36,19,237,2,2,Texas-El Paso,40.0,49,264,23,17,204,0,1,-33.0,-23,-258,13,2,33,2,1
602,10/07/2000,Texas A & M,19.0,36,71,45,28,291,0,0,Colorado,26.0,42,112,25,15,239,0,2,-7.0,-6,-41,20,13,52,0,-2
603,10/07/2000,Alabama-Birmingham,17.0,35,38,30,12,187,3,1,Louisville,38.0,39,107,30,21,227,1,0,-21.0,-4,-69,0,-9,-40,2,1
604,10/07/2000,Nevada-Las Vegas,38.0,53,321,14,8,152,0,0,Nevada,7.0,31,109,33,11,136,1,0,31.0,22,212,-19,-3,16,-1,0
605,10/07/2000,Texas-El Paso,40.0,49,264,23,17,204,0,1,Tulsa,7.0,26,6,36,19,237,2,2,33.0,23,258,-13,-2,-33,-2,-1
606,10/07/2000,Utah State,14.0,25,11,38,23,204,0,1,Brigham Young,38.0,38,198,39,25,335,0,0,-24.0,-13,-187,-1,-2,-131,0,1
607,10/07/2000,Vanderbilt,17.0,32,129,16,9,145,1,0,Wake Forest,10.0,56,217,26,12,158,0,1,7.0,-24,-88,-10,-3,-13,1,-1
608,10/07/2000,Virginia,31.0,59,263,20,12,222,2,2,Maryland,24.0,31,109,34,14,207,2,0,7.0,28,154,-14,-2,15,0,2
609,10/07/2000,Virginia Tech,35.0,56,214,29,14,162,2,1,Temple,13.0,28,-15,28,13,131,3,0,22.0,28,229,1,1,31,-1,1
610,10/07/2000,Washington,33.0,47,281,32,20,223,0,0,Oregon State,30.0,40,160,25,13,314,0,0,3.0,7,121,7,7,-91,0,0
611,10/07/2000,Washington State,42.0,47,131,31,21,290,0,1,Boise State,35.0,29,139,41,24,335,1,3,7.0,18,-8,-10,-3,-45,-1,-2
612,10/07/2000,Wake Forest,10.0,56,217,26,12,158,0,1,Vanderbilt,17.0,32,129,16,9,145,1,0,-7.0,24,88,10,3,13,-1,1
613,10/07/2000,Wisconsin,7.0,43,109,35,19,209,1,1,Ohio State,23.0,44,249,13,8,143,1,1,-16.0,-1,-140,22,11,66,0,0
614,10/07/2000,Western Michigan,30.0,47,286,22,12,121,1,1,Marshall,10.0,35,90,54,26,324,1,0,20.0,12,196,-32,-14,-203,0,1
615,10/07/2000,West Virginia,28.0,34,116,30,12,131,1,1,Idaho,16.0,48,89,50,35,365,4,0,12.0,-14,27,-20,-23,-234,-3,1
616,10/07/2000,Wyoming,0.0,30,26,30,20,158,1,2,San Diego State,34.0,42,117,27,19,317,1,1,-34.0,-12,-91,3,1,-159,0,1
617,10/14/2000,Air Force,51.0,71,432,14,8,193,0,1,Wyoming,34.0,29,82,41,28,339,1,0,17.0,42,350,-27,-20,-146,-1,1
618,10/14/2000,Akron,35.0,28,116,28,12,324,2,1,Northern Illinois,52.0,57,360,23,15,134,0,1,-17.0,-29,-244,5,-3,190,2,0
619,10/14/2000,Alabama,45.0,39,168,26,21,296,1,1,Mississippi,7.0,26,74,40,20,163,3,1,38.0,13,94,-14,1,133,-2,0
620,10/14/2000,Arizona,53.0,57,254,31,15,236,2,0,Washington State,47.0,34,112,37,20,378,2,3,6.0,23,142,-6,-5,-142,0,-3
621,10/14/2000,Arkansas,7.0,41,100,37,19,151,2,2,South Carolina,27.0,31,174,21,12,170,1,0,-20.0,10,-74,16,7,-19,1,2
622,10/14/2000,Army,21.0,45,178,30,16,125,1,0,East Carolina,42.0,42,332,23,14,195,2,0,-21.0,3,-154,7,2,-70,-1,0
623,10/14/2000,Auburn,7.0,32,119,34,20,203,1,2,Florida,38.0,29,116,26,16,243,0,0,-31.0,3,3,8,4,-40,1,2
624,10/14/2000,Arizona State,15.0,38,60,46,15,202,2,4,Washington,21.0,42,186,30,13,110,1,5,-6.0,-4,-126,16,2,92,1,-1
625,10/14/2000,Ball State,33.0,56,192,20,13,104,1,0,Eastern Michigan,14.0,25,47,43,21,300,0,2,19.0,31,145,-23,-8,-196,1,-2
626,10/14/2000,Baylor,0.0,33,74,36,14,162,4,0,Texas A & M,24.0,30,103,41,22,311,2,1,-24.0,3,-29,-5,-8,-149,2,-1
627,10/14/2000,Boise State,41.0,41,19,39,21,333,2,0,Eastern Washington,23.0,31,126,39,21,201,1,5,18.0,10,-107,0,0,132,1,-5
628,10/14/2000,Boston College,20.0,36,176,24,10,119,0,0,Syracuse,13.0,46,306,22,9,134,4,0,7.0,-10,-130,2,1,-15,-4,0
629,10/14/2000,Bowling Green,10.0,42,159,36,16,222,2,0,"Miami, Ohio",24.0,37,141,43,24,222,0,1,-14.0,5,18,-7,-8,0,2,-1
630,10/14/2000,California,46.0,43,107,34,16,252,1,3,U.C.L.A.,38.0,45,45,40,20,309,3,0,8.0,-2,62,-6,-4,-57,-2,3
631,10/14/2000,Central Florida,34.0,22,80,33,20,255,2,0,Eastern Kentucky,3.0,37,20,34,20,216,3,1,31.0,-15,60,-1,0,39,-1,-1
632,10/14/2000,Cincinnati,24.0,34,108,29,11,142,3,0,Louisville,38.0,42,147,32,25,326,2,1,-14.0,-8,-39,-3,-14,-184,1,-1
633,10/14/2000,Clemson,35.0,61,278,20,10,186,1,1,Maryland,14.0,37,82,22,8,179,3,0,21.0,24,196,-2,2,7,-2,1
634,10/14/2000,Colorado,14.0,36,55,36,12,78,2,1,Texas,28.0,41,166,40,23,308,1,3,-14.0,-5,-111,-4,-11,-230,1,-2
635,10/14/2000,Colorado State,20.0,42,158,28,20,222,1,1,Nevada-Las Vegas,19.0,43,200,14,9,80,0,0,1.0,-1,-42,14,11,142,1,1
636,10/14/2000,Duke,14.0,33,108,37,15,152,1,1,Florida State,63.0,25,71,49,37,536,1,0,-49.0,8,37,-12,-22,-384,0,1
637,10/14/2000,East Carolina,42.0,42,332,23,14,195,2,0,Army,21.0,45,178,30,16,125,1,0,21.0,-3,154,-7,-2,70,1,0
638,10/14/2000,Eastern Michigan,14.0,23,41,39,19,268,0,2,Ball State,33.0,56,192,19,12,97,1,0,-19.0,-33,-151,20,7,171,-1,2
639,10/14/2000,Florida,38.0,31,122,30,18,275,0,0,Auburn,7.0,32,119,35,21,210,1,2,31.0,-1,3,-5,-3,65,-1,-2
640,10/14/2000,Fresno State,58.0,40,125,21,11,201,0,0,Nevada,21.0,29,61,49,29,341,2,1,37.0,11,64,-28,-18,-140,-2,-1
641,10/14/2000,Florida State,63.0,25,71,49,37,536,1,0,Duke,14.0,33,108,37,15,152,1,1,49.0,-8,-37,12,22,384,0,-1
642,10/14/2000,Georgia,29.0,30,92,31,12,215,0,0,Vanderbilt,19.0,30,115,43,29,327,3,1,10.0,0,-23,-12,-17,-112,-3,-1
643,10/14/2000,Georgia Tech,52.0,47,245,24,16,333,0,0,Wake Forest,20.0,39,179,43,27,272,2,2,32.0,8,66,-19,-11,61,-2,-2
644,10/14/2000,Hawaii,30.0,17,50,42,23,314,1,1,Southern Methodist,15.0,47,126,27,16,145,0,1,15.0,-30,-76,15,7,169,1,0
645,10/14/2000,Iowa State,33.0,40,210,38,19,290,1,0,Oklahoma State,26.0,37,132,46,26,328,1,2,7.0,3,78,-8,-7,-38,0,-2
646,10/14/2000,Illinois,31.0,44,169,28,17,248,1,1,Iowa,0.0,32,86,34,18,181,2,2,31.0,12,83,-6,-1,67,-1,-1
647,10/14/2000,Indiana,0.0,33,85,30,14,101,1,2,Michigan,58.0,52,282,22,17,280,0,1,-58.0,-19,-197,8,-3,-179,1,1
648,10/14/2000,Iowa,0.0,32,86,34,18,181,2,2,Illinois,31.0,44,169,28,17,248,1,1,-31.0,-12,-83,6,1,-67,1,1
649,10/14/2000,Kansas,38.0,58,219,30,14,234,1,2,Missouri,17.0,26,10,34,16,237,4,1,21.0,32,209,-4,-2,-3,-3,1
650,10/14/2000,Kent State,7.0,39,141,20,7,41,2,0,Ohio,44.0,56,233,11,9,136,0,1,-37.0,-17,-92,9,-2,-95,2,-1
651,10/14/2000,Kansas State,31.0,33,144,36,14,211,2,0,Oklahoma,41.0,36,11,38,29,374,1,0,-10.0,-3,133,-2,-15,-163,1,0
652,10/14/2000,Kentucky,0.0,22,117,55,31,280,1,3,Louisiana State,34.0,46,114,33,15,225,0,0,-34.0,-24,3,22,16,55,1,3
653,10/14/2000,Louisville,38.0,42,147,32,25,326,2,1,Cincinnati,24.0,34,108,29,11,142,3,0,14.0,8,39,3,14,184,-1,1
654,10/14/2000,Louisiana State,34.0,46,114,33,15,225,0,0,Kentucky,0.0,22,117,55,31,280,1,3,34.0,24,-3,-22,-16,-55,-1,-3
655,10/14/2000,Louisiana Tech,48.0,24,97,48,35,399,1,1,UL-Lafayette,14.0,48,223,26,10,77,1,1,34.0,-24,-126,22,25,322,0,0
656,10/14/2000,Marshall,0.0,28,42,39,21,218,2,2,Toledo,42.0,49,247,19,13,140,0,1,-42.0,-21,-205,20,8,78,2,1
657,10/14/2000,Michigan State,10.0,46,183,24,12,183,3,0,Wisconsin,17.0,40,101,21,7,96,0,0,-7.0,6,82,3,5,87,3,0
658,10/14/2000,Maryland,14.0,37,82,22,8,179,3,0,Clemson,35.0,61,278,20,10,186,1,1,-21.0,-24,-196,2,-2,-7,2,-1
659,10/14/2000,Memphis,9.0,35,57,22,11,129,1,1,Alabama-Birmingham,13.0,37,56,27,14,144,0,1,-4.0,-2,1,-5,-3,-15,1,0
660,10/14/2000,"Miami, Ohio",24.0,37,141,43,24,222,0,1,Bowling Green,10.0,42,159,36,16,222,2,0,14.0,-5,-18,7,8,0,-2,1
661,10/14/2000,Michigan,58.0,52,282,22,17,280,0,1,Indiana,0.0,33,85,30,14,101,1,2,58.0,19,197,-8,3,179,-1,-1
662,10/14/2000,Minnesota,29.0,48,138,28,16,243,0,1,Ohio State,17.0,35,70,28,11,130,0,0,12.0,13,68,0,5,113,0,1
663,10/14/2000,Mississippi,7.0,26,74,40,20,163,3,1,Alabama,45.0,39,168,26,21,296,1,1,-38.0,-13,-94,14,-1,-133,2,0
664,10/14/2000,Missouri,17.0,26,10,34,16,237,4,1,Kansas,38.0,58,219,30,14,234,1,2,-21.0,-32,-209,4,2,3,3,-1
665,10/14/2000,Mid Tennessee St,28.0,42,192,24,14,151,0,0,UL-Monroe,0.0,25,76,32,20,119,0,1,28.0,17,116,-8,-6,32,0,-1
666,10/14/2000,Navy,14.0,32,58,20,11,188,0,2,Notre Dame,45.0,55,218,21,14,229,1,1,-31.0,-23,-160,-1,-3,-41,-1,1
667,10/14/2000,North Carolina,20.0,49,158,25,12,128,0,2,No Carolina State,38.0,46,171,26,14,221,1,0,-18.0,3,-13,-1,-2,-93,-1,2
668,10/14/2000,No Carolina State,38.0,46,171,26,14,221,1,0,North Carolina,20.0,49,158,25,12,128,0,2,18.0,-3,13,1,2,93,1,-2
669,10/14/2000,Notre Dame,45.0,55,218,21,14,229,1,1,Navy,14.0,32,58,20,11,188,0,2,31.0,23,160,1,3,41,1,-1
670,10/14/2000,Nebraska,56.0,77,442,14,7,98,1,1,Texas Tech,3.0,12,19,48,22,181,2,0,53.0,65,423,-34,-15,-83,-1,1
671,10/14/2000,UL-Monroe,0.0,25,76,32,20,119,0,1,Mid Tennessee St,28.0,42,192,24,14,151,0,0,-28.0,-17,-116,8,6,-32,0,1
672,10/14/2000,Nevada,21.0,29,61,49,29,341,2,1,Fresno State,58.0,40,125,21,11,201,0,0,-37.0,-11,-64,28,18,140,2,1
673,10/14/2000,Northern Illinois,52.0,57,360,23,15,134,0,1,Akron,35.0,28,116,28,12,324,2,1,17.0,29,244,-5,3,-190,-2,0
674,10/14/2000,New Mexico State,42.0,53,450,15,10,144,1,1,Tulsa,28.0,40,86,26,14,306,0,1,14.0,13,364,-11,-4,-162,1,0
675,10/14/2000,North Texas,12.0,35,69,17,8,72,1,0,Utah State,17.0,40,156,36,21,170,1,0,-5.0,-5,-87,-19,-13,-98,0,0
676,10/14/2000,Northwestern,28.0,37,83,36,24,369,2,0,Purdue,41.0,47,222,40,22,239,1,1,-13.0,-10,-139,-4,2,130,1,-1
677,10/14/2000,Ohio,44.0,56,233,11,9,136,0,1,Kent State,7.0,39,141,20,7,41,2,0,37.0,17,92,-9,2,95,-2,1
678,10/14/2000,Ohio State,17.0,35,70,28,11,130,0,0,Minnesota,29.0,48,138,28,16,243,0,1,-12.0,-13,-68,0,-5,-113,0,-1
679,10/14/2000,Oklahoma,41.0,36,11,38,29,374,1,0,Kansas State,31.0,33,144,36,14,211,2,0,10.0,3,-133,2,15,163,-1,0
680,10/14/2000,Oklahoma State,26.0,37,132,46,26,328,1,2,Iowa State,33.0,40,210,38,19,290,1,0,-7.0,-3,-78,8,7,38,0,2
681,10/14/2000,Oregon,28.0,41,117,42,28,382,1,2,Southern Cal,17.0,33,229,36,15,194,1,1,11.0,8,-112,6,13,188,0,1
682,10/14/2000,Oregon State,38.0,37,147,26,14,324,0,1,Stanford,6.0,49,148,33,18,185,2,1,32.0,-12,-1,-7,-4,139,-2,0
683,10/14/2000,Purdue,41.0,47,222,40,22,239,1,1,Northwestern,28.0,37,83,36,24,369,2,0,13.0,10,139,4,-2,-130,-1,1
684,10/14/2000,Rutgers,14.0,27,108,39,19,243,1,4,Temple,48.0,57,202,32,21,254,1,2,-34.0,-30,-94,7,-2,-11,0,2
685,10/14/2000,Southern Cal,17.0,33,229,36,15,194,1,1,Oregon,28.0,41,117,42,28,382,1,2,-11.0,-8,112,-6,-13,-188,0,-1
686,10/14/2000,South Carolina,27.0,31,174,21,12,170,1,0,Arkansas,7.0,41,100,37,19,151,2,2,20.0,-10,74,-16,-7,19,-1,-2
687,10/14/2000,San Diego State,7.0,35,93,39,15,157,0,0,Utah,21.0,38,99,20,12,230,2,1,-14.0,-3,-6,19,3,-73,-2,-1
688,10/14/2000,San Jose State,30.0,26,218,35,16,166,1,0,Texas-El Paso,47.0,50,186,36,21,292,1,0,-17.0,-24,32,-1,-5,-126,0,0
689,10/14/2000,Southern Miss,56.0,35,256,24,15,224,1,1,Tulane,24.0,49,138,50,22,260,2,2,32.0,-14,118,-26,-7,-36,-1,-1
690,10/14/2000,Southern Methodist,15.0,47,126,27,16,145,0,1,Hawaii,30.0,17,50,42,23,314,1,1,-15.0,30,76,-15,-7,-169,-1,0
691,10/14/2000,Stanford,6.0,49,148,33,18,185,2,1,Oregon State,38.0,37,147,26,14,324,0,1,-32.0,12,1,7,4,-139,2,0
692,10/14/2000,UL-Lafayette,14.0,48,223,26,10,77,1,1,Louisiana Tech,48.0,24,97,48,35,399,1,1,-34.0,24,126,-22,-25,-322,0,0
693,10/14/2000,Syracuse,13.0,46,306,22,9,134,4,0,Boston College,20.0,36,176,24,10,119,0,0,-7.0,10,130,-2,-1,15,4,0
694,10/14/2000,Temple,48.0,57,202,32,21,254,1,2,Rutgers,14.0,27,108,39,19,243,1,4,34.0,30,94,-7,2,11,0,-2
695,10/14/2000,Texas,28.0,41,166,40,23,308,1,3,Colorado,14.0,36,55,36,12,78,2,1,14.0,5,111,4,11,230,-1,2
696,10/14/2000,Toledo,42.0,49,247,19,13,140,0,1,Marshall,0.0,28,42,39,21,218,2,2,42.0,21,205,-20,-8,-78,-2,-1
697,10/14/2000,Texas Tech,3.0,12,19,48,22,181,2,0,Nebraska,56.0,77,442,14,7,98,1,1,-53.0,-65,-423,34,15,83,1,-1
698,10/14/2000,Tulane,24.0,49,138,50,22,260,2,2,Southern Miss,56.0,35,256,24,15,224,1,1,-32.0,14,-118,26,7,36,1,1
699,10/14/2000,Tulsa,28.0,40,86,26,14,306,0,1,New Mexico State,42.0,53,450,15,10,144,1,1,-14.0,-13,-364,11,4,162,-1,0
700,10/14/2000,Texas A & M,24.0,30,103,41,22,311,2,1,Baylor,0.0,33,74,36,14,162,4,0,24.0,-3,29,5,8,149,-2,1
701,10/14/2000,Alabama-Birmingham,13.0,37,56,27,14,144,0,1,Memphis,9.0,35,57,22,11,129,1,1,4.0,2,-1,5,3,15,-1,0
702,10/14/2000,U.C.L.A.,38.0,45,45,40,20,309,3,0,California,46.0,43,107,34,16,252,1,3,-8.0,2,-62,6,4,57,2,-3
703,10/14/2000,Nevada-Las Vegas,19.0,43,200,14,9,80,0,0,Colorado State,20.0,42,158,28,20,222,1,1,-1.0,1,42,-14,-11,-142,-1,-1
704,10/14/2000,Utah,21.0,38,99,20,12,230,2,1,San Diego State,7.0,35,93,39,15,157,0,0,14.0,3,6,-19,-3,73,2,1
705,10/14/2000,Texas-El Paso,47.0,50,186,36,21,292,1,0,San Jose State,30.0,26,218,35,16,166,1,0,17.0,24,-32,1,5,126,0,0
706,10/14/2000,Utah State,17.0,40,156,32,20,175,1,0,North Texas,12.0,35,69,17,8,72,1,0,5.0,5,87,15,12,103,0,0
707,10/14/2000,Vanderbilt,19.0,30,115,44,30,338,3,1,Georgia,29.0,30,92,31,12,215,0,0,-10.0,0,23,13,18,123,3,1
708,10/14/2000,Virginia Tech,48.0,48,271,18,10,233,0,3,West Virginia,20.0,33,78,33,15,170,2,0,28.0,15,193,-15,-5,63,-2,3
709,10/14/2000,Washington,21.0,42,186,30,13,110,1,5,Arizona State,15.0,38,60,46,15,202,2,4,6.0,4,126,-16,-2,-92,-1,1
710,10/14/2000,Washington State,47.0,34,112,37,20,378,2,3,Arizona,53.0,57,254,31,15,236,2,0,-6.0,-23,-142,6,5,142,0,3
711,10/14/2000,Wake Forest,20.0,39,179,43,27,272,2,2,Georgia Tech,52.0,47,245,25,17,344,0,0,-32.0,-8,-66,18,10,-72,2,2
712,10/14/2000,Wisconsin,17.0,40,101,21,7,96,0,0,Michigan State,10.0,46,183,24,12,183,3,0,7.0,-6,-82,-3,-5,-87,-3,0
713,10/14/2000,West Virginia,20.0,33,78,33,15,170,2,0,Virginia Tech,48.0,48,271,18,10,233,0,3,-28.0,-15,-193,15,5,-63,2,-3
714,10/14/2000,Wyoming,34.0,29,82,41,28,339,1,0,Air Force,51.0,71,432,14,8,193,0,1,-17.0,-42,-350,27,20,146,1,-1
715,10/21/2000,Air Force,23.0,38,145,27,15,153,1,2,New Mexico,29.0,55,251,17,10,170,0,0,-6.0,-17,-106,10,5,-17,1,2
716,10/21/2000,Akron,35.0,50,289,32,17,147,1,2,Connecticut,38.0,43,106,35,22,293,0,0,-3.0,7,183,-3,-5,-146,1,2
717,10/21/2000,Arkansas State,29.0,63,399,54,33,409,1,2,New Mexico State,35.0,98,431,69,45,597,0,1,-6.0,-35,-32,-15,-12,-188,1,1
718,10/21/2000,Alabama,10.0,28,44,30,14,181,2,1,Tennessee,20.0,42,96,24,17,213,0,0,-10.0,-14,-52,6,-3,-32,2,1
719,10/21/2000,Arizona,10.0,32,17,32,15,200,1,1,Oregon,14.0,45,137,22,9,123,1,0,-4.0,-13,-120,10,6,77,0,1
720,10/21/2000,Army,21.0,40,221,34,21,171,1,0,Tulane,17.0,38,164,43,23,268,2,0,4.0,2,57,-9,-2,-97,-1,0
721,10/21/2000,Auburn,38.0,48,301,18,12,135,1,0,Louisiana Tech,28.0,17,36,65,47,433,2,1,10.0,31,265,-47,-35,-298,-1,-1
722,10/21/2000,Arizona State,23.0,50,117,32,20,251,2,0,Washington State,20.0,37,167,32,14,321,3,2,3.0,13,-50,0,6,-70,-1,-2
723,10/21/2000,Ball State,44.0,57,192,18,13,248,0,2,Buffalo,35.0,44,252,24,14,172,1,1,9.0,13,-60,-6,-1,76,-1,1
724,10/21/2000,Baylor,0.0,27,5,29,7,79,0,2,Nebraska,59.0,67,459,12,5,49,0,0,-59.0,-40,-454,17,2,30,0,2
725,10/21/2000,Boise State,59.0,54,291,28,20,292,0,2,North Texas,0.0,39,120,20,3,42,3,0,59.0,15,171,8,17,250,-3,2
726,10/21/2000,Boston College,26.0,34,140,37,19,284,3,0,Pittsburgh,42.0,45,252,29,16,332,0,1,-16.0,-11,-112,8,3,-48,3,-1
727,10/21/2000,Bowling Green,20.0,50,141,22,11,113,0,0,Eastern Michigan,6.0,21,59,44,21,216,0,2,14.0,29,82,-22,-10,-103,0,-2
728,10/21/2000,Buffalo,35.0,44,252,24,14,172,1,1,Ball State,44.0,57,192,18,13,248,0,2,-9.0,-13,60,6,1,-76,1,-1
729,10/21/2000,Brigham Young,15.0,34,63,58,34,376,0,1,San Diego State,16.0,28,70,30,14,239,0,2,-1.0,6,-7,28,20,137,0,-1
730,10/21/2000,California,24.0,29,132,32,14,213,1,2,Washington,36.0,42,113,35,19,225,0,1,-12.0,-13,19,-3,-5,-12,1,1
731,10/21/2000,Central Florida,55.0,22,84,29,17,338,1,0,UL-Monroe,0.0,38,-20,34,17,182,1,3,55.0,-16,104,-5,0,156,0,-3
732,10/21/2000,Clemson,38.0,45,112,25,14,296,0,0,North Carolina,24.0,38,89,34,18,314,2,1,14.0,7,23,-9,-4,-18,-2,-1
733,10/21/2000,Central Michigan,3.0,32,111,37,18,179,2,0,Ohio,52.0,62,444,11,4,63,0,1,-49.0,-30,-333,26,14,116,2,-1
734,10/21/2000,Colorado,15.0,32,90,36,20,246,0,0,Kansas,23.0,51,262,22,10,152,0,1,-8.0,-19,-172,14,10,94,0,-1
735,10/21/2000,Colorado State,24.0,35,68,36,18,207,1,0,Utah,17.0,39,110,24,9,142,3,1,7.0,-4,-42,12,9,65,-2,-1
736,10/21/2000,Duke,10.0,46,112,43,22,210,2,1,Georgia Tech,45.0,35,226,21,12,221,1,0,-35.0,11,-114,22,10,-11,1,1
737,10/21/2000,East Carolina,28.0,48,145,20,11,174,2,0,Louisville,25.0,38,130,42,22,252,4,0,3.0,10,15,-22,-11,-78,-2,0
738,10/21/2000,Eastern Michigan,6.0,21,59,44,21,216,0,2,Bowling Green,20.0,50,141,22,11,113,0,0,-14.0,-29,-82,22,10,103,0,2
739,10/21/2000,Fresno State,13.0,31,93,31,14,142,1,0,Texas-El Paso,23.0,44,157,29,20,212,1,0,-10.0,-13,-64,2,-6,-70,0,0
740,10/21/2000,Florida State,37.0,33,128,35,22,426,1,1,Virginia,3.0,46,33,27,14,166,2,3,34.0,-13,95,8,8,260,-1,-2
741,10/21/2000,Georgia,34.0,23,43,39,20,400,1,0,Kentucky,30.0,26,92,58,39,528,2,0,4.0,-3,-49,-19,-19,-128,-1,0
742,10/21/2000,Georgia Tech,45.0,35,226,21,12,221,1,0,Duke,10.0,46,112,43,22,210,2,1,35.0,-11,114,-22,-10,11,-1,-1
743,10/21/2000,Hawaii,13.0,9,10,48,25,227,5,0,Rice,38.0,69,315,7,3,45,0,0,-25.0,-60,-305,41,22,182,5,0
744,10/21/2000,Houston,33.0,31,64,50,33,262,1,1,Memphis,30.0,46,73,26,12,129,0,1,3.0,-15,-9,24,21,133,1,0
745,10/21/2000,Iowa State,7.0,26,102,35,16,137,2,0,Texas A & M,30.0,50,221,27,16,248,0,1,-23.0,-24,-119,8,0,-111,2,-1
746,10/21/2000,Idaho,14.0,79,327,74,51,590,1,1,Utah State,31.0,72,321,67,35,604,1,2,-17.0,7,6,7,16,-14,0,-1
747,10/21/2000,Illinois,25.0,32,129,50,30,343,2,2,Penn State,39.0,46,182,24,13,208,0,1,-14.0,-14,-53,26,17,135,2,1
748,10/21/2000,Indiana,51.0,54,348,21,12,263,1,1,Minnesota,43.0,41,151,36,23,324,1,1,8.0,13,197,-15,-11,-61,0,0
749,10/21/2000,Iowa,10.0,39,13,42,22,233,1,1,Ohio State,38.0,33,108,36,20,338,0,0,-28.0,6,-95,6,2,-105,1,1
750,10/21/2000,Kansas,23.0,51,262,22,10,152,0,1,Colorado,15.0,32,90,36,20,246,0,0,8.0,19,172,-14,-10,-94,0,1
751,10/21/2000,Kent State,12.0,36,75,37,16,162,1,0,Marshall,34.0,30,181,42,31,312,0,1,-22.0,6,-106,-5,-15,-150,1,-1
752,10/21/2000,Kansas State,28.0,44,125,25,13,160,2,0,Texas Tech,23.0,28,35,60,29,302,2,0,5.0,16,90,-35,-16,-142,0,0
753,10/21/2000,Kentucky,30.0,26,92,58,39,528,2,0,Georgia,34.0,24,38,38,20,400,1,0,-4.0,2,54,20,19,128,1,0
754,10/21/2000,Louisville,25.0,38,130,42,22,252,4,0,East Carolina,28.0,48,145,20,11,174,2,0,-3.0,-10,-15,22,11,78,2,0
755,10/21/2000,Louisiana State,45.0,43,220,38,24,246,1,1,Mississippi State,38.0,40,239,26,12,215,1,0,7.0,3,-19,12,12,31,0,1
756,10/21/2000,Louisiana Tech,28.0,17,36,65,47,433,2,1,Auburn,38.0,48,297,18,12,139,1,0,-10.0,-31,-261,47,35,294,1,1
757,10/21/2000,Marshall,34.0,30,181,42,31,312,0,1,Kent State,12.0,36,75,37,16,162,1,0,22.0,-6,106,5,15,150,-1,1
758,10/21/2000,Michigan State,0.0,44,63,37,26,292,1,1,Michigan,14.0,35,188,37,17,138,0,1,-14.0,9,-125,0,9,154,1,0
759,10/21/2000,Maryland,37.0,42,233,31,20,246,0,1,Wake Forest,7.0,30,72,50,29,354,3,1,30.0,12,161,-19,-9,-108,-3,0
760,10/21/2000,Memphis,30.0,46,73,26,12,129,0,1,Houston,33.0,31,64,50,33,262,1,1,-3.0,15,9,-24,-21,-133,-1,0
761,10/21/2000,Miami-Florida,45.0,36,152,23,12,205,1,3,Temple,17.0,44,122,31,17,135,1,1,28.0,-8,30,-8,-5,70,0,2
762,10/21/2000,Michigan,14.0,35,188,37,17,138,0,1,Michigan State,0.0,44,63,37,26,292,1,1,14.0,-9,125,0,-9,-154,-1,0
763,10/21/2000,Minnesota,43.0,41,151,36,23,324,1,1,Indiana,51.0,54,348,21,12,263,1,1,-8.0,-13,-197,15,11,61,0,0
764,10/21/2000,Missouri,12.0,38,145,33,12,176,2,1,Texas,46.0,36,212,32,21,282,1,3,-34.0,2,-67,1,-9,-106,1,-2
765,10/21/2000,Mississippi State,38.0,40,239,26,12,215,1,0,Louisiana State,45.0,43,220,38,24,246,1,1,-7.0,-3,19,-12,-12,-31,0,-1
766,10/21/2000,Mid Tennessee St,9.0,20,65,29,16,146,1,0,Alabama-Birmingham,14.0,58,240,28,17,153,0,1,-5.0,-38,-175,1,-1,-7,1,-1
767,10/21/2000,Navy,21.0,70,260,18,8,107,0,1,Rutgers,28.0,32,112,33,18,304,1,-1,-7.0,38,148,-15,-10,-197,-1,2
768,10/21/2000,North Carolina,24.0,38,89,34,18,314,2,1,Clemson,38.0,45,112,25,14,296,0,0,-14.0,-7,-23,9,4,18,2,1
769,10/21/2000,Notre Dame,42.0,43,227,17,9,146,0,-1,West Virginia,28.0,46,134,35,16,305,1,0,14.0,-3,93,-18,-7,-159,-1,-1
770,10/21/2000,Nebraska,59.0,67,459,12,5,49,0,0,Baylor,0.0,27,5,29,7,79,0,2,59.0,40,454,-17,-2,-30,0,-2
771,10/21/2000,UL-Monroe,0.0,38,-20,34,17,182,1,3,Central Florida,55.0,22,84,29,17,338,1,0,-55.0,16,-104,5,0,-156,0,3
772,10/21/2000,Nevada-Reno,30.0,38,157,51,28,357,2,0,San Jose State,49.0,46,265,27,19,238,0,2,-19.0,-8,-108,24,9,119,2,-2
773,10/21/2000,Northern Illinois,22.0,38,162,20,12,193,1,1,Western Michigan,52.0,46,209,35,22,209,0,0,-30.0,-8,-47,-15,-10,-16,1,1
774,10/21/2000,New Mexico,29.0,55,251,17,10,170,0,0,Air Force,23.0,38,145,27,15,153,1,2,6.0,17,106,-10,-5,17,-1,-2
775,10/21/2000,New Mexico State,35.0,55,259,40,21,258,0,1,Arkansas State,29.0,28,208,23,18,244,0,2,6.0,27,51,17,3,14,0,-1
776,10/21/2000,North Texas,0.0,39,120,20,3,42,3,0,Boise State,59.0,54,291,28,20,292,0,2,-59.0,-15,-171,-8,-17,-250,3,-2
777,10/21/2000,Ohio,52.0,62,444,11,4,63,0,1,Central Michigan,3.0,32,111,37,18,179,2,0,49.0,30,333,-26,-14,-116,-2,1
778,10/21/2000,Ohio State,38.0,33,108,36,20,338,0,0,Iowa,10.0,39,13,42,22,233,1,1,28.0,-6,95,-6,-2,105,-1,-1
779,10/21/2000,Oregon,14.0,45,137,22,9,123,1,0,Arizona,10.0,32,17,32,15,200,1,1,4.0,13,120,-10,-6,-77,0,-1
780,10/21/2000,Oregon State,44.0,53,253,37,23,351,1,2,U.C.L.A.,38.0,31,72,33,19,363,0,1,6.0,22,181,4,4,-12,1,1
781,10/21/2000,Penn State,39.0,46,182,24,13,208,0,1,Illinois,25.0,32,129,50,30,343,2,2,14.0,14,53,-26,-17,-135,-2,-1
782,10/21/2000,Pittsburgh,42.0,45,252,29,16,332,0,1,Boston College,26.0,34,140,37,19,284,3,0,16.0,11,112,-8,-3,48,-3,1
783,10/21/2000,Purdue,30.0,26,145,43,21,274,0,0,Wisconsin,24.0,42,158,29,21,243,0,1,6.0,-16,-13,14,0,31,0,-1
784,10/21/2000,Rice,38.0,69,315,7,3,45,0,0,Hawaii,13.0,9,10,48,25,227,5,0,25.0,60,305,-41,-22,-182,-5,0
785,10/21/2000,Rutgers,28.0,32,112,33,18,304,1,0,Navy,21.0,70,260,18,8,107,0,1,7.0,-38,-148,15,10,197,1,-1
786,10/21/2000,Southern Cal,30.0,29,230,30,15,190,2,0,Stanford,32.0,55,198,41,20,223,2,0,-2.0,-26,32,-11,-5,-33,0,0
787,10/21/2000,South Carolina,30.0,52,339,26,12,151,1,1,Vanderbilt,14.0,27,148,27,14,214,2,1,16.0,25,191,-1,-2,-63,-1,0
788,10/21/2000,San Diego State,16.0,28,70,30,14,239,0,2,Brigham Young,15.0,34,63,58,34,376,0,1,1.0,-6,7,-28,-20,-137,0,1
789,10/21/2000,San Jose State,49.0,46,265,27,19,238,0,2,Nevada-Reno,30.0,38,157,51,28,357,2,0,19.0,8,108,-24,-9,-119,-2,2
790,10/21/2000,Stanford,32.0,55,198,41,20,223,2,0,Southern Cal,30.0,29,230,30,15,190,2,0,2.0,26,-32,11,5,33,0,0
791,10/21/2000,Syracuse,14.0,41,111,25,13,217,4,1,Virginia Tech,22.0,48,165,11,6,75,0,0,-8.0,-7,-54,14,7,142,4,1
792,10/21/2000,Texas Christian,17.0,46,223,12,7,62,0,1,Tulsa,3.0,39,72,39,18,222,4,0,14.0,7,151,-27,-11,-160,-4,1
793,10/21/2000,Temple,17.0,44,122,31,17,135,1,1,Miami-Florida,45.0,36,152,23,12,205,1,3,-28.0,8,-30,8,5,-70,0,-2
794,10/21/2000,Tennessee,20.0,42,96,24,17,213,0,0,Alabama,10.0,27,49,31,14,181,2,1,10.0,15,47,-7,3,32,-2,-1
795,10/21/2000,Texas,46.0,36,212,32,21,282,1,3,Missouri,12.0,38,145,33,12,176,2,1,34.0,-2,67,-1,9,106,-1,2
796,10/21/2000,Texas Tech,23.0,28,35,60,29,302,2,0,Kansas State,28.0,44,125,25,13,160,2,0,-5.0,-16,-90,35,16,142,0,0
797,10/21/2000,Tulane,17.0,38,164,43,23,268,2,0,Army,21.0,40,221,34,21,171,1,0,-4.0,-2,-57,9,2,97,1,0
798,10/21/2000,Tulsa,3.0,39,72,39,18,222,4,0,Texas Christian,17.0,46,223,12,7,62,0,1,-14.0,-7,-151,27,11,160,4,-1
799,10/21/2000,Texas A & M,30.0,50,221,27,16,248,0,1,Iowa State,7.0,26,102,35,16,137,2,0,23.0,24,119,-8,0,111,-2,1
800,10/21/2000,Alabama-Birmingham,14.0,58,240,28,17,153,0,1,Mid Tennessee St,9.0,20,65,29,16,146,1,0,5.0,38,175,-1,1,7,-1,1
801,10/21/2000,U.C.L.A.,38.0,31,72,33,19,363,0,1,Oregon State,44.0,53,253,37,23,351,1,2,-6.0,-22,-181,-4,-4,12,-1,-1
802,10/21/2000,Nevada-Las Vegas,42.0,35,193,15,9,175,2,0,Wyoming,23.0,43,128,42,28,237,0,1,19.0,-8,65,-27,-19,-62,2,-1
803,10/21/2000,Utah,17.0,39,110,24,9,142,3,1,Colorado State,24.0,35,68,36,18,207,1,0,-7.0,4,42,-12,-9,-65,2,1
804,10/21/2000,Texas-El Paso,23.0,44,157,29,20,212,1,0,Fresno State,13.0,31,93,31,14,142,1,0,10.0,13,64,-2,6,70,0,0
805,10/21/2000,Utah State,31.0,37,130,36,20,439,0,2,Idaho,14.0,36,155,45,27,251,1,1,17.0,1,-25,-9,-7,188,-1,1
806,10/21/2000,Vanderbilt,14.0,27,148,27,14,214,2,1,South Carolina,30.0,52,339,26,12,151,1,1,-16.0,-25,-191,1,2,63,1,0
807,10/21/2000,Virginia,3.0,46,33,27,14,166,2,3,Florida State,37.0,33,128,35,22,426,1,1,-34.0,13,-95,-8,-8,-260,1,2
808,10/21/2000,Virginia Tech,22.0,48,165,11,6,75,0,0,Syracuse,14.0,41,111,25,13,217,4,1,8.0,7,54,-14,-7,-142,-4,-1
809,10/21/2000,Washington,36.0,42,113,35,19,225,0,1,California,24.0,29,132,32,14,213,1,2,12.0,13,-19,3,5,12,-1,-1
810,10/21/2000,Washington State,20.0,37,167,32,14,321,3,2,Arizona State,23.0,50,117,32,20,251,2,0,-3.0,-13,50,0,-6,70,1,2
811,10/21/2000,Wake Forest,7.0,30,72,50,29,354,3,1,Maryland,37.0,42,233,31,20,246,0,1,-30.0,-12,-161,19,9,108,3,0
812,10/21/2000,Wisconsin,24.0,42,158,29,21,243,0,1,Purdue,30.0,26,145,43,21,274,0,0,-6.0,16,13,-14,0,-31,0,1
813,10/21/2000,Western Michigan,52.0,46,209,35,22,209,0,0,Northern Illinois,22.0,38,162,20,12,193,1,1,30.0,8,47,15,10,16,-1,-1
814,10/21/2000,West Virginia,28.0,46,134,35,16,305,1,0,Notre Dame,42.0,43,227,17,9,146,0,0,-14.0,3,-93,18,7,159,1,0
815,10/21/2000,Wyoming,23.0,43,128,42,28,237,0,1,Nevada-Las Vegas,42.0,35,193,15,9,175,2,0,-19.0,8,-65,27,19,62,-2,1
816,10/28/2000,Air Force,31.0,53,206,29,17,265,0,1,Notre Dame,34.0,47,212,25,10,171,0,1,-3.0,6,-6,4,7,94,0,0
817,10/28/2000,Akron,28.0,52,235,25,11,170,1,0,Marshall,31.0,28,43,49,26,393,0,1,-3.0,24,192,-24,-15,-223,1,-1
818,10/28/2000,Arkansas State,31.0,30,68,44,22,231,1,1,Utah State,44.0,39,236,43,24,247,0,1,-13.0,-9,-168,1,-2,-16,1,0
819,10/28/2000,Alabama,38.0,34,179,30,15,250,4,1,Central Florida,40.0,33,95,49,27,283,1,1,-2.0,1,84,-19,-12,-33,3,0
820,10/28/2000,Arizona,24.0,45,211,18,7,105,4,0,U.C.L.A.,27.0,39,54,35,19,230,2,0,-3.0,6,157,-17,-12,-125,2,0
821,10/28/2000,Arkansas,19.0,29,166,42,20,204,3,0,Auburn,21.0,39,113,30,19,240,2,1,-2.0,-10,53,12,1,-36,1,-1
822,10/28/2000,Auburn,21.0,39,113,30,19,240,2,1,Arkansas,19.0,29,166,42,20,204,3,0,2.0,10,-53,-12,-1,36,-1,1
823,10/28/2000,Arizona State,55.0,51,235,34,21,432,1,3,Oregon,56.0,40,131,43,26,434,0,2,-1.0,11,104,-9,-5,-2,1,1
824,10/28/2000,Ball State,38.0,68,381,30,18,228,2,2,Central Michigan,34.0,36,153,23,7,83,0,0,4.0,32,228,7,11,145,2,2
825,10/28/2000,Baylor,14.0,32,57,33,9,77,4,1,Texas,48.0,36,90,50,23,383,1,1,-34.0,-4,-33,-17,-14,-306,3,0
826,10/28/2000,Boise State,34.0,42,166,36,23,375,0,0,New Mexico State,31.0,47,317,15,9,160,0,0,3.0,-5,-151,21,14,215,0,0
827,10/28/2000,Boston College,42.0,55,325,18,11,159,0,1,Rutgers,13.0,37,133,36,13,171,2,0,29.0,18,192,-18,-2,-12,-2,1
828,10/28/2000,Buffalo,10.0,30,174,29,9,107,4,0,Northern Illinois,73.0,54,286,32,21,360,0,0,-63.0,-24,-112,-3,-12,-253,4,0
829,10/28/2000,Brigham Young,19.0,40,128,34,22,225,1,3,Wyoming,7.0,36,68,30,19,169,4,1,12.0,4,60,4,3,56,-3,2
830,10/28/2000,California,28.0,39,82,12,7,131,0,1,Southern Cal,16.0,39,118,39,19,202,2,1,12.0,0,-36,-27,-12,-71,-2,0
831,10/28/2000,Central Florida,40.0,33,95,49,27,283,1,1,Alabama,38.0,34,179,30,15,250,4,1,2.0,-1,-84,19,12,33,-3,0
832,10/28/2000,Cincinnati,45.0,41,182,29,16,201,0,0,Miami-Ohio,15.0,42,128,43,20,261,2,2,30.0,-1,54,-14,-4,-60,-2,-2
833,10/28/2000,Clemson,28.0,37,147,27,15,207,1,2,Georgia Tech,31.0,40,96,57,35,454,0,0,-3.0,-3,51,-30,-20,-247,1,2
834,10/28/2000,Central Michigan,34.0,36,153,23,7,83,0,0,Ball State,38.0,68,381,30,18,228,2,2,-4.0,-32,-228,-7,-11,-145,-2,-2
835,10/28/2000,Colorado,37.0,29,135,37,24,389,0,1,Oklahoma State,21.0,38,114,49,30,313,1,0,16.0,-9,21,-12,-6,76,-1,1
836,10/28/2000,Colorado State,34.0,33,84,34,22,232,1,1,San Diego State,22.0,25,26,46,30,393,2,1,12.0,8,58,-12,-8,-161,-1,0
837,10/28/2000,Duke,9.0,40,13,38,22,253,2,1,Maryland,20.0,34,172,23,12,182,3,0,-11.0,6,-159,15,10,71,-1,1
838,10/28/2000,East Carolina,13.0,41,157,35,18,253,0,1,Alabama-Birmingham,16.0,36,156,26,15,192,0,0,-3.0,5,1,9,3,61,0,1
839,10/28/2000,Florida,34.0,32,69,36,18,247,3,1,Georgia,23.0,45,173,40,20,240,3,1,11.0,-13,-104,-4,-2,7,0,0
840,10/28/2000,Fresno State,34.0,37,199,24,17,252,1,0,Tulsa,12.0,32,78,55,30,352,2,2,22.0,5,121,-31,-13,-100,-1,-2
841,10/28/2000,Florida State,58.0,54,324,22,14,195,0,0,No Carolina State,14.0,22,49,43,21,235,3,0,44.0,32,275,-21,-7,-40,-3,0
842,10/28/2000,Georgia,23.0,45,173,40,20,240,3,1,Florida,34.0,32,69,36,18,247,3,1,-11.0,13,104,4,2,-7,0,0
843,10/28/2000,Georgia Tech,31.0,40,96,57,35,454,0,0,Clemson,28.0,37,147,27,15,207,1,2,3.0,3,-51,30,20,247,-1,-2
844,10/28/2000,Hawaii,48.0,20,74,74,38,492,2,0,San Jose State,57.0,50,285,22,12,227,0,1,-9.0,-30,-211,52,26,265,2,-1
845,10/28/2000,Houston,3.0,30,-2,31,15,150,0,0,Southern Miss,6.0,38,113,33,18,215,0,1,-3.0,-8,-115,-2,-3,-65,0,-1
846,10/28/2000,Iowa State,39.0,50,339,17,10,156,1,0,Missouri,20.0,48,256,34,13,171,2,0,19.0,2,83,-17,-3,-15,-1,0
847,10/28/2000,Illinois,10.0,45,182,29,13,104,2,0,Michigan State,14.0,46,180,24,13,117,2,1,-4.0,-1,2,5,0,-13,0,-1
848,10/28/2000,Indiana,24.0,46,225,23,10,91,3,1,Penn State,27.0,35,161,23,18,198,0,1,-3.0,11,64,0,-8,-107,3,0
849,10/28/2000,Iowa,7.0,24,84,27,13,122,2,0,Wisconsin,13.0,50,118,26,18,292,1,2,-6.0,-26,-34,1,-5,-170,1,-2
850,10/28/2000,Kansas,39.0,44,172,41,23,327,0,1,Texas Tech,45.0,32,80,49,33,409,0,1,-6.0,12,92,-8,-10,-82,0,0
851,10/28/2000,Kent State,0.0,32,94,16,7,27,0,0,Western Michigan,42.0,51,241,35,22,261,0,0,-42.0,-19,-147,-19,-15,-234,0,0
852,10/28/2000,Kansas State,10.0,34,118,40,14,227,3,0,Texas A & M,26.0,53,171,20,12,155,0,0,-16.0,-19,-53,20,2,72,3,0
853,10/28/2000,Louisville,35.0,37,114,42,24,283,0,2,Tulane,32.0,25,59,72,43,388,3,2,3.0,12,55,-30,-19,-105,-3,0
854,10/28/2000,Louisiana Tech,31.0,18,67,72,42,418,3,0,Miami-Florida,42.0,48,331,31,16,185,3,1,-11.0,-30,-264,41,26,233,0,-1
855,10/28/2000,Marshall,31.0,28,43,49,26,393,0,1,Akron,28.0,52,235,25,11,170,1,0,3.0,-24,-192,24,15,223,-1,1
856,10/28/2000,Michigan State,14.0,46,180,24,13,117,2,1,Illinois,10.0,45,182,23,13,104,2,0,4.0,1,-2,1,0,13,0,1
857,10/28/2000,Maryland,20.0,34,172,23,12,182,3,0,Duke,9.0,40,13,38,22,253,2,1,11.0,-6,159,-15,-10,-71,1,-1
858,10/28/2000,Miami-Florida,42.0,48,331,31,16,185,3,1,Louisiana Tech,31.0,18,67,72,42,418,3,0,11.0,30,264,-41,-26,-233,0,1
859,10/28/2000,Miami-Ohio,15.0,42,128,43,20,261,2,2,Cincinnati,45.0,41,182,29,16,201,0,0,-30.0,1,-54,14,4,60,2,2
860,10/28/2000,Minnesota,35.0,35,120,36,20,316,1,0,Northwestern,41.0,65,334,32,18,209,0,2,-6.0,-30,-214,4,2,107,1,-2
861,10/28/2000,Mississippi,43.0,38,164,29,18,288,0,0,Nevada-Las Vegas,40.0,59,378,25,7,93,2,0,3.0,-21,-214,4,11,195,-2,0
862,10/28/2000,Missouri,20.0,48,256,34,13,171,2,0,Iowa State,39.0,50,339,17,10,156,1,0,-19.0,-2,-83,17,3,15,1,0
863,10/28/2000,Mississippi State,61.0,45,270,26,18,260,0,1,Mid Tennessee St,35.0,33,190,40,18,337,3,1,26.0,12,80,-14,0,-77,-3,0
864,10/28/2000,Mid Tennessee St,35.0,33,190,40,18,337,3,1,Mississippi State,61.0,45,270,26,18,260,0,1,-26.0,-12,-80,14,0,77,3,0
865,10/28/2000,Navy,14.0,46,127,18,10,105,1,1,Toledo,35.0,41,251,28,17,135,0,2,-21.0,5,-124,-10,-7,-30,1,-1
866,10/28/2000,North Carolina,6.0,49,157,39,22,223,1,1,Virginia,17.0,33,105,15,8,122,0,1,-11.0,16,52,24,14,101,1,0
867,10/28/2000,No Carolina State,14.0,22,49,43,21,235,3,0,Florida State,58.0,54,324,22,14,195,0,0,-44.0,-32,-275,21,7,40,3,0
868,10/28/2000,Notre Dame,34.0,47,212,25,10,171,0,1,Air Force,31.0,53,206,29,17,265,0,1,3.0,-6,6,-4,-7,-94,0,0
869,10/28/2000,Nebraska,14.0,43,195,27,12,133,1,1,Oklahoma,31.0,35,118,34,20,300,1,0,-17.0,8,77,-7,-8,-167,0,1
870,10/28/2000,Nevada-Reno,7.0,23,19,39,22,306,4,1,Southern Methodist,21.0,36,143,35,25,233,1,0,-14.0,-13,-124,4,-3,73,3,1
871,10/28/2000,Northern Illinois,73.0,54,286,32,21,360,0,0,Buffalo,10.0,30,174,29,9,107,4,0,63.0,24,112,3,12,253,-4,0
872,10/28/2000,New Mexico,10.0,53,161,12,6,39,0,0,Utah,3.0,27,60,31,13,185,2,0,7.0,26,101,-19,-7,-146,-2,0
873,10/28/2000,New Mexico State,31.0,47,317,15,9,160,0,0,Boise State,34.0,42,166,36,23,375,0,0,-3.0,5,151,-21,-14,-215,0,0
874,10/28/2000,North Texas,13.0,41,207,11,6,108,1,1,UL-Lafayette,0.0,40,114,31,17,135,1,3,13.0,1,93,-20,-11,-27,0,-2
875,10/28/2000,Northwestern,41.0,65,334,32,18,209,0,2,Minnesota,35.0,35,120,36,20,316,1,0,6.0,30,214,-4,-2,-107,-1,2
876,10/28/2000,Ohio State,27.0,31,70,29,17,208,1,1,Purdue,31.0,28,31,65,39,455,4,0,-4.0,3,39,-36,-22,-247,-3,1
877,10/28/2000,Oklahoma,31.0,35,118,34,20,300,1,0,Nebraska,14.0,43,195,27,12,133,1,1,17.0,-8,-77,7,8,167,0,-1
878,10/28/2000,Oklahoma State,21.0,38,114,49,30,313,1,0,Colorado,37.0,29,135,37,24,389,0,1,-16.0,9,-21,12,6,-76,1,-1
879,10/28/2000,Oregon,56.0,40,131,43,26,434,0,2,Arizona State,55.0,51,235,34,21,432,1,3,1.0,-11,-104,9,5,2,-1,-1
880,10/28/2000,Oregon State,38.0,43,267,30,13,146,1,0,Washington State,9.0,31,56,37,17,184,2,0,29.0,12,211,-7,-4,-38,-1,0
881,10/28/2000,Penn State,27.0,35,161,23,18,198,0,1,Indiana,24.0,46,225,23,10,91,3,1,3.0,-11,-64,0,8,107,-3,0
882,10/28/2000,Pittsburgh,34.0,29,24,26,17,311,1,0,Virginia Tech,37.0,61,283,28,15,194,1,1,-3.0,-32,-259,-2,2,117,0,-1
883,10/28/2000,Purdue,31.0,28,31,65,39,455,4,0,Ohio State,27.0,31,70,29,17,208,1,1,4.0,-3,-39,36,22,247,3,-1
884,10/28/2000,Rice,0.0,52,140,13,3,46,0,2,Texas Christian,37.0,51,249,21,11,151,1,0,-37.0,1,-109,-8,-8,-105,-1,2
885,10/28/2000,Rutgers,13.0,37,133,36,13,171,2,0,Boston College,42.0,55,325,18,11,159,0,1,-29.0,-18,-192,18,2,12,2,-1
886,10/28/2000,Southern Cal,16.0,39,118,39,19,202,2,1,California,28.0,39,82,12,7,131,0,1,-12.0,0,36,27,12,71,2,0
887,10/28/2000,South Carolina,14.0,29,24,31,16,268,1,1,Tennessee,17.0,39,101,31,19,152,1,1,-3.0,-10,-77,0,-3,116,0,0
888,10/28/2000,San Diego State,22.0,25,26,46,30,393,2,1,Colorado State,34.0,33,84,34,22,232,1,1,-12.0,-8,-58,12,8,161,1,0
889,10/28/2000,San Jose State,57.0,50,285,22,12,227,0,1,Hawaii,48.0,20,74,74,38,492,2,0,9.0,30,211,-52,-26,-265,-2,1
890,10/28/2000,Southern Miss,6.0,38,113,33,18,215,0,1,Houston,3.0,30,-2,31,15,150,0,0,3.0,8,115,2,3,65,0,1
891,10/28/2000,Southern Methodist,21.0,36,143,35,25,233,1,0,Nevada-Reno,7.0,23,19,39,22,306,4,1,14.0,13,124,-4,3,-73,-3,-1
892,10/28/2000,Stanford,28.0,44,182,30,13,166,0,1,Washington,31.0,42,170,26,15,216,2,0,-3.0,2,12,4,-2,-50,-2,1
893,10/28/2000,UL-Lafayette,0.0,40,114,31,17,135,1,3,North Texas,13.0,41,207,11,6,108,1,1,-13.0,-1,-93,20,11,27,0,2
894,10/28/2000,Texas Christian,37.0,51,249,21,11,151,1,0,Rice,0.0,52,140,13,3,46,0,2,37.0,-1,109,8,8,105,1,-2
895,10/28/2000,Tennessee,17.0,39,101,31,19,152,1,1,South Carolina,14.0,29,24,31,16,268,1,1,3.0,10,77,0,3,-116,0,0
896,10/28/2000,Texas,48.0,36,90,50,23,383,1,1,Baylor,14.0,32,57,33,9,77,4,1,34.0,4,33,17,14,306,-3,0
897,10/28/2000,Toledo,35.0,41,251,28,17,135,0,2,Navy,14.0,46,127,18,10,105,1,1,21.0,-5,124,10,7,30,-1,1
898,10/28/2000,Texas Tech,45.0,32,80,49,33,409,0,1,Kansas,39.0,44,172,41,23,327,0,1,6.0,-12,-92,8,10,82,0,0
899,10/28/2000,Tulane,32.0,25,59,72,43,388,3,1,Louisville,35.0,37,114,42,24,283,0,2,-3.0,-12,-55,30,19,105,3,-1
900,10/28/2000,Tulsa,12.0,32,78,55,30,352,2,2,Fresno State,34.0,37,199,24,17,252,1,0,-22.0,-5,-121,31,13,100,1,2
901,10/28/2000,Texas A & M,26.0,53,171,20,12,155,0,0,Kansas State,10.0,34,118,40,14,227,3,0,16.0,19,53,-20,-2,-72,-3,0
902,10/28/2000,Alabama-Birmingham,16.0,36,156,26,15,192,0,0,East Carolina,13.0,41,157,35,18,253,0,0,3.0,-5,-1,-9,-3,-61,0,0
903,10/28/2000,U.C.L.A.,27.0,39,54,35,19,230,2,0,Arizona,24.0,45,211,18,7,105,4,0,3.0,-6,-157,17,12,125,-2,0
904,10/28/2000,Nevada-Las Vegas,40.0,59,378,25,7,93,2,0,Mississippi,43.0,38,163,29,18,288,0,0,-3.0,21,215,-4,-11,-195,2,0
905,10/28/2000,Utah,3.0,27,60,31,13,185,2,0,New Mexico,10.0,53,161,12,6,39,0,0,-7.0,-26,-101,19,7,146,2,0
906,10/28/2000,Utah State,44.0,39,236,43,24,247,0,1,Arkansas State,31.0,30,68,44,22,231,1,1,13.0,9,168,-1,2,16,-1,0
907,10/28/2000,Virginia,17.0,33,105,15,8,122,0,1,North Carolina,6.0,49,157,39,22,223,1,1,11.0,-16,-52,-24,-14,-101,-1,0
908,10/28/2000,Virginia Tech,37.0,61,283,28,15,194,1,1,Pittsburgh,34.0,29,24,26,17,311,1,0,3.0,32,259,2,-2,-117,0,1
909,10/28/2000,Washington,31.0,42,170,26,15,216,2,0,Stanford,28.0,44,182,30,13,166,0,1,3.0,-2,-12,-4,2,50,2,-1
910,10/28/2000,Washington State,9.0,31,56,37,17,184,2,0,Oregon State,38.0,43,267,30,13,146,1,0,-29.0,-12,-211,7,4,38,1,0
911,10/28/2000,Wisconsin,13.0,50,118,26,18,292,1,2,Iowa,7.0,24,84,27,13,122,2,0,6.0,26,34,-1,5,170,-1,2
912,10/28/2000,Western Michigan,42.0,51,241,35,22,261,0,0,Kent State,0.0,32,94,16,7,27,0,0,42.0,19,147,19,15,234,0,0
913,10/28/2000,Wyoming,7.0,36,67,30,19,169,4,1,Brigham Young,19.0,40,128,34,22,225,1,3,-12.0,-4,-61,-4,-3,-56,3,-2
914,11/04/2000,Air Force,41.0,59,278,22,14,163,0,0,Army,27.0,35,233,32,15,134,2,0,14.0,24,45,-10,-1,29,-2,0
915,11/04/2000,Arkansas State,14.0,23,53,28,19,219,0,1,Boise State,42.0,52,206,28,20,304,1,1,-28.0,-29,-153,0,-1,-85,-1,0
916,11/04/2000,Alabama,28.0,38,164,33,15,150,1,2,Louisiana State,30.0,39,133,31,18,275,0,0,-2.0,-1,31,2,-3,-125,1,2
917,11/04/2000,Arizona,32.0,51,263,34,13,208,0,1,Washington,35.0,30,211,34,17,196,1,3,-3.0,21,52,0,-4,12,-1,-2
918,11/04/2000,Arkansas,24.0,36,212,37,16,181,2,0,Mississippi,38.0,42,194,25,10,109,0,0,-14.0,-6,18,12,6,72,2,0
919,11/04/2000,Army,27.0,35,233,32,15,134,2,0,Air Force,41.0,59,278,22,14,163,0,0,-14.0,-24,-45,10,1,-29,2,0
920,11/04/2000,Arizona State,38.0,36,77,54,30,314,1,1,Southern Cal,44.0,45,261,37,22,279,2,4,-6.0,-9,-184,17,8,35,-1,-3
921,11/04/2000,Ball State,3.0,45,132,31,11,96,2,0,Western Michigan,42.0,36,210,39,22,314,2,0,-39.0,9,-78,-8,-11,-218,0,0
922,11/04/2000,Baylor,7.0,28,69,30,9,25,2,0,Oklahoma,56.0,39,129,38,25,387,2,0,-49.0,-11,-60,-8,-16,-362,0,0
923,11/04/2000,Boise State,42.0,52,206,28,20,304,1,1,Arkansas State,14.0,23,53,28,19,219,0,1,28.0,29,153,0,1,85,1,0
924,11/04/2000,Boston College,31.0,45,154,28,19,273,1,0,Temple,3.0,32,92,24,10,126,3,1,28.0,13,62,4,9,147,-2,-1
925,11/04/2000,Bowling Green,13.0,40,85,24,12,123,3,0,Marshall,20.0,31,64,35,20,202,2,0,-7.0,9,21,-11,-8,-79,1,0
926,11/04/2000,Buffalo,20.0,50,73,36,23,323,1,0,Kent State,17.0,39,108,31,18,185,1,0,3.0,11,-35,5,5,138,0,0
927,11/04/2000,Brigham Young,21.0,16,57,41,18,120,3,2,Colorado State,45.0,43,165,31,19,298,0,3,-24.0,-27,-108,10,-1,-178,3,-1
928,11/04/2000,California,32.0,30,27,44,17,349,2,0,Oregon State,38.0,47,207,28,11,317,1,1,-6.0,-17,-180,16,6,32,1,-1
929,11/04/2000,Central Florida,20.0,24,47,37,18,254,1,0,Louisiana Tech,16.0,28,53,52,34,363,2,0,4.0,-4,-6,-15,-16,-109,-1,0
930,11/04/2000,Cincinnati,33.0,44,126,32,20,351,1,1,Alabama-Birmingham,21.0,35,138,34,17,183,2,2,12.0,9,-12,-2,3,168,-1,-1
931,11/04/2000,Clemson,7.0,36,95,38,15,167,3,0,Florida State,54.0,40,250,43,27,521,0,2,-47.0,-4,-155,-5,-12,-354,3,-2
932,11/04/2000,Central Michigan,15.0,36,40,41,23,276,2,3,Eastern Michigan,31.0,49,225,26,17,109,1,0,-16.0,-13,-185,15,6,167,1,3
933,11/04/2000,Colorado,28.0,34,54,32,17,147,2,1,Missouri,18.0,60,159,34,17,246,3,2,10.0,-26,-105,-2,0,-99,-1,-1
934,11/04/2000,Colorado State,45.0,43,165,31,19,298,0,3,Brigham Young,21.0,16,57,41,18,120,3,2,24.0,27,108,-10,1,178,-3,1
935,11/04/2000,Duke,26.0,30,50,46,29,354,2,0,Wake Forest,28.0,48,244,20,13,138,0,1,-2.0,-18,-194,26,16,216,2,-1
936,11/04/2000,Eastern Michigan,31.0,49,225,26,17,109,1,0,Central Michigan,15.0,36,40,41,23,276,2,3,16.0,13,185,-15,-6,-167,-1,-3
937,11/04/2000,Florida,43.0,38,141,36,21,334,2,1,Vanderbilt,20.0,33,52,41,15,147,5,0,23.0,5,89,-5,6,187,-3,1
938,11/04/2000,Fresno State,45.0,42,209,31,23,257,0,1,Hawaii,27.0,27,138,44,26,297,2,0,18.0,15,71,-13,-3,-40,-2,1
939,11/04/2000,Florida State,54.0,40,250,43,27,521,0,2,Clemson,7.0,36,95,38,15,167,3,1,47.0,4,155,5,12,354,-3,1
940,11/04/2000,Hawaii,27.0,27,138,44,26,297,2,0,Fresno State,45.0,42,209,31,23,257,0,1,-18.0,-15,-71,13,3,40,2,-1
941,11/04/2000,Houston,23.0,38,146,45,25,248,0,0,Tulane,41.0,35,142,33,19,309,1,1,-18.0,3,4,12,6,-61,-1,-1
942,11/04/2000,Iowa State,10.0,28,80,42,18,211,2,1,Kansas State,56.0,60,367,20,13,216,0,1,-46.0,-32,-287,22,5,-5,2,0
943,11/04/2000,Idaho,16.0,35,150,45,27,319,0,1,North Texas,14.0,42,134,24,10,145,0,0,2.0,-7,16,21,17,174,0,1
944,11/04/2000,Illinois,42.0,36,99,29,21,277,0,0,Indiana,35.0,65,447,18,10,130,1,1,7.0,-29,-348,11,11,147,-1,-1
945,11/04/2000,Indiana,35.0,65,447,18,10,130,1,1,Illinois,42.0,36,99,29,21,277,0,0,-7.0,29,348,-11,-11,-147,1,1
946,11/04/2000,Iowa,26.0,44,162,37,25,232,1,0,Penn State,23.0,30,132,51,27,302,1,0,3.0,14,30,-14,-2,-70,0,0
947,11/04/2000,Kansas,17.0,29,97,31,16,169,1,1,Nebraska,56.0,73,493,8,7,69,0,2,-39.0,-44,-396,23,9,100,1,-1
948,11/04/2000,Kent State,17.0,39,108,31,18,185,1,0,Buffalo,20.0,50,73,36,23,323,1,0,-3.0,-11,35,-5,-5,-138,0,0
949,11/04/2000,Kansas State,56.0,60,367,20,13,216,0,1,Iowa State,10.0,28,80,42,18,211,2,1,46.0,32,287,-22,-5,5,-2,0
950,11/04/2000,Kentucky,17.0,31,122,53,23,264,4,3,Mississippi State,35.0,44,253,20,11,212,2,3,-18.0,-13,-131,33,12,52,2,0
951,11/04/2000,Louisville,49.0,33,126,42,25,293,0,2,Southern Miss,28.0,36,61,32,18,300,4,0,21.0,-3,65,10,7,-7,-4,2
952,11/04/2000,Louisiana State,30.0,39,133,31,18,275,0,0,Alabama,28.0,38,164,33,15,150,1,2,2.0,1,-31,-2,3,125,-1,-2
953,11/04/2000,Louisiana Tech,16.0,28,53,52,34,363,2,0,Central Florida,20.0,24,47,37,18,254,1,0,-4.0,4,6,15,16,109,1,0
954,11/04/2000,Marshall,20.0,31,64,35,20,202,2,0,Bowling Green,13.0,40,85,24,12,123,3,0,7.0,-9,-21,11,8,79,-1,0
955,11/04/2000,Michigan State,13.0,39,108,24,14,103,2,2,Ohio State,27.0,50,157,21,9,132,2,1,-14.0,-11,-49,3,5,-29,0,1
956,11/04/2000,Maryland,35.0,41,138,34,21,200,1,0,No Carolina State,28.0,47,218,35,16,183,0,1,7.0,-6,-80,-1,5,17,1,-1
957,11/04/2000,Memphis,17.0,28,47,27,15,137,0,2,Tennessee,19.0,42,99,31,19,224,1,2,-2.0,-14,-52,-4,-4,-87,-1,0
958,11/04/2000,Miami-Florida,41.0,39,183,23,11,283,0,1,Virginia Tech,21.0,44,162,30,15,234,2,1,20.0,-5,21,-7,-4,49,-2,0
959,11/04/2000,Miami-Ohio,27.0,35,135,21,9,213,1,0,Ohio,24.0,70,399,6,3,38,1,1,3.0,-35,-264,15,6,175,0,-1
960,11/04/2000,Michigan,51.0,44,217,37,24,318,0,2,Northwestern,54.0,50,332,40,27,322,0,0,-3.0,-6,-115,-3,-3,-4,0,2
961,11/04/2000,Minnesota,20.0,51,303,32,18,187,3,1,Wisconsin,41.0,46,216,21,12,204,1,0,-21.0,5,87,11,6,-17,2,1
962,11/04/2000,Mississippi,38.0,42,194,25,10,109,0,0,Arkansas,24.0,36,212,37,16,181,2,0,14.0,6,-18,-12,-6,-72,-2,0
963,11/04/2000,Missouri,18.0,60,159,34,17,246,3,2,Colorado,28.0,34,54,32,17,147,2,1,-10.0,26,105,2,0,99,1,1
964,11/04/2000,Mississippi State,35.0,44,253,20,11,212,2,3,Kentucky,17.0,31,122,53,23,264,4,3,18.0,13,131,-33,-12,-52,-2,0
965,11/04/2000,Mid Tennessee St,66.0,41,301,28,21,269,0,0,Connecticut,10.0,28,81,46,24,276,4,1,56.0,13,220,-18,-3,-7,-4,-1
966,11/04/2000,North Carolina,20.0,47,129,32,13,164,2,0,Pittsburgh,17.0,32,63,39,18,344,0,3,3.0,15,66,-7,-5,-180,2,-3
967,11/04/2000,No Carolina State,28.0,47,218,35,16,183,0,1,Maryland,35.0,41,138,34,21,200,1,0,-7.0,6,80,1,-5,-17,-1,1
968,11/04/2000,Nebraska,56.0,73,493,8,7,69,0,2,Kansas,17.0,29,97,31,16,169,1,1,39.0,44,396,-23,-9,-100,-1,1
969,11/04/2000,UL-Monroe,18.0,33,81,26,14,147,2,0,UL-Lafayette,21.0,39,91,30,15,177,1,0,-3.0,-6,-10,-4,-1,-30,1,0
970,11/04/2000,Nevada-Reno,22.0,26,44,48,21,258,3,1,Texas-El Paso,45.0,50,179,35,20,323,0,2,-23.0,-24,-135,13,1,-65,3,-1
971,11/04/2000,Northern Illinois,24.0,36,165,26,13,193,1,0,Toledo,38.0,55,335,26,21,226,0,1,-14.0,-19,-170,0,-8,-33,1,-1
972,11/04/2000,New Mexico,16.0,42,114,30,14,154,1,1,San Diego State,17.0,38,35,24,12,148,0,2,-1.0,4,79,6,2,6,1,-1
973,11/04/2000,New Mexico State,37.0,52,369,32,15,226,0,1,Utah State,44.0,36,322,39,24,297,0,2,-7.0,16,47,-7,-9,-71,0,-1
974,11/04/2000,North Texas,14.0,42,134,24,10,145,0,0,Idaho,16.0,35,150,45,27,319,0,1,-2.0,7,-16,-21,-17,-174,0,-1
975,11/04/2000,Northwestern,54.0,50,332,40,27,322,0,0,Michigan,51.0,44,217,37,24,318,0,2,3.0,6,115,3,3,4,0,-2
976,11/04/2000,Ohio,24.0,70,399,6,3,38,1,1,Miami-Ohio,27.0,35,135,21,9,213,1,0,-3.0,35,264,-15,-6,-175,0,1
977,11/04/2000,Ohio State,27.0,50,157,21,9,132,2,1,Michigan State,13.0,39,108,24,14,103,2,2,14.0,11,49,-3,-5,29,0,-1
978,11/04/2000,Oklahoma,56.0,39,129,38,25,387,2,0,Baylor,7.0,28,69,30,9,25,2,0,49.0,11,60,8,16,362,0,0
979,11/04/2000,Oklahoma State,16.0,35,167,33,16,155,2,0,Texas A & M,21.0,37,190,37,24,246,1,1,-5.0,-2,-23,-4,-8,-91,1,-1
980,11/04/2000,Oregon,27.0,21,94,39,18,212,1,0,Washington State,24.0,47,122,34,14,217,1,0,3.0,-26,-28,5,4,-5,0,0
981,11/04/2000,Oregon State,38.0,47,207,28,11,317,1,1,California,32.0,30,27,44,17,349,2,0,6.0,17,180,-16,-6,-32,-1,1
982,11/04/2000,Penn State,23.0,30,132,51,27,302,1,0,Iowa,26.0,44,162,37,25,232,1,0,-3.0,-14,-30,14,2,70,0,0
983,11/04/2000,Pittsburgh,17.0,32,63,39,18,344,0,3,North Carolina,20.0,47,129,32,13,164,2,0,-3.0,-15,-66,7,5,180,-2,3
984,11/04/2000,Rice,43.0,62,301,5,1,12,0,0,Southern Methodist,14.0,35,133,26,13,93,3,1,29.0,27,168,-21,-12,-81,-3,-1
985,11/04/2000,Southern Cal,44.0,45,261,37,22,279,2,4,Arizona State,38.0,36,77,54,30,314,1,1,6.0,9,184,-17,-8,-35,1,3
986,11/04/2000,San Diego State,17.0,38,35,24,12,148,0,2,New Mexico,16.0,42,114,30,14,154,1,1,1.0,-4,-79,-6,-2,-6,-1,1
987,11/04/2000,San Jose State,27.0,45,138,24,11,237,2,0,Texas Christian,24.0,42,164,23,12,194,1,2,3.0,3,-26,1,-1,43,1,-2
988,11/04/2000,Southern Miss,28.0,36,61,32,18,300,4,0,Louisville,49.0,33,126,42,25,293,0,2,-21.0,3,-65,-10,-7,7,4,-2
989,11/04/2000,Southern Methodist,14.0,35,133,26,13,93,3,1,Rice,43.0,62,301,5,1,12,0,0,-29.0,-27,-168,21,12,81,3,1
990,11/04/2000,Stanford,35.0,40,178,46,23,317,2,2,U.C.L.A.,37.0,40,117,28,17,346,2,1,-2.0,0,61,18,6,-29,0,1
991,11/04/2000,UL-Lafayette,21.0,39,91,30,15,177,1,0,UL-Monroe,18.0,33,81,26,14,147,2,0,3.0,6,10,4,1,30,-1,0
992,11/04/2000,Syracuse,31.0,42,183,37,20,216,1,0,West Virginia,27.0,37,169,21,8,156,2,0,4.0,5,14,16,12,60,-1,0
993,11/04/2000,Texas Christian,24.0,42,164,23,12,194,1,2,San Jose State,27.0,45,138,24,11,237,2,0,-3.0,-3,26,-1,1,-43,-1,2
994,11/04/2000,Temple,3.0,32,92,24,10,126,3,1,Boston College,31.0,45,154,28,19,273,1,0,-28.0,-13,-62,-4,-9,-147,2,1
995,11/04/2000,Tennessee,19.0,42,99,31,19,224,1,2,Memphis,17.0,28,47,27,15,137,0,2,2.0,14,52,4,4,87,1,0
996,11/04/2000,Texas,29.0,53,233,35,20,182,1,1,Texas Tech,17.0,14,17,49,28,282,2,3,12.0,39,216,-14,-8,-100,-1,-2
997,11/04/2000,Toledo,38.0,55,335,26,21,226,0,1,Northern Illinois,24.0,36,165,26,13,193,1,0,14.0,19,170,0,8,33,-1,1
998,11/04/2000,Texas Tech,17.0,14,17,49,28,282,2,3,Texas,29.0,53,233,35,20,182,1,1,-12.0,-39,-216,14,8,100,1,2
999,11/04/2000,Tulane,41.0,35,142,33,19,309,1,1,Houston,23.0,38,146,45,25,248,0,0,18.0,-3,-4,-12,-6,61,1,1
1000,11/04/2000,Texas A & M,21.0,37,190,37,24,246,1,1,Oklahoma State,16.0,35,167,33,16,155,2,0,5.0,2,23,4,8,91,-1,1
1001,11/04/2000,Alabama-Birmingham,21.0,35,138,34,17,183,2,2,Cincinnati,33.0,44,126,32,20,351,1,1,-12.0,-9,12,2,-3,-168,1,1
1002,11/04/2000,U.C.L.A.,37.0,40,117,28,17,346,2,1,Stanford,35.0,40,178,46,23,317,2,2,2.0,0,-61,-18,-6,29,0,-1
1003,11/04/2000,Nevada-Las Vegas,16.0,40,163,21,11,78,0,2,Utah,38.0,44,193,21,13,157,0,1,-22.0,-4,-30,0,-2,-79,0,1
1004,11/04/2000,Utah,38.0,44,193,21,13,157,0,1,Nevada-Las Vegas,16.0,40,163,21,11,78,0,2,22.0,4,30,0,2,79,0,-1
1005,11/04/2000,Texas-El Paso,45.0,50,179,35,20,323,0,2,Nevada-Reno,22.0,26,44,48,21,258,3,1,23.0,24,135,-13,-1,65,-3,1
1006,11/04/2000,Utah State,44.0,36,322,39,24,297,0,2,New Mexico State,37.0,52,369,32,15,226,0,1,7.0,-16,-47,7,9,71,0,1
1007,11/04/2000,Vanderbilt,20.0,33,52,41,15,147,5,0,Florida,43.0,38,141,36,21,334,2,1,-23.0,-5,-89,5,-6,-187,3,-1
1008,11/04/2000,Virginia Tech,21.0,44,162,30,15,234,2,1,Miami-Florida,41.0,39,183,23,11,283,0,1,-20.0,5,-21,7,4,-49,2,0
1009,11/04/2000,Washington,35.0,30,211,34,17,196,1,3,Arizona,32.0,51,263,34,13,208,0,1,3.0,-21,-52,0,4,-12,1,2
1010,11/04/2000,Washington State,24.0,47,122,34,14,217,1,0,Oregon,27.0,21,94,39,18,212,1,0,-3.0,26,28,-5,-4,5,0,0
1011,11/04/2000,Wake Forest,28.0,48,244,20,13,138,0,1,Duke,26.0,30,50,46,29,354,2,0,2.0,18,194,-26,-16,-216,-2,1
1012,11/04/2000,Wisconsin,41.0,46,216,21,12,204,1,0,Minnesota,20.0,51,303,32,18,187,3,1,21.0,-5,-87,-11,-6,17,-2,-1
1013,11/04/2000,Western Michigan,42.0,36,210,39,22,314,2,0,Ball State,3.0,45,132,31,11,96,2,0,39.0,-9,78,8,11,218,0,0
1014,11/04/2000,West Virginia,27.0,37,169,21,8,156,2,0,Syracuse,31.0,42,183,37,20,216,1,0,-4.0,-5,-14,-16,-12,-60,1,0
1015,11/11/2000,Air Force,44.0,74,400,15,10,130,1,1,Colorado State,40.0,18,178,41,22,334,1,2,4.0,56,222,-26,-12,-204,0,-1
1016,11/11/2000,Akron,49.0,42,241,25,12,287,2,0,Buffalo,14.0,54,243,26,9,100,1,3,35.0,-12,-2,-1,3,187,1,-3
1017,11/11/2000,Arkansas State,53.0,31,193,38,21,213,1,0,North Texas,28.0,37,111,31,19,214,2,1,25.0,-6,82,7,2,-1,-1,-1
1018,11/11/2000,Alabama,7.0,28,31,31,13,281,2,0,Mississippi State,29.0,50,276,27,18,262,0,1,-22.0,-22,-245,4,-5,19,2,-1
1019,11/11/2000,Arizona,9.0,31,69,22,9,89,1,0,Oregon State,33.0,41,73,31,17,231,1,0,-24.0,-10,-4,-9,-8,-142,0,0
1020,11/11/2000,Arkansas,20.0,35,118,20,11,128,1,3,Tennessee,63.0,51,290,34,19,212,0,0,-43.0,-16,-172,-14,-8,-84,1,3
1021,11/11/2000,Army,17.0,55,137,25,10,111,0,0,Louisville,38.0,28,126,34,23,307,1,1,-21.0,27,11,-9,-13,-196,-1,-1
1022,11/11/2000,Auburn,29.0,37,150,38,24,149,2,0,Georgia,26.0,26,55,35,23,164,1,2,3.0,11,95,3,1,-15,1,-2
1023,11/11/2000,Arizona State,7.0,34,23,38,13,151,2,0,Stanford,29.0,45,145,30,17,169,0,0,-22.0,-11,-122,8,-4,-18,2,0
1024,11/11/2000,Ball State,3.0,44,81,36,24,200,2,0,Toledo,31.0,35,260,19,6,82,0,0,-28.0,9,-179,17,18,118,2,0
1025,11/11/2000,Baylor,22.0,41,13,30,15,195,3,1,Missouri,47.0,52,273,28,16,199,1,1,-25.0,-11,-260,2,-1,-4,2,0
1026,11/11/2000,Boise State,66.0,48,260,30,21,381,0,1,Utah State,38.0,24,86,57,25,509,0,0,28.0,24,174,-27,-4,-128,0,1
1027,11/11/2000,Boston College,16.0,30,124,29,15,172,2,0,Notre Dame,28.0,61,380,12,9,86,0,2,-12.0,-31,-256,17,6,86,2,-2
1028,11/11/2000,Bowling Green,21.0,36,102,25,14,236,1,0,Ohio,23.0,55,277,12,2,17,1,0,-2.0,-19,-175,13,12,219,0,0
1029,11/11/2000,Buffalo,14.0,54,243,26,9,100,1,3,Akron,49.0,42,241,25,12,287,2,0,-35.0,12,2,1,-3,-187,-1,3
1030,11/11/2000,California,17.0,28,88,39,15,197,1,0,Oregon,25.0,38,76,36,20,252,1,1,-8.0,-10,12,3,-5,-55,0,-1
1031,11/11/2000,Central Florida,21.0,23,21,45,28,362,4,2,Virginia Tech,44.0,61,313,8,2,55,0,0,-23.0,-38,-292,37,26,307,4,2
1032,11/11/2000,Cincinnati,13.0,31,66,33,15,124,2,0,Memphis,10.0,42,152,34,20,203,4,3,3.0,-11,-86,-1,-5,-79,-2,-3
1033,11/11/2000,Central Michigan,21.0,43,97,29,17,220,0,0,Western Michigan,17.0,44,176,20,8,99,3,0,4.0,-1,-79,9,9,121,-3,0
1034,11/11/2000,Colorado,27.0,38,132,34,25,307,1,3,Iowa State,35.0,47,277,27,15,173,1,1,-8.0,-9,-145,7,10,134,0,2
1035,11/11/2000,Colorado State,40.0,18,178,41,22,334,1,2,Air Force,44.0,74,400,15,10,130,1,1,-4.0,-56,-222,26,12,204,0,1
1036,11/11/2000,Duke,31.0,35,155,37,24,319,1,1,No Carolina State,35.0,25,48,51,32,413,1,1,-4.0,10,107,-14,-8,-94,0,0
1037,11/11/2000,East Carolina,62.0,54,247,27,12,183,0,0,Houston,20.0,35,100,33,15,238,1,1,42.0,19,147,-6,-3,-55,-1,-1
1038,11/11/2000,Eastern Michigan,39.0,33,131,51,36,372,0,1,Northern Illinois,32.0,43,278,25,13,144,2,2,7.0,-10,-147,26,23,228,-2,-1
1039,11/11/2000,Florida,41.0,31,152,46,27,356,0,0,South Carolina,21.0,35,81,28,19,166,0,1,20.0,-4,71,18,8,190,0,-1
1040,11/11/2000,Fresno State,7.0,30,41,31,15,183,2,2,Texas Christian,24.0,62,217,15,7,78,0,1,-17.0,-32,-176,16,8,105,2,1
1041,11/11/2000,Florida State,35.0,25,229,39,24,327,3,0,Wake Forest,6.0,46,162,26,11,114,1,0,29.0,-21,67,13,13,213,2,0
1042,11/11/2000,Georgia,26.0,26,55,35,23,164,1,2,Auburn,29.0,37,150,38,24,149,2,0,-3.0,-11,-95,-3,-1,15,-1,2
1043,11/11/2000,Georgia Tech,35.0,57,304,37,29,323,0,0,Virginia,0.0,29,154,30,14,136,1,2,35.0,28,150,7,15,187,-1,-2
1044,11/11/2000,Hawaii,37.0,29,155,45,24,283,2,1,Nevada-Reno,17.0,32,41,51,27,337,2,2,20.0,-3,114,-6,-3,-54,0,-1
1045,11/11/2000,Houston,20.0,35,100,33,15,238,1,1,East Carolina,62.0,54,247,27,12,183,0,0,-42.0,-19,-147,6,3,55,1,1
1046,11/11/2000,Iowa State,35.0,47,277,27,15,173,1,1,Colorado,27.0,38,132,34,25,307,1,3,8.0,9,145,-7,-10,-134,0,-2
1047,11/11/2000,Idaho,44.0,39,157,37,19,366,1,1,New Mexico State,41.0,64,432,28,14,228,2,2,3.0,-25,-275,9,5,138,-1,-1
1048,11/11/2000,Illinois,21.0,30,152,30,16,181,1,0,Ohio State,24.0,57,223,38,23,251,3,0,-3.0,-27,-71,-8,-7,-70,-2,0
1049,11/11/2000,Indiana,22.0,47,250,35,15,209,4,1,Wisconsin,43.0,39,228,23,16,207,0,3,-21.0,8,22,12,-1,2,4,-2
1050,11/11/2000,Iowa,27.0,40,103,27,17,250,0,0,Northwestern,17.0,50,129,45,25,248,0,0,10.0,-10,-26,-18,-8,2,0,0
1051,11/11/2000,Kansas,16.0,36,125,25,10,111,1,1,Texas,51.0,61,396,19,11,241,2,0,-35.0,-25,-271,6,-1,-130,-1,1
1052,11/11/2000,Kansas State,29.0,43,143,36,12,234,1,1,Nebraska,28.0,45,200,13,2,39,1,1,1.0,-2,-57,23,10,195,0,0
1053,11/11/2000,Kentucky,20.0,33,192,55,33,385,1,1,Vanderbilt,24.0,32,82,29,17,263,0,1,-4.0,1,110,26,16,122,1,0
1054,11/11/2000,Louisville,38.0,28,126,34,23,307,1,1,Army,17.0,55,137,25,10,111,0,0,21.0,-27,-11,9,13,196,1,1
1055,11/11/2000,Louisiana State,20.0,37,152,30,16,290,2,0,Mississippi,9.0,34,73,37,20,287,1,1,11.0,3,79,-7,-4,3,1,-1
1056,11/11/2000,Marshall,51.0,40,196,33,21,290,0,1,Miami-Ohio,31.0,49,185,39,21,283,2,3,20.0,-9,11,-6,0,7,-2,-2
1057,11/11/2000,Michigan State,30.0,51,292,23,12,195,1,0,Purdue,10.0,21,79,43,26,279,3,0,20.0,30,213,-20,-14,-84,-2,0
1058,11/11/2000,Maryland,10.0,47,145,31,16,164,1,0,North Carolina,13.0,38,241,16,7,42,1,2,-3.0,9,-96,15,9,122,0,-2
1059,11/11/2000,Memphis,10.0,42,152,34,20,203,4,3,Cincinnati,13.0,31,66,33,15,124,2,0,-3.0,11,86,1,5,79,2,3
1060,11/11/2000,Miami-Florida,35.0,41,155,37,22,264,0,0,Pittsburgh,7.0,30,77,39,19,189,2,1,28.0,11,78,-2,3,75,-2,-1
1061,11/11/2000,Miami-Ohio,31.0,49,185,39,21,283,2,3,Marshall,51.0,40,196,33,21,290,0,1,-20.0,9,-11,6,0,-7,2,2
1062,11/11/2000,Michigan,33.0,50,232,29,14,212,3,0,Penn State,11.0,34,177,35,19,230,4,1,22.0,16,55,-6,-5,-18,-1,-1
1063,11/11/2000,Mississippi,9.0,34,73,37,20,287,1,1,Louisiana State,20.0,37,152,30,16,290,2,0,-11.0,-3,-79,7,4,-3,-1,1
1064,11/11/2000,Missouri,47.0,52,273,28,16,199,1,1,Baylor,22.0,41,13,30,15,195,3,1,25.0,11,260,-2,1,4,-2,0
1065,11/11/2000,Mississippi State,29.0,50,276,27,18,262,0,1,Alabama,7.0,28,31,31,13,281,2,0,22.0,22,245,-4,5,-19,-2,1
1066,11/11/2000,Mid Tennessee St,45.0,34,188,25,15,232,0,0,South Florida,9.0,28,91,44,27,206,2,1,36.0,6,97,-19,-12,26,-2,-1
1067,11/11/2000,Navy,38.0,56,362,43,24,362,3,3,Tulane,50.0,29,125,41,26,380,2,0,-12.0,27,237,2,-2,-18,1,3
1068,11/11/2000,North Carolina,13.0,38,241,16,7,42,1,2,Maryland,10.0,47,145,31,16,164,1,0,3.0,-9,96,-15,-9,-122,0,2
1069,11/11/2000,No Carolina State,35.0,25,48,51,32,413,1,1,Duke,31.0,35,155,37,24,319,1,1,4.0,-10,-107,14,8,94,0,0
1070,11/11/2000,Notre Dame,28.0,61,380,12,9,86,0,2,Boston College,16.0,30,124,29,15,172,2,0,12.0,31,256,-17,-6,-86,-2,2
1071,11/11/2000,Nebraska,28.0,45,200,13,2,39,1,1,Kansas State,29.0,43,143,36,12,234,1,1,-1.0,2,57,-23,-10,-195,0,0
1072,11/11/2000,Nevada-Reno,17.0,32,41,51,27,337,2,2,Hawaii,37.0,29,155,45,24,283,2,1,-20.0,3,-114,6,3,54,0,1
1073,11/11/2000,Northern Illinois,32.0,43,278,25,13,144,2,2,Eastern Michigan,39.0,33,131,51,36,372,0,1,-7.0,10,147,-26,-23,-228,2,1
1074,11/11/2000,New Mexico,14.0,43,143,11,4,61,2,1,Nevada-Las Vegas,18.0,46,181,21,13,148,3,2,-4.0,-3,-38,-10,-9,-87,-1,-1
1075,11/11/2000,New Mexico State,41.0,64,432,28,14,228,2,2,Idaho,44.0,39,157,37,19,366,1,1,-3.0,25,275,-9,-5,-138,1,1
1076,11/11/2000,North Texas,28.0,37,111,31,19,214,2,1,Arkansas State,53.0,31,193,38,21,213,1,0,-25.0,6,-82,-7,-2,1,1,1
1077,11/11/2000,Northwestern,17.0,50,129,45,25,248,0,0,Iowa,27.0,40,103,27,17,250,0,0,-10.0,10,26,18,8,-2,0,0
1078,11/11/2000,Ohio,23.0,55,277,12,2,17,1,0,Bowling Green,21.0,36,102,25,14,236,1,0,2.0,19,175,-13,-12,-219,0,0
1079,11/11/2000,Ohio State,24.0,57,223,38,23,251,3,0,Illinois,21.0,30,152,30,16,181,1,0,3.0,27,71,8,7,70,2,0
1080,11/11/2000,Oklahoma,35.0,28,105,42,28,263,2,1,Texas A & M,31.0,37,97,37,18,219,2,0,4.0,-9,8,5,10,44,0,1
1081,11/11/2000,Oklahoma State,0.0,39,107,39,22,223,2,1,Texas Tech,58.0,29,152,47,32,252,0,0,-58.0,10,-45,-8,-10,-29,2,1
1082,11/11/2000,Oregon,25.0,38,76,36,20,252,1,1,California,17.0,28,88,39,15,197,1,0,8.0,10,-12,-3,5,55,0,1
1083,11/11/2000,Oregon State,33.0,41,73,31,17,231,1,0,Arizona,9.0,31,69,22,9,89,1,0,24.0,10,4,9,8,142,0,0
1084,11/11/2000,Penn State,11.0,34,177,35,19,230,4,1,Michigan,33.0,50,232,29,14,212,3,0,-22.0,-16,-55,6,5,18,1,1
1085,11/11/2000,Pittsburgh,7.0,30,77,39,19,189,2,1,Miami-Florida,35.0,41,155,37,22,264,0,0,-28.0,-11,-78,2,-3,-75,2,1
1086,11/11/2000,Purdue,10.0,21,79,43,26,279,3,0,Michigan State,30.0,51,292,23,12,195,1,0,-20.0,-30,-213,20,14,84,2,0
1087,11/11/2000,Rice,21.0,43,175,18,7,130,0,0,Texas-El Paso,38.0,35,115,30,21,339,0,0,-17.0,8,60,-12,-14,-209,0,0
1088,11/11/2000,Rutgers,24.0,35,176,48,24,274,4,2,West Virginia,31.0,51,152,26,12,126,1,1,-7.0,-16,24,22,12,148,3,1
1089,11/11/2000,Southern Cal,28.0,41,91,54,29,379,1,2,Washington State,33.0,38,130,32,12,242,0,2,-5.0,3,-39,22,17,137,1,0
1090,11/11/2000,South Carolina,21.0,35,81,28,19,166,0,1,Florida,41.0,31,152,46,27,356,0,0,-20.0,4,-71,-18,-8,-190,0,1
1091,11/11/2000,Southern Miss,33.0,38,46,34,25,261,1,0,Alabama-Birmingham,30.0,51,191,25,15,146,0,0,3.0,-13,-145,9,10,115,1,0
1092,11/11/2000,Southern Methodist,24.0,39,177,19,14,157,1,1,Tulsa,20.0,38,85,36,19,227,0,1,4.0,1,92,-17,-5,-70,1,0
1093,11/11/2000,Stanford,29.0,45,145,30,17,169,0,0,Arizona State,7.0,34,23,38,13,151,2,0,22.0,11,122,-8,4,18,-2,0
1094,11/11/2000,UL-Lafayette,14.0,36,176,37,15,198,4,1,Jacksonville St,28.0,47,201,23,13,205,0,2,-14.0,-11,-25,14,2,-7,4,-1
1095,11/11/2000,Syracuse,31.0,57,224,14,4,62,2,0,Temple,12.0,32,119,27,6,44,2,1,19.0,25,105,-13,-2,18,0,-1
1096,11/11/2000,Texas Christian,24.0,62,217,15,7,78,0,1,Fresno State,7.0,30,41,31,15,183,2,2,17.0,32,176,-16,-8,-105,-2,-1
1097,11/11/2000,Temple,12.0,32,119,27,6,44,2,1,Syracuse,31.0,57,224,14,4,62,2,0,-19.0,-25,-105,13,2,-18,0,1
1098,11/11/2000,Tennessee,63.0,51,290,34,19,212,0,0,Arkansas,20.0,35,118,20,11,128,1,3,43.0,16,172,14,8,84,-1,-3
1099,11/11/2000,Texas,51.0,61,396,19,11,241,2,0,Kansas,16.0,36,125,25,10,111,1,1,35.0,25,271,-6,1,130,1,-1
1100,11/11/2000,Toledo,31.0,35,260,19,6,82,0,0,Ball State,3.0,44,81,36,24,200,2,0,28.0,-9,179,-17,-18,-118,-2,0
1101,11/11/2000,Texas Tech,58.0,29,152,47,32,252,0,0,Oklahoma State,0.0,39,107,39,22,223,2,1,58.0,-10,45,8,10,29,-2,-1
1102,11/11/2000,Tulane,50.0,29,125,41,26,380,2,0,Navy,38.0,56,362,43,24,362,3,3,12.0,-27,-237,-2,2,18,-1,-3
1103,11/11/2000,Tulsa,20.0,38,85,36,19,227,0,1,Southern Methodist,24.0,39,177,19,14,157,1,1,-4.0,-1,-92,17,5,70,-1,0
1104,11/11/2000,Texas A & M,31.0,37,97,37,18,219,2,0,Oklahoma,35.0,28,105,42,28,263,2,1,-4.0,9,-8,-5,-10,-44,0,-1
1105,11/11/2000,Alabama-Birmingham,30.0,51,191,25,15,146,0,0,Southern Miss,33.0,38,46,34,25,261,1,0,-3.0,13,145,-9,-10,-115,-1,0
1106,11/11/2000,U.C.L.A.,28.0,24,71,38,22,298,1,1,Washington,35.0,64,349,19,12,111,0,2,-7.0,-40,-278,19,10,187,1,-1
1107,11/11/2000,Nevada-Las Vegas,18.0,46,181,21,13,148,3,2,New Mexico,14.0,43,143,11,4,61,2,1,4.0,3,38,10,9,87,1,1
1108,11/11/2000,Utah,34.0,41,183,16,7,146,0,0,Wyoming,0.0,34,63,36,15,186,1,1,34.0,7,120,-20,-8,-40,-1,-1
1109,11/11/2000,Texas-El Paso,38.0,35,115,30,21,339,0,0,Rice,21.0,43,175,18,7,130,0,0,17.0,-8,-60,12,14,209,0,0
1110,11/11/2000,Utah State,38.0,24,86,57,25,509,0,0,Boise State,66.0,48,260,30,21,381,0,1,-28.0,-24,-174,27,4,128,0,-1
1111,11/11/2000,Vanderbilt,24.0,32,82,29,17,263,0,1,Kentucky,20.0,33,192,55,33,385,1,1,4.0,-1,-110,-26,-16,-122,-1,0
1112,11/11/2000,Virginia,0.0,29,154,30,14,136,1,2,Georgia Tech,35.0,57,304,37,29,323,0,0,-35.0,-28,-150,-7,-15,-187,1,2
1113,11/11/2000,Virginia Tech,44.0,61,313,8,2,55,0,0,Central Florida,21.0,23,21,45,28,362,4,2,23.0,38,292,-37,-26,-307,-4,-2
1114,11/11/2000,Washington,35.0,64,349,19,12,111,0,2,U.C.L.A.,28.0,24,71,38,22,298,1,1,7.0,40,278,-19,-10,-187,-1,1
1115,11/11/2000,Washington State,33.0,38,130,32,12,242,0,2,Southern Cal,28.0,41,91,54,29,379,1,2,5.0,-3,39,-22,-17,-137,-1,0
1116,11/11/2000,Wake Forest,6.0,46,162,26,11,114,1,0,Florida State,35.0,25,229,39,24,327,3,0,-29.0,21,-67,-13,-13,-213,-2,0
1117,11/11/2000,Wisconsin,43.0,39,228,23,16,207,0,3,Indiana,22.0,47,250,35,15,209,4,1,21.0,-8,-22,-12,1,-2,-4,2
1118,11/11/2000,Western Michigan,17.0,44,176,20,8,99,3,0,Central Michigan,21.0,43,97,29,17,220,0,0,-4.0,1,79,-9,-9,-121,3,0
1119,11/11/2000,West Virginia,31.0,51,152,26,12,126,1,1,Rutgers,24.0,35,176,48,24,274,4,2,7.0,16,-24,-22,-12,-148,-3,-1
1120,11/11/2000,Wyoming,0.0,34,63,36,15,186,1,1,Utah,34.0,41,183,16,7,146,0,0,-34.0,-7,-120,20,8,40,1,1
1121,11/18/00,Air Force,45.0,73,418,17,10,122,1,0,San Diego State,24.0,28,81,26,14,269,1,2,21.0,45,337,-9,-4,-147,0,-2
1122,11/18/00,Akron,34.0,60,306,20,11,113,0,2,Kent State,6.0,29,82,38,17,205,1,4,28.0,31,224,-18,-6,-92,-1,-2
1123,11/18/00,Alabama,0.0,22,23,29,12,112,1,0,Auburn,9.0,47,162,20,10,139,2,1,-9.0,-25,-139,9,2,-27,-1,-1
1124,11/18/00,Arkansas,17.0,47,149,27,9,68,3,0,Mississippi State,10.0,39,68,22,12,138,0,1,7.0,8,81,5,-3,-70,3,-1
1125,11/18/00,Army,7.0,32,47,49,22,216,1,1,Alabama-Birmingham,27.0,41,209,28,14,218,1,1,-20.0,-9,-162,21,8,-2,0,0
1126,11/18/00,Auburn,9.0,47,162,20,10,139,2,1,Alabama,0.0,22,23,29,12,112,1,0,9.0,25,139,-9,-2,27,1,1
1127,11/18/00,Ball State,29.0,54,255,20,13,137,0,1,Connecticut,0.0,31,40,37,20,254,0,2,29.0,23,215,-17,-7,-117,0,-1
1128,11/18/00,Baylor,22.0,31,66,35,17,227,3,4,Oklahoma State,50.0,51,240,24,15,171,0,2,-28.0,-20,-174,11,2,56,3,2
1129,11/18/00,Boise State,66.0,31,120,31,21,449,0,0,Idaho,24.0,41,111,40,22,289,5,0,42.0,-10,9,-9,-1,160,-5,0
1130,11/18/00,Buffalo,16.0,56,290,24,12,121,3,0,Miami-Ohio,17.0,47,239,21,9,104,4,1,-1.0,9,51,3,3,17,-1,-1
1131,11/18/00,Brigham Young,37.0,44,149,35,21,349,1,1,New Mexico,13.0,33,90,28,11,178,0,2,24.0,11,59,7,10,171,1,-1
1132,11/18/00,California,30.0,37,181,34,22,195,4,1,Stanford,36.0,41,48,23,12,242,1,0,-6.0,-4,133,11,10,-47,3,1
1133,11/18/00,Cincinnati,27.0,36,72,42,20,197,0,2,Southern Miss,24.0,42,138,34,19,203,2,3,3.0,-6,-66,8,1,-6,-2,-1
1134,11/18/00,Clemson,16.0,49,174,30,14,185,1,0,South Carolina,14.0,39,162,26,13,200,3,0,2.0,10,12,4,1,-15,-2,0
1135,11/18/00,Central Michigan,6.0,28,104,24,7,65,0,1,Northern Illinois,40.0,64,299,21,10,174,1,0,-34.0,-36,-195,3,-3,-109,-1,1
1136,11/18/00,Colorado State,37.0,33,74,26,17,216,0,2,Wyoming,13.0,39,152,30,14,138,3,1,24.0,-6,-78,-4,3,78,-3,1
1137,11/18/00,Duke,21.0,36,107,36,10,140,3,1,North Carolina,59.0,41,247,26,18,218,1,2,-38.0,-5,-140,10,-8,-78,2,-1
1138,11/18/00,East Carolina,24.0,32,1,42,26,313,1,1,West Virginia,42.0,46,79,25,13,316,0,2,-18.0,-14,-78,17,13,-3,1,-1
1139,11/18/00,Eastern Michigan,0.0,27,35,34,15,140,3,1,Western Michigan,28.0,51,191,30,17,223,1,1,-28.0,-24,-156,4,-2,-83,2,0
1140,11/18/00,Florida,7.0,20,37,46,27,278,3,0,Florida State,30.0,29,90,44,23,353,2,0,-23.0,-9,-53,2,4,-75,1,0
1141,11/18/00,Fresno State,14.0,41,181,18,14,139,0,1,Southern Methodist,7.0,43,151,36,19,190,1,2,7.0,-2,30,-18,-5,-51,-1,-1
1142,11/18/00,Florida State,30.0,29,90,44,23,353,2,0,Florida,7.0,20,37,46,27,278,3,0,23.0,9,53,-2,-4,75,-1,0
1143,11/18/00,Georgia,32.0,45,244,18,9,107,2,2,Mississippi,14.0,33,67,37,16,175,2,1,18.0,12,177,-19,-7,-68,0,1
1144,11/18/00,Georgia Tech,35.0,53,193,30,19,354,0,1,Maryland,22.0,22,20,46,29,318,1,2,13.0,31,173,-16,-10,36,-1,-1
1145,11/18/00,Hawaii,27.0,29,124,51,31,391,1,2,Louisiana Tech,10.0,20,32,47,28,255,4,0,17.0,9,92,4,3,136,-3,2
1146,11/18/00,Houston,13.0,29,29,34,14,147,5,1,Louisville,32.0,49,156,34,13,216,1,1,-19.0,-20,-127,0,1,-69,4,0
1147,11/18/00,Iowa State,38.0,50,335,28,13,171,1,1,Kansas,17.0,38,138,35,15,158,0,1,21.0,12,197,-7,-2,13,1,0
1148,11/18/00,Idaho,24.0,41,111,40,22,289,5,0,Boise State,66.0,31,120,31,21,449,0,0,-42.0,10,-9,9,1,-160,5,0
1149,11/18/00,Illinois,23.0,36,116,37,20,246,1,2,Northwestern,61.0,71,315,32,19,163,0,0,-38.0,-35,-199,5,1,83,1,2
1150,11/18/00,Indiana,13.0,36,205,28,13,123,3,1,Purdue,41.0,50,294,29,20,216,1,1,-28.0,-14,-89,-1,-7,-93,2,0
1151,11/18/00,Iowa,24.0,34,136,24,14,159,1,1,Minnesota,27.0,40,142,38,23,299,0,1,-3.0,-6,-6,-14,-9,-140,1,0
1152,11/18/00,Kansas,17.0,38,138,35,15,158,0,1,Iowa State,38.0,50,335,28,13,171,1,1,-21.0,-12,-197,7,2,-13,-1,0
1153,11/18/00,Kent State,6.0,29,82,38,17,205,1,4,Akron,34.0,60,284,20,11,113,0,2,-28.0,-31,-202,18,6,92,1,2
1154,11/18/00,Kansas State,28.0,55,155,20,9,158,1,0,Missouri,24.0,42,139,20,9,110,1,1,4.0,13,16,0,0,48,0,-1
1155,11/18/00,Kentucky,20.0,35,96,49,25,330,2,0,Tennessee,59.0,29,228,25,19,362,1,1,-39.0,6,-132,24,6,-32,1,-1
1156,11/18/00,Louisville,32.0,49,156,34,13,216,1,1,Houston,13.0,29,29,34,14,147,5,1,19.0,20,127,0,-1,69,-4,0
1157,11/18/00,Louisiana Tech,10.0,48,170,85,55,659,5,2,Hawaii,27.0,67,238,81,53,591,2,4,-17.0,-19,-68,4,2,68,3,-2
1158,11/18/00,Marshall,28.0,20,77,39,26,294,0,2,Ohio,38.0,66,401,14,10,87,0,0,-10.0,-46,-324,25,16,207,0,2
1159,11/18/00,Michigan State,23.0,37,100,38,22,308,0,0,Penn State,42.0,45,244,26,11,218,0,0,-19.0,-8,-144,12,11,90,0,0
1160,11/18/00,Maryland,22.0,22,20,46,29,318,1,2,Georgia Tech,35.0,53,193,30,19,354,0,1,-13.0,-31,-173,16,10,-36,1,1
1161,11/18/00,Memphis,14.0,26,85,54,24,216,3,3,Tulane,37.0,40,123,56,29,360,0,1,-23.0,-14,-38,-2,-5,-144,3,2
1162,11/18/00,Miami-Florida,26.0,41,156,29,16,263,0,0,Syracuse,0.0,31,83,27,11,83,2,0,26.0,10,73,2,5,180,-2,0
1163,11/18/00,Miami-Ohio,17.0,47,217,21,9,104,4,1,Buffalo,16.0,56,290,24,12,121,3,0,1.0,-9,-73,-3,-3,-17,1,1
1164,11/18/00,Michigan,38.0,43,88,25,14,303,1,0,Ohio State,26.0,34,149,48,21,251,3,0,12.0,9,-61,-23,-7,52,-2,0
1165,11/18/00,Minnesota,27.0,40,142,38,23,299,0,1,Iowa,24.0,34,136,24,14,159,1,1,3.0,6,6,14,9,140,-1,0
1166,11/18/00,Mississippi,14.0,33,67,37,16,175,2,1,Georgia,32.0,45,244,18,9,107,2,2,-18.0,-12,-177,19,7,68,0,-1
1167,11/18/00,Missouri,24.0,42,139,20,9,110,1,1,Kansas State,28.0,55,155,20,9,158,1,0,-4.0,-13,-16,0,0,-48,0,1
1168,11/18/00,Mississippi State,10.0,39,68,22,12,138,0,1,Arkansas,17.0,47,149,27,9,68,3,0,-7.0,-8,-81,-5,3,70,-3,1
1169,11/18/00,Mid Tennessee St,41.0,38,168,39,24,292,2,2,UL-Lafayette,38.0,39,105,45,28,299,0,1,3.0,-1,63,-6,-4,-7,2,1
1170,11/18/00,Navy,26.0,54,283,23,12,151,1,1,Wake Forest,49.0,53,305,24,16,272,0,2,-23.0,1,-22,-1,-4,-121,1,-1
1171,11/18/00,North Carolina,59.0,41,247,26,18,218,1,2,Duke,21.0,36,107,36,10,140,3,1,38.0,5,140,-10,8,78,-2,1
1172,11/18/00,No Carolina State,17.0,37,137,46,25,266,1,0,Virginia,24.0,44,231,17,7,149,0,0,-7.0,-7,-94,29,18,117,1,0
1173,11/18/00,Notre Dame,45.0,60,295,20,14,186,0,1,Rutgers,17.0,30,174,28,13,175,3,2,28.0,30,121,-8,1,11,-3,-1
1174,11/18/00,UL-Monroe,6.0,59,154,74,45,378,2,3,Wofford,14.0,92,350,41,28,412,1,2,-8.0,-33,-196,33,17,-34,1,1
1175,11/18/00,Nevada-Reno,34.0,38,129,30,17,236,1,1,Rice,28.0,59,293,23,10,104,1,3,6.0,-21,-164,7,7,132,0,-2
1176,11/18/00,Northern Illinois,40.0,64,299,21,10,174,1,0,Central Michigan,6.0,28,104,24,7,65,0,1,34.0,36,195,-3,3,109,1,-1
1177,11/18/00,New Mexico,13.0,33,90,28,11,178,0,2,Brigham Young,37.0,44,149,35,21,349,1,1,-24.0,-11,-59,-7,-10,-171,-1,1
1178,11/18/00,New Mexico State,23.0,39,180,25,12,139,2,3,North Texas,30.0,53,208,12,6,63,0,1,-7.0,-14,-28,13,6,76,2,2
1179,11/18/00,North Texas,30.0,53,208,12,6,63,0,1,New Mexico State,23.0,39,180,25,12,139,2,3,7.0,14,28,-13,-6,-76,-2,-2
1180,11/18/00,Northwestern,61.0,71,315,32,19,163,0,1,Illinois,23.0,36,116,37,20,246,1,2,38.0,35,199,-5,-1,-83,-1,-1
1181,11/18/00,Ohio,38.0,66,401,14,10,87,0,0,Marshall,28.0,20,77,39,26,294,0,2,10.0,46,324,-25,-16,-207,0,-2
1182,11/18/00,Ohio State,26.0,34,149,48,21,251,3,0,Michigan,38.0,43,88,25,14,303,1,0,-12.0,-9,61,23,7,-52,2,0
1183,11/18/00,Oklahoma,27.0,25,136,38,24,248,2,2,Texas Tech,13.0,23,21,62,42,309,2,0,14.0,2,115,-24,-18,-61,0,2
1184,11/18/00,Oklahoma State,50.0,51,240,24,15,171,0,2,Baylor,22.0,31,66,35,17,227,3,4,28.0,20,174,-11,-2,-56,-3,-2
1185,11/18/00,Oregon,13.0,34,137,48,25,334,5,1,Oregon State,23.0,39,153,27,14,246,1,0,-10.0,-5,-16,21,11,88,4,1
1186,11/18/00,Oregon State,23.0,39,153,27,14,246,1,0,Oregon,13.0,34,137,48,25,334,5,1,10.0,5,16,-21,-11,-88,-4,-1
1187,11/18/00,Penn State,42.0,45,244,26,11,218,0,0,Michigan State,23.0,37,100,38,22,308,0,0,19.0,8,144,-12,-11,-90,0,0
1188,11/18/00,Pittsburgh,7.0,45,170,29,18,218,1,4,Temple,0.0,27,12,35,18,170,2,0,7.0,18,158,-6,0,48,-1,4
1189,11/18/00,Purdue,41.0,50,294,29,20,216,1,1,Indiana,13.0,36,205,28,13,123,3,2,28.0,14,89,1,7,93,-2,-1
1190,11/18/00,Rice,28.0,59,293,23,10,104,1,3,Nevada-Reno,34.0,38,129,30,17,236,1,1,-6.0,21,164,-7,-7,-132,0,2
1191,11/18/00,Rutgers,17.0,30,174,28,13,175,3,2,Notre Dame,45.0,60,295,20,14,186,0,1,-28.0,-30,-121,8,-1,-11,3,1
1192,11/18/00,Southern Cal,38.0,44,207,38,26,350,0,2,U.C.L.A.,35.0,28,71,23,14,257,0,0,3.0,16,136,15,12,93,0,2
1193,11/18/00,South Carolina,14.0,39,162,26,13,200,3,0,Clemson,16.0,49,174,30,14,185,1,0,-2.0,-10,-12,-4,-1,15,2,0
1194,11/18/00,San Diego State,24.0,28,81,26,14,269,1,2,Air Force,45.0,73,418,17,10,122,1,0,-21.0,-45,-337,9,4,147,0,2
1195,11/18/00,San Jose State,17.0,37,206,33,12,196,1,0,Tulsa,28.0,52,327,27,12,138,0,1,-11.0,-15,-121,6,0,58,1,-1
1196,11/18/00,Southern Miss,24.0,42,138,34,19,203,2,3,Cincinnati,27.0,36,72,42,20,197,0,2,-3.0,6,66,-8,-1,6,2,1
1197,11/18/00,Southern Methodist,7.0,43,151,36,19,190,1,2,Fresno State,14.0,41,181,18,14,139,0,1,-7.0,2,-30,18,5,51,1,1
1198,11/18/00,Stanford,36.0,41,48,23,12,242,1,0,California,30.0,37,181,34,22,195,4,1,6.0,4,-133,-11,-10,47,-3,-1
1199,11/18/00,UL-Lafayette,38.0,39,105,45,28,299,0,1,Mid Tennessee St,41.0,38,168,39,24,292,2,2,-3.0,1,-63,6,4,7,-2,-1
1200,11/18/00,Syracuse,0.0,31,82,27,11,83,2,0,Miami-Florida,26.0,41,156,29,16,263,0,0,-26.0,-10,-74,-2,-5,-180,2,0
1201,11/18/00,Texas Christian,47.0,49,313,18,10,216,0,2,Texas-El Paso,14.0,32,70,47,21,217,1,1,33.0,17,243,-29,-11,-1,-1,1
1202,11/18/00,Temple,0.0,27,12,35,18,170,2,0,Pittsburgh,7.0,45,169,29,18,218,1,4,-7.0,-18,-157,6,0,-48,1,-4
1203,11/18/00,Tennessee,59.0,29,228,25,19,362,1,1,Kentucky,20.0,35,96,49,25,330,2,0,39.0,-6,132,-24,-6,32,-1,1
1204,11/18/00,Texas Tech,13.0,23,21,62,42,309,2,0,Oklahoma,27.0,25,136,38,24,248,2,2,-14.0,-2,-115,24,18,61,0,-2
1205,11/18/00,Tulane,37.0,40,123,56,29,360,0,1,Memphis,14.0,26,85,54,24,216,3,3,23.0,14,38,2,5,144,-3,-2
1206,11/18/00,Tulsa,28.0,52,327,27,12,138,0,1,San Jose State,17.0,37,206,33,12,196,1,0,11.0,15,121,-6,0,-58,-1,1
1207,11/18/00,Alabama-Birmingham,27.0,41,209,28,14,218,1,1,Army,7.0,32,47,49,22,216,1,1,20.0,9,162,-21,-8,2,0,0
1208,11/18/00,U.C.L.A.,35.0,28,71,23,14,257,0,0,Southern Cal,38.0,44,207,38,26,350,0,2,-3.0,-16,-136,-15,-12,-93,0,-2
1209,11/18/00,Texas-El Paso,14.0,32,70,47,21,217,1,1,Texas Christian,47.0,49,313,18,10,216,0,2,-33.0,-17,-243,29,11,1,1,-1
1210,11/18/00,Utah State,24.0,19,51,36,15,209,1,2,Idaho State,27.0,59,262,34,20,180,3,0,-3.0,-40,-211,2,-5,29,-2,2
1211,11/18/00,Virginia,24.0,44,231,17,7,149,0,0,No Carolina State,17.0,37,137,46,25,266,1,0,7.0,7,94,-29,-18,-117,-1,0
1212,11/18/00,Washington,51.0,53,336,21,11,190,0,1,Washington State,3.0,28,88,28,12,122,1,0,48.0,25,248,-7,-1,68,-1,1
1213,11/18/00,Washington State,3.0,28,88,28,12,122,1,0,Washington,51.0,53,336,21,11,190,0,1,-48.0,-25,-248,7,1,-68,1,-1
1214,11/18/00,Wake Forest,49.0,53,305,24,16,272,0,2,Navy,26.0,55,292,23,12,142,1,1,23.0,-2,13,1,4,130,-1,1
1215,11/18/00,Western Michigan,28.0,51,191,30,17,223,1,1,Eastern Michigan,0.0,27,35,34,15,140,3,1,28.0,24,156,-4,2,83,-2,0
1216,11/18/00,West Virginia,42.0,46,79,25,13,316,0,2,East Carolina,24.0,32,1,42,26,313,1,1,18.0,14,78,-17,-13,3,-1,1
1217,11/18/00,Wyoming,13.0,39,152,30,14,138,3,1,Colorado State,37.0,33,74,26,17,216,0,2,-24.0,6,78,4,-3,-78,3,-1
1218,11/25/00,Arizona,17.0,50,195,31,16,176,1,2,Arizona State,30.0,31,75,35,15,189,0,0,-13.0,19,120,-4,1,-13,1,2
1219,11/25/00,Arkansas,14.0,47,139,28,15,114,0,0,Louisiana State,3.0,27,84,27,6,65,2,1,11.0,20,55,1,9,49,-2,-1
1220,11/25/00,Arizona State,30.0,31,75,35,15,189,0,0,Arizona,17.0,50,195,31,16,176,1,2,13.0,-19,-120,4,-1,13,-1,-2
1221,11/25/00,Boston College,6.0,42,176,29,12,122,1,0,Miami-Florida,52.0,41,244,28,18,255,1,1,-46.0,1,-68,1,-6,-133,0,-1
1222,11/25/00,Bowling Green,17.0,30,81,31,14,136,2,2,Toledo,51.0,47,275,23,11,174,1,0,-34.0,-17,-194,8,3,-38,1,2
1223,11/25/00,Brigham Young,34.0,42,100,29,16,284,1,0,Utah,27.0,30,70,34,16,252,1,1,7.0,12,30,-5,0,32,0,-1
1224,11/25/00,Colorado,32.0,43,197,41,25,254,2,0,Nebraska,34.0,48,296,17,11,139,0,3,-2.0,-5,-99,24,14,115,2,-3
1225,11/25/00,East Carolina,14.0,43,155,20,5,55,2,0,Southern Miss,9.0,45,110,40,18,261,1,2,5.0,-2,45,-20,-13,-206,1,-2
1226,11/25/00,Fresno State,37.0,43,135,25,15,244,0,0,San Jose State,6.0,26,50,40,16,232,3,1,31.0,17,85,-15,-1,12,-3,-1
1227,11/25/00,Georgia,15.0,18,26,63,37,435,2,1,Georgia Tech,27.0,34,140,35,20,222,2,0,-12.0,-16,-114,28,17,213,0,1
1228,11/25/00,Georgia Tech,27.0,34,140,35,20,222,2,0,Georgia,15.0,18,26,63,37,435,2,1,12.0,16,114,-28,-17,-213,0,-1
1229,11/25/00,Hawaii,18.0,14,42,56,24,361,2,0,Wisconsin,34.0,64,263,21,12,207,2,1,-16.0,-50,-221,35,12,154,0,-1
1230,11/25/00,Louisiana State,3.0,27,84,27,6,65,2,1,Arkansas,14.0,47,139,28,15,114,0,0,-11.0,-20,-55,-1,-9,-49,2,1
1231,11/25/00,Miami-Florida,52.0,41,244,28,18,255,1,1,Boston College,6.0,42,176,29,12,122,1,0,46.0,-1,68,-1,6,133,0,1
1232,11/25/00,Mississippi,45.0,44,230,23,11,147,1,0,Mississippi State,30.0,40,184,26,13,184,1,1,15.0,4,46,-3,-2,-37,0,-1
1233,11/25/00,Mississippi State,30.0,40,184,26,13,184,1,1,Mississippi,45.0,44,230,23,11,147,1,0,-15.0,-4,-46,3,2,37,0,1
1234,11/25/00,No Carolina State,32.0,37,143,30,14,139,0,3,Wake Forest,14.0,39,164,27,14,126,1,4,18.0,-2,-21,3,0,13,-1,-1
1235,11/25/00,Notre Dame,38.0,62,246,15,9,142,0,0,Southern Cal,21.0,30,78,35,17,251,2,1,17.0,32,168,-20,-8,-109,-2,-1
1236,11/25/00,Nebraska,34.0,48,296,17,11,139,0,3,Colorado,32.0,43,197,41,25,254,2,0,2.0,5,99,-24,-14,-115,-2,3
1237,11/25/00,Nevada-Reno,3.0,24,17,33,13,153,1,1,Tulsa,38.0,54,273,22,14,157,1,1,-35.0,-30,-256,11,-1,-4,0,0
1238,11/25/00,Oklahoma,12.0,34,155,36,19,154,2,0,Oklahoma State,7.0,38,173,20,9,102,2,0,5.0,-4,-18,16,10,52,0,0
1239,11/25/00,Oklahoma State,7.0,38,173,20,9,102,2,0,Oklahoma,12.0,34,155,36,19,154,2,0,-5.0,4,18,-16,-10,-52,0,0
1240,11/25/00,Pittsburgh,38.0,46,275,27,11,229,4,0,West Virginia,28.0,26,49,45,21,343,0,1,10.0,20,226,-18,-10,-114,4,-1
1241,11/25/00,Rutgers,21.0,42,177,36,17,200,1,2,Syracuse,49.0,54,339,20,11,180,1,1,-28.0,-12,-162,16,6,20,0,1
1242,11/25/00,Southern Cal,21.0,30,78,35,17,251,2,1,Notre Dame,38.0,62,246,15,9,142,0,0,-17.0,-32,-168,20,8,109,2,1
1243,11/25/00,San Diego State,24.0,32,90,32,17,328,1,0,Nevada-Las Vegas,31.0,39,91,31,19,277,0,0,-7.0,-7,-1,1,-2,51,1,0
1244,11/25/00,San Jose State,6.0,26,50,40,16,232,3,1,Fresno State,37.0,43,135,25,15,244,0,0,-31.0,-17,-85,15,1,-12,3,1
1245,11/25/00,Southern Miss,9.0,47,132,38,16,239,1,2,East Carolina,14.0,43,155,20,5,55,2,0,-5.0,4,-23,18,11,184,-1,2
1246,11/25/00,Southern Methodist,7.0,32,27,31,11,119,1,1,Texas Christian,62.0,48,307,20,13,251,1,0,-55.0,-16,-280,11,-2,-132,0,1
1247,11/25/00,Syracuse,49.0,54,339,20,11,180,1,1,Rutgers,21.0,42,177,36,17,200,1,2,28.0,12,162,-16,-6,-20,0,-1
1248,11/25/00,Texas Christian,62.0,48,307,20,13,251,1,0,Southern Methodist,7.0,32,27,31,11,119,1,1,55.0,16,280,-11,2,132,0,-1
1249,11/25/00,Tennessee,28.0,46,196,30,14,158,2,1,Vanderbilt,26.0,25,57,46,21,258,1,0,2.0,21,139,-16,-7,-100,1,1
1250,11/25/00,Texas,43.0,35,109,24,16,383,0,0,Texas A & M,17.0,28,81,43,25,290,2,2,26.0,7,28,-19,-9,93,-2,-2
1251,11/25/00,Toledo,51.0,47,275,23,11,174,1,0,Bowling Green,17.0,30,81,31,14,136,2,2,34.0,17,194,-8,-3,38,-1,-2
1252,11/25/00,Tulsa,38.0,54,273,22,14,157,1,1,Nevada-Reno,3.0,24,17,33,13,153,1,1,35.0,30,256,-11,1,4,0,0
1253,11/25/00,Texas A & M,17.0,28,81,43,25,290,2,2,Texas,43.0,35,109,24,16,383,0,0,-26.0,-7,-28,19,9,-93,2,2
1254,11/25/00,Nevada-Las Vegas,31.0,39,91,31,19,277,0,0,San Diego State,24.0,32,90,32,17,328,1,0,7.0,7,1,-1,2,-51,-1,0
1255,11/25/00,Utah,27.0,30,70,34,16,252,1,1,Brigham Young,34.0,42,100,29,16,284,1,0,-7.0,-12,-30,5,0,-32,0,1
1256,11/25/00,Vanderbilt,26.0,25,57,46,21,258,1,0,Tennessee,28.0,46,196,30,14,158,2,1,-2.0,-21,-139,16,7,100,-1,-1
1257,11/25/00,Virginia,21.0,34,171,24,9,157,0,1,Virginia Tech,42.0,53,259,25,16,202,0,1,-21.0,-19,-88,-1,-7,-45,0,0
1258,11/25/00,Virginia Tech,42.0,53,259,25,16,202,0,1,Virginia,21.0,34,171,24,9,157,0,1,21.0,19,88,1,7,45,0,0
1259,11/25/00,Wake Forest,14.0,39,164,27,14,126,1,4,No Carolina State,32.0,37,143,30,14,139,0,3,-18.0,2,21,-3,0,-13,1,1
1260,11/25/00,Wisconsin,34.0,64,263,21,12,207,2,1,Hawaii,18.0,14,42,56,24,361,2,0,16.0,50,221,-35,-12,-154,0,1
1261,11/25/00,West Virginia,28.0,26,49,45,21,343,0,1,Pittsburgh,38.0,46,275,27,11,229,4,0,-10.0,-20,-226,18,10,114,-4,1
1262,12/02/2000,Army,28.0,27,153,31,13,145,2,3,Navy,30.0,70,300,13,7,88,0,2,-2.0,-43,-147,18,6,57,2,1
1263,12/02/2000,Auburn,6.0,28,120,43,23,208,2,2,Florida,28.0,35,191,26,17,238,1,2,-22.0,-7,-71,17,6,-30,1,0
1264,12/02/2000,Florida,28.0,35,191,26,17,238,1,2,Auburn,6.0,28,120,43,23,208,2,2,22.0,7,71,-17,-6,30,-1,0
1265,12/02/2000,Hawaii,32.0,15,37,50,26,353,2,0,Nevada-Las Vegas,34.0,62,431,25,10,124,1,3,-2.0,-47,-394,25,16,229,1,-3
1266,12/02/2000,Kansas State,24.0,38,133,28,12,106,0,1,Oklahoma,27.0,28,99,44,24,220,3,0,-3.0,10,34,-16,-12,-114,-3,1
1267,12/02/2000,Marshall,19.0,31,70,45,29,358,0,1,Western Michigan,14.0,32,86,34,23,264,1,1,5.0,-1,-16,11,6,94,-1,0
1268,12/02/2000,Navy,30.0,70,300,13,7,88,0,2,Army,28.0,27,153,31,13,145,2,3,2.0,43,147,-18,-6,-57,-2,-1
1269,12/02/2000,Oklahoma,27.0,28,99,44,24,220,3,0,Kansas State,24.0,38,133,28,12,106,0,1,3.0,-10,-34,16,12,114,3,-1
1270,12/02/2000,Nevada-Las Vegas,34.0,62,431,25,10,124,1,3,Hawaii,32.0,15,37,50,26,353,2,0,2.0,47,394,-25,-16,-229,-1,3
1271,12/02/2000,Western Michigan,14.0,32,86,34,23,264,1,1,Marshall,19.0,31,70,45,29,358,0,1,-5.0,1,16,-11,-6,-94,1,0
